division,subtype,report_year,count_cleared,count_,clearance_rate,unsolved_crime
D11,Other,2014,9,22,0,13
D11,Theft Over $5000,2014,1,1,1,0
D11,Other,2014,1,1,1,0
D11,Robbery-Financial,2014,1,1,1,0
D11,Break & Enter-House,2014,13,23,0,10
D11,Theft Over $5000,2014,1,1,1,0
D11,Break & Enter-House,2014,6,13,0,7
D11,Theft Over $5000,2014,1,2,0,1
D11,Break & Enter-House,2014,2,7,0,5
D11,Theft Over $5000,2014,0,1,0,1
D11,Robbery-Financial,2014,1,1,1,0
D11,Break & Enter-House,2014,2,8,0,6
D12,Break & Enter-Other,2014,3,4,0,1
D11,Other,2014,12,14,0,2
D12,Auto Theft,2014,6,39,0,33
D11,Theft Over $5000,2014,0,2,0,2
D11,Robbery-Financial,2014,1,1,1,0
D11,Break & Enter-House,2014,0,5,0,5
D12,Fraud,2014,5,21,0,16
D11,Theft Over $5000,2014,1,4,0,3
D12,Auto Theft,2014,2,9,0,7
D11,Other,2014,20,20,1,0
D11,Robbery-Financial,2014,1,1,1,0
D11,Break & Enter-House,2014,2,7,0,5
D12,Fraud,2014,19,42,0,23
D11,Theft Under $5000,2014,1,1,1,0
D12,Auto Theft,2014,3,20,0,17
D11,Other,2014,19,20,0,1
D11,Robbery-Financial,2014,1,1,1,0
D11,Break & Enter-House,2014,5,13,0,8
D12,Fraud,2014,3,6,0,3
D11,Theft Under $5000,2014,256,372,0,116
D12,Auto Theft,2014,1,7,0,6
D11,Other,2014,11,11,1,0
D11,Robbery-Financial,2014,1,1,1,0
D11,Break & Enter-House,2014,3,6,0,3
D11,Theft Under $5000,2014,25,147,0,122
D12,Auto Theft,2014,4,27,0,23
D12,Assault,2014,43,67,0,24
D12,Fraud,2014,6,27,0,21
D11,Other,2014,1,1,1,0
D11,Other,2014,55,56,0,1
D11,Break & Enter-Other,2014,1,3,0,2
D11,Robbery-Financial,2014,1,1,1,0
D11,Theft Under $5000,2014,44,166,0,122
D12,Auto Theft,2014,5,19,0,14
D12,Assault,2014,15,17,0,2
D12,Fraud,2014,5,17,0,12
D11,Other,2014,9,9,1,0
D11,Other,2014,34,37,0,3
D11,Break & Enter-Other,2014,1,4,0,3
D11,Robbery-Other,2014,4,10,0,6
D12,Assault,2014,71,84,0,13
D11,Theft Under $5000,2014,115,252,0,137
D12,Auto Theft,2014,12,47,0,35
D12,Fraud,2014,2,15,0,13
D11,Robbery-Other,2014,6,14,0,8
D11,Theft Under $5000,2014,62,200,0,138
D12,Auto Theft,2014,1,7,0,6
D12,Assault,2014,7,14,0,7
D11,Break & Enter-Other,2014,1,1,1,0
D11,Other,2014,39,43,0,4
D11,Other,2014,6,6,1,0
D12,Auto Theft,2014,12,55,0,43
D12,Assault,2014,20,24,0,4
D11,Break & Enter-Other,2014,0,1,0,1
D11,Other,2014,42,46,0,4
D12,Fraud,2014,0,5,0,5
D11,Robbery-Other,2014,2,24,0,22
D11,Theft Under $5000,2014,9,39,0,30
D11,Other,2014,4,4,1,0
D12,Auto Theft,2014,2,7,0,5
D12,Assault,2014,79,112,0,33
D11,Break & Enter-Other,2014,1,1,1,0
D11,Other,2014,55,57,0,2
D12,Fraud,2014,4,14,0,10
D11,Robbery-Other,2014,5,8,0,3
D11,Theft Under $5000,2014,27,55,0,28
D11,Other,2014,29,30,0,1
D12,Break & Enter-Apartment,2014,3,8,0,5
D12,Assault,2014,31,41,0,10
D11,Break & Enter-Other,2014,1,3,0,2
D11,Other,2014,96,102,0,6
D12,Fraud,2014,8,26,0,18
D11,Robbery-Other,2014,5,20,0,15
D11,Theft Under $5000,2014,3,9,0,6
D11,Other,2014,7,7,1,0
D12,Break & Enter-Apartment,2014,4,5,0,1
D12,Assault,2014,112,153,0,41
D11,Break & Enter-Other,2014,0,5,0,5
D11,Other,2014,17,18,0,1
D12,Fraud,2014,2,11,0,9
D11,Robbery-Other,2014,0,1,0,1
D11,Theft Under $5000,2014,88,106,0,18
D11,Other,2014,7,8,0,1
D12,Break & Enter-Apartment,2014,0,1,0,1
D12,Assault,2014,22,30,0,8
D12,Fraud,2014,13,45,0,32
D11,Break & Enter-Other,2014,1,2,0,1
D12,Fraud,2014,1,3,0,2
D11,Theft Under $5000,2014,73,186,0,113
D11,Break & Enter-Other,2014,1,3,0,2
D12,Other,2014,11,34,0,23
D11,Other,2014,15,15,1,0
D12,Break & Enter-Apartment,2014,6,9,0,3
D11,Robbery-Other,2014,6,8,0,2
D12,Attempt Murder,2014,0,1,0,1
D11,Other,2014,7,11,0,4
D11,Auto Theft,2014,5,7,0,2
D12,Break & Enter-Apartment,2014,1,2,0,1
D11,Robbery-Other,2014,0,4,0,4
D11,Theft Under $5000,2014,69,144,0,75
D12,Other,2014,28,71,0,43
D11,Fraud,2014,1,1,1,0
D11,Other,2014,2,3,0,1
D12,Attempt Murder,2014,4,4,1,0
D11,Auto Theft,2014,4,8,0,4
D12,Break & Enter-Apartment,2014,7,12,0,5
D11,Robbery-Other,2014,1,1,1,0
D11,Theft Under $5000,2014,8,45,0,37
D12,Other,2014,5,14,0,9
D11,Fraud,2014,15,37,0,22
D11,Other,2014,9,9,1,0
D12,Attempt Murder,2014,1,1,1,0
D11,Auto Theft,2014,6,19,0,13
D12,Break & Enter-Apartment,2014,2,2,1,0
D11,Robbery-Other,2014,13,21,0,8
D11,Theft Under $5000,2014,0,1,0,1
D12,Other,2014,14,39,0,25
D11,Fraud,2014,5,19,0,14
D11,Other,2014,83,87,0,4
D12,Other,2014,18,28,0,10
D11,Auto Theft,2014,4,16,0,12
D12,Break & Enter-Apartment,2014,6,10,0,4
D11,Robbery-Other,2014,7,9,0,2
D11,Theft Under $5000,2014,10,51,0,41
D12,Other,2014,5,17,0,12
D11,Fraud,2014,7,37,0,30
D11,Other,2014,30,32,0,2
D12,Other,2014,23,30,0,7
D11,Auto Theft,2014,3,15,0,12
D12,Break & Enter-Apartment,2014,5,10,0,5
D11,Robbery-Other,2014,0,3,0,3
D11,Robbery-Other,2014,0,4,0,4
D11,Sexual Violation,2014,1,1,1,0
D11,Sexual Violation,2014,3,6,0,3
D11,Sexual Violation,2014,5,9,0,4
D11,Sexual Violation,2014,7,12,0,5
D11,Sexual Violation,2014,5,8,0,3
D11,Sexual Violation,2014,12,16,0,4
D11,Sexual Violation,2014,0,2,0,2
D11,Sexual Violation,2014,3,3,1,0
D11,Sexual Violation,2014,1,4,0,3
D11,Sexual Violation,2014,1,1,1,0
D11,Sexual Violation,2014,6,15,0,9
D11,Sexual Violation,2014,3,5,0,2
D11,Sexual Violation,2014,0,2,0,2
D11,Sexual Violation,2014,4,10,0,6
D11,Other,2014,3,3,1,0
D11,Other,2014,1,1,1,0
D11,Other,2014,5,5,1,0
D11,Other,2014,27,27,1,0
D11,Other,2014,7,7,1,0
D11,Other,2014,7,7,1,0
D11,Other,2014,4,4,1,0
D11,Other,2014,3,3,1,0
D11,Other,2014,1,1,1,0
D11,Other,2014,1,1,1,0
D11,Other,2014,5,5,1,0
D11,Other,2014,7,7,1,0
D11,Other,2014,7,7,1,0
D11,Other,2014,9,9,1,0
D11,Fraud,2014,11,27,0,16
D11,Assault,2014,39,61,0,22
D12,Other,2014,11,40,0,29
D12,Break & Enter-Apartment,2014,10,17,0,7
D12,Other,2014,1,2,0,1
D11,Other,2014,10,10,1,0
D11,Fraud,2014,12,30,0,18
D11,Assault,2014,56,73,0,17
D12,Other,2014,3,6,0,3
D12,Break & Enter-Commercial,2014,4,5,0,1
D12,Other,2014,15,18,0,3
D11,Other,2014,57,60,0,3
D11,Fraud,2014,4,8,0,4
D11,Assault,2014,58,80,0,22
D12,Other,2014,7,19,0,12
D12,Break & Enter-Commercial,2014,2,7,0,5
D12,Other,2014,0,1,0,1
D12,Other,2014,6,6,1,0
D12,Other,2014,12,17,0,5
D12,Other,2014,4,4,1,0
D12,Other,2014,4,7,0,3
D12,Other,2014,14,26,0,12
D12,Other,2014,8,11,0,3
D12,Other,2014,28,44,0,16
D12,Other,2014,2,5,0,3
D12,Robbery-Financial,2014,2,2,1,0
D12,Robbery-Financial,2014,1,1,1,0
D12,Robbery-Other,2014,8,14,0,6
D12,Robbery-Other,2014,21,32,0,11
D12,Robbery-Other,2014,3,5,0,2
D12,Robbery-Other,2014,10,32,0,22
D12,Robbery-Other,2014,5,7,0,2
D12,Robbery-Other,2014,12,20,0,8
D12,Robbery-Other,2014,0,2,0,2
D12,Robbery-Other,2014,3,5,0,2
D12,Robbery-Other,2014,21,34,0,13
D12,Robbery-Other,2014,4,13,0,9
D12,Robbery-Other,2014,20,30,0,10
D12,Robbery-Other,2014,3,6,0,3
D12,Sexual Violation,2014,2,5,0,3
D12,Sexual Violation,2014,9,15,0,6
D12,Sexual Violation,2014,0,1,0,1
D12,Sexual Violation,2014,4,8,0,4
D12,Sexual Violation,2014,0,1,0,1
D12,Sexual Violation,2014,6,8,0,2
D12,Sexual Violation,2014,4,5,0,1
D12,Sexual Violation,2014,4,6,0,2
D12,Sexual Violation,2014,2,4,0,2
D12,Sexual Violation,2014,11,19,0,8
D12,Sexual Violation,2014,4,7,0,3
D12,Other,2014,31,80,0,49
D11,Fraud,2014,2,9,0,7
D11,Assault,2014,65,77,0,12
D12,Break & Enter-Commercial,2014,1,4,0,3
D12,Other,2014,12,36,0,24
D11,Fraud,2014,0,2,0,2
D11,Assault,2014,94,123,0,29
D12,Break & Enter-Commercial,2014,1,3,0,2
D12,Other,2014,34,94,0,60
D11,Fraud,2014,5,8,0,3
D11,Assault,2014,0,1,0,1
D12,Break & Enter-Commercial,2014,0,1,0,1
D12,Other,2014,8,23,0,15
D12,Theft Over $5000,2014,1,2,0,1
D12,Theft Over $5000,2014,2,5,0,3
D12,Theft Over $5000,2014,0,1,0,1
D12,Theft Over $5000,2014,1,4,0,3
D12,Theft Over $5000,2014,1,2,0,1
D12,Theft Over $5000,2014,2,7,0,5
D12,Theft Over $5000,2014,1,1,1,0
D12,Theft Over $5000,2014,2,4,0,2
D12,Theft Over $5000,2014,0,1,0,1
D12,Theft Under $5000,2014,12,50,0,38
D12,Theft Under $5000,2014,179,279,0,100
D12,Theft Under $5000,2014,27,56,0,29
D12,Theft Under $5000,2014,24,65,0,41
D12,Theft Under $5000,2014,1,1,1,0
D12,Theft Under $5000,2014,6,21,0,15
D12,Theft Under $5000,2014,14,68,0,54
D12,Theft Under $5000,2014,4,6,0,2
D12,Theft Under $5000,2014,119,197,0,78
D12,Theft Under $5000,2014,27,137,0,110
D12,Theft Under $5000,2014,11,47,0,36
D12,Theft Under $5000,2014,52,166,0,114
D12,Theft Under $5000,2014,2,26,0,24
D12,Assault,2014,38,53,0,15
D12,Assault,2014,57,82,0,25
D12,Assault,2014,13,17,0,4
D11,Other,2014,1,1,1,0
D11,Fraud,2014,7,21,0,14
D11,Assault,2014,23,26,0,3
D11,Other,2014,1,1,1,0
D12,Break & Enter-Commercial,2014,1,2,0,1
D11,Fraud,2014,9,15,0,6
D11,Assault,2014,16,23,0,7
D11,Other Criminal Violations - Offensive Weapons,2014,3,3,1,0
D12,Break & Enter-Commercial,2014,0,1,0,1
D11,Fraud,2014,0,2,0,2
D11,Assault,2014,3,5,0,2
D11,Other Criminal Violations - Offensive Weapons,2014,5,6,0,1
D12,Break & Enter-Commercial,2014,1,3,0,2
D11,Fraud,2014,5,16,0,11
D11,Assault,2014,5,7,0,2
D11,Other Criminal Violations - Offensive Weapons,2014,8,8,1,0
D12,Break & Enter-Commercial,2014,2,7,0,5
D11,Other,2014,0,2,0,2
D11,Assault,2014,56,69,0,13
D12,Break & Enter-Commercial,2014,2,2,1,0
D11,Other Criminal Violations - Offensive Weapons,2014,6,6,1,0
D11,Other,2014,33,74,0,41
D11,Assault,2014,18,26,0,8
D12,Break & Enter-Commercial,2014,1,6,0,5
D11,Other Criminal Violations - Offensive Weapons,2014,3,3,1,0
D11,Other,2014,24,67,0,43
D11,Assault,2014,16,21,0,5
D12,Break & Enter-House,2014,2,6,0,4
D11,Other Criminal Violations - Offensive Weapons,2014,7,8,0,1
D11,Other,2014,23,85,0,62
D11,Assault,2014,1,1,1,0
D12,Break & Enter-House,2014,3,9,0,6
D11,Other Criminal Violations - Offensive Weapons,2014,3,3,1,0
D11,Other,2014,35,77,0,42
D11,Assault,2014,45,54,0,9
D12,Break & Enter-House,2014,1,4,0,3
D11,Other Criminal Violations - Offensive Weapons,2014,1,1,1,0
D11,Other,2014,40,94,0,54
D11,Attempt Murder,2014,1,1,1,0
D12,Break & Enter-House,2014,1,10,0,9
D11,Other Criminal Violations - Offensive Weapons,2014,6,7,0,1
D11,Other,2014,5,23,0,18
D11,Other,2014,9,13,0,4
D12,Break & Enter-House,2014,2,10,0,8
D11,Other Criminal Violations - Offensive Weapons,2014,1,1,1,0
D11,Other,2014,6,25,0,19
D11,Other,2014,15,26,0,11
D12,Break & Enter-House,2014,1,3,0,2
D11,Other Criminal Violations - Offensive Weapons,2014,1,1,1,0
D11,Other,2014,2,9,0,7
D11,Other,2014,15,23,0,8
D12,Break & Enter-House,2014,12,16,0,4
D11,Other Criminal Violations - Offensive Weapons,2014,1,1,1,0
D11,Other,2014,3,4,0,1
D11,Other,2014,13,15,0,2
D12,Break & Enter-House,2014,5,12,0,7
D11,Other,2014,2,2,1,0
D11,Other,2014,24,74,0,50
D11,Other,2014,15,29,0,14
D12,Break & Enter-House,2014,2,7,0,5
D11,Other,2014,3,3,1,0
D11,Other,2014,5,7,0,2
D11,Other,2014,14,39,0,25
D12,Break & Enter-House,2014,5,6,0,1
D11,Other,2014,3,3,1,0
D11,Other,2014,6,10,0,4
D11,Other,2014,3,4,0,1
D12,Break & Enter-House,2014,2,7,0,5
D11,Other,2014,1,1,1,0
D11,Other,2014,15,45,0,30
D11,Other,2014,0,1,0,1
D12,Break & Enter-Other,2014,1,1,1,0
D11,Other,2014,1,1,1,0
D11,Theft Over $5000,2014,3,6,0,3
D11,Other,2014,4,5,0,1
D12,Break & Enter-Other,2014,1,2,0,1
D11,Other,2014,4,4,1,0
D11,Theft Over $5000,2014,0,5,0,5
D11,Other,2014,0,3,0,3
D12,Break & Enter-Other,2014,0,1,0,1
D11,Other,2014,3,3,1,0
D11,Theft Over $5000,2014,3,8,0,5
D11,Other,2014,15,18,0,3
D12,Break & Enter-Other,2014,0,1,0,1
D11,Other,2014,1,1,1,0
D11,Theft Over $5000,2014,1,4,0,3
D11,Other,2014,6,13,0,7
D12,Break & Enter-Other,2014,0,1,0,1
D11,Other,2014,1,1,1,0
D11,Theft Over $5000,2014,1,2,0,1
D11,Other,2014,2,2,1,0
D12,Break & Enter-Other,2014,0,1,0,1
D12,Other,2014,24,24,1,0
D12,Break & Enter-Other,2014,1,6,0,5
D12,Other,2014,41,42,0,1
D12,Break & Enter-Other,2014,2,2,1,0
D12,Other,2014,8,9,0,1
D12,Other,2014,19,19,1,0
D12,Other,2014,10,11,0,1
D12,Other,2014,52,52,1,0
D12,Other,2014,9,13,0,4
D12,Other,2014,15,16,0,1
D12,Other,2014,36,37,0,1
D12,Other,2014,24,24,1,0
D12,Other,2014,60,63,0,3
D12,Other,2014,13,13,1,0
D12,Auto Theft,2014,3,10,0,7
D11,Auto Theft,2014,3,7,0,4
D11,Auto Theft,2014,0,3,0,3
D11,Auto Theft,2014,0,1,0,1
D11,Auto Theft,2014,0,1,0,1
D11,Auto Theft,2014,2,12,0,10
D11,Auto Theft,2014,7,15,0,8
D11,Auto Theft,2014,2,4,0,2
D11,Auto Theft,2014,7,16,0,9
D11,Break & Enter-Apartment,2014,6,12,0,6
D11,Break & Enter-Apartment,2014,5,11,0,6
D11,Break & Enter-Apartment,2014,4,9,0,5
D11,Break & Enter-Apartment,2014,1,6,0,5
D11,Break & Enter-Apartment,2014,6,19,0,13
D11,Break & Enter-Apartment,2014,3,3,1,0
D11,Break & Enter-Apartment,2014,0,3,0,3
D11,Break & Enter-Apartment,2014,2,2,1,0
D11,Break & Enter-Apartment,2014,7,13,0,6
D11,Break & Enter-Apartment,2014,0,1,0,1
D11,Break & Enter-Apartment,2014,3,6,0,3
D11,Break & Enter-Commercial,2014,0,2,0,2
D11,Break & Enter-Commercial,2014,0,1,0,1
D11,Break & Enter-Commercial,2014,3,10,0,7
D11,Break & Enter-Commercial,2014,3,7,0,4
D11,Break & Enter-Commercial,2014,0,5,0,5
D11,Break & Enter-Commercial,2014,2,5,0,3
D11,Break & Enter-Commercial,2014,0,2,0,2
D11,Break & Enter-Commercial,2014,1,2,0,1
D11,Break & Enter-Commercial,2014,4,13,0,9
D11,Break & Enter-Commercial,2014,3,6,0,3
D11,Break & Enter-Commercial,2014,0,1,0,1
D11,Break & Enter-Commercial,2014,2,4,0,2
D11,Break & Enter-House,2014,0,2,0,2
D11,Break & Enter-House,2014,1,5,0,4
D13,Other,2014,1,1,1,0
D13,Other,2014,24,27,0,3
D13,Other,2014,5,5,1,0
D13,Theft Over $5000,2014,3,5,0,2
D13,Other,2014,6,6,1,0
D13,Other,2014,80,85,0,5
D13,Other,2014,36,37,0,1
D14,Auto Theft,2014,2,13,0,11
D13,Other,2014,18,19,0,1
D13,Other,2014,4,7,0,3
D13,Break & Enter-House,2014,2,12,0,10
D14,Break & Enter-Other,2014,2,4,0,2
D13,Other,2014,22,23,0,1
D13,Theft Over $5000,2014,1,1,1,0
D13,Other Criminal Violations - Offensive Weapons,2014,5,5,1,0
D13,Theft Over $5000,2014,0,2,0,2
D13,Other,2014,12,12,1,0
D14,Auto Theft,2014,5,8,0,3
D14,Break & Enter-Other,2014,0,4,0,4
D13,Other,2014,2,2,1,0
D13,Other Criminal Violations - Offensive Weapons,2014,2,2,1,0
D13,Theft Over $5000,2014,1,3,0,2
D13,Break & Enter-House,2014,9,20,0,11
D13,Other,2014,6,6,1,0
D14,Auto Theft,2014,7,15,0,8
D14,Break & Enter-Other,2014,0,1,0,1
D13,Other,2014,23,29,0,6
D13,Other Criminal Violations - Offensive Weapons,2014,3,3,1,0
D13,Theft Over $5000,2014,1,2,0,1
D13,Break & Enter-House,2014,2,9,0,7
D13,Other,2014,32,33,0,1
D14,Auto Theft,2014,7,12,0,5
D14,Break & Enter-Other,2014,2,2,1,0
D13,Other,2014,14,19,0,5
D13,Other Criminal Violations - Offensive Weapons,2014,1,1,1,0
D13,Other,2014,3,3,1,0
D14,Break & Enter-Apartment,2014,5,17,0,12
D13,Theft Over $5000,2014,0,4,0,4
D13,Break & Enter-House,2014,5,15,0,10
D13,Other,2014,6,14,0,8
D14,Fraud,2014,4,25,0,21
D13,Other Criminal Violations - Offensive Weapons,2014,3,3,1,0
D13,Robbery-Financial,2014,0,2,0,2
D13,Break & Enter-House,2014,0,10,0,10
D14,Break & Enter-Apartment,2014,3,6,0,3
D14,Fraud,2014,7,24,0,17
D13,Theft Over $5000,2014,2,3,0,1
D13,Other,2014,1,1,1,0
D13,Other Criminal Violations - Offensive Weapons,2014,1,1,1,0
D13,Robbery-Financial,2014,0,1,0,1
D13,Break & Enter-House,2014,5,17,0,12
D14,Break & Enter-Apartment,2014,1,2,0,1
D14,Fraud,2014,0,4,0,4
D13,Theft Over $5000,2014,1,3,0,2
D13,Other,2014,5,5,1,0
D13,Other Criminal Violations - Offensive Weapons,2014,7,7,1,0
D13,Robbery-Other,2014,4,12,0,8
D13,Break & Enter-House,2014,6,17,0,11
D14,Break & Enter-Apartment,2014,2,16,0,14
D14,Fraud,2014,14,44,0,30
D13,Theft Over $5000,2014,2,2,1,0
D13,Other,2014,11,11,1,0
D13,Other Criminal Violations - Offensive Weapons,2014,2,3,0,1
D13,Robbery-Other,2014,4,13,0,9
D13,Break & Enter-House,2014,5,17,0,12
D14,Break & Enter-Apartment,2014,2,6,0,4
D14,Fraud,2014,1,15,0,14
D13,Theft Over $5000,2014,1,3,0,2
D13,Other,2014,4,4,1,0
D13,Other,2014,5,5,1,0
D13,Robbery-Other,2014,5,8,0,3
D13,Break & Enter-House,2014,1,3,0,2
D14,Break & Enter-Apartment,2014,4,17,0,13
D14,Fraud,2014,8,29,0,21
D13,Theft Over $5000,2014,3,6,0,3
D13,Other,2014,7,11,0,4
D13,Other,2014,3,3,1,0
D13,Robbery-Other,2014,7,15,0,8
D13,Robbery-Other,2014,2,6,0,4
D13,Robbery-Other,2014,0,2,0,2
D13,Robbery-Other,2014,0,3,0,3
D13,Robbery-Other,2014,2,4,0,2
D13,Robbery-Other,2014,0,2,0,2
D13,Robbery-Other,2014,0,1,0,1
D13,Robbery-Other,2014,15,36,0,21
D13,Robbery-Other,2014,3,13,0,10
D13,Robbery-Other,2014,3,11,0,8
D13,Sexual Violation,2014,2,5,0,3
D13,Sexual Violation,2014,3,6,0,3
D13,Sexual Violation,2014,1,1,1,0
D13,Sexual Violation,2014,6,12,0,6
D13,Sexual Violation,2014,3,3,1,0
D13,Sexual Violation,2014,1,2,0,1
D13,Sexual Violation,2014,8,9,0,1
D13,Sexual Violation,2014,1,2,0,1
D13,Sexual Violation,2014,8,13,0,5
D13,Sexual Violation,2014,7,11,0,4
D13,Sexual Violation,2014,1,3,0,2
D13,Other,2014,14,14,1,0
D13,Other,2014,13,13,1,0
D13,Other,2014,5,5,1,0
D13,Other,2014,12,13,0,1
D13,Other,2014,1,1,1,0
D13,Other,2014,2,2,1,0
D13,Other,2014,7,7,1,0
D13,Other,2014,7,7,1,0
D13,Other,2014,10,11,0,1
D13,Other,2014,2,2,1,0
D13,Other,2014,13,13,1,0
D13,Other,2014,4,4,1,0
D13,Other,2014,10,10,1,0
D13,Other,2014,28,32,0,4
D13,Other,2014,28,28,1,0
D13,Other,2014,25,25,1,0
D13,Other,2014,48,51,0,3
D13,Other,2014,2,3,0,1
D13,Other,2014,6,7,0,1
D12,Sexual Violation,2014,8,18,0,10
D13,Other,2014,4,4,1,0
D13,Other,2014,34,35,0,1
D13,Theft Under $5000,2014,52,143,0,91
D14,Break & Enter-Apartment,2014,3,5,0,2
D14,Fraud,2014,10,19,0,9
D12,Sexual Violation,2014,1,1,1,0
D13,Other,2014,1,2,0,1
D13,Other,2014,2,2,1,0
D13,Other,2014,1,1,1,0
D13,Other,2014,7,7,1,0
D13,Other,2014,3,3,1,0
D13,Other,2014,2,2,1,0
D14,Other,2014,21,22,0,1
D14,Other,2014,33,34,0,1
D14,Other,2014,7,7,1,0
D14,Other,2014,31,39,0,8
D14,Other,2014,10,12,0,2
D14,Other,2014,150,151,0,1
D14,Other,2014,14,15,0,1
D14,Other,2014,10,10,1,0
D14,Other,2014,20,21,0,1
D14,Other,2014,66,66,1,0
D14,Other,2014,1,1,1,0
D14,Other,2014,43,44,0,1
D14,Other,2014,34,34,1,0
D14,Other,2014,50,51,0,1
D14,Other,2014,46,47,0,1
D14,Auto Theft,2014,2,8,0,6
D14,Auto Theft,2014,3,8,0,5
D14,Auto Theft,2014,3,5,0,2
D14,Auto Theft,2014,3,10,0,7
D14,Auto Theft,2014,0,3,0,3
D14,Auto Theft,2014,0,1,0,1
D14,Auto Theft,2014,4,13,0,9
D14,Auto Theft,2014,3,8,0,5
D14,Auto Theft,2014,1,1,1,0
D14,Auto Theft,2014,5,14,0,9
D14,Auto Theft,2014,1,9,0,8
D13,Break & Enter-House,2014,1,1,1,0
D13,Theft Under $5000,2014,13,52,0,39
D14,Break & Enter-Apartment,2014,1,1,1,0
D13,Other,2014,10,10,1,0
D12,Other,2014,7,9,0,2
D13,Theft Under $5000,2014,57,99,0,42
D14,Break & Enter-Apartment,2014,3,12,0,9
D13,Break & Enter-House,2014,2,10,0,8
D13,Other,2014,14,14,1,0
D12,Other,2014,22,24,0,2
D13,Theft Under $5000,2014,28,102,0,74
D14,Break & Enter-Apartment,2014,10,20,0,10
D13,Break & Enter-House,2014,3,18,0,15
D13,Auto Theft,2014,3,15,0,12
D13,Auto Theft,2014,4,11,0,7
D13,Auto Theft,2014,0,1,0,1
D13,Auto Theft,2014,6,16,0,10
D13,Auto Theft,2014,0,7,0,7
D13,Auto Theft,2014,1,7,0,6
D13,Auto Theft,2014,0,3,0,3
D13,Auto Theft,2014,3,12,0,9
D13,Auto Theft,2014,0,4,0,4
D13,Auto Theft,2014,1,4,0,3
D13,Auto Theft,2014,7,21,0,14
D13,Auto Theft,2014,2,5,0,3
D13,Auto Theft,2014,3,21,0,18
D13,Break & Enter-Apartment,2014,3,13,0,10
D13,Break & Enter-Apartment,2014,3,5,0,2
D13,Break & Enter-Apartment,2014,1,1,1,0
D13,Break & Enter-Apartment,2014,1,5,0,4
D13,Break & Enter-Apartment,2014,1,3,0,2
D13,Break & Enter-Apartment,2014,2,2,1,0
D13,Break & Enter-Apartment,2014,0,1,0,1
D13,Break & Enter-Apartment,2014,5,10,0,5
D13,Break & Enter-Apartment,2014,0,1,0,1
D13,Break & Enter-Apartment,2014,0,2,0,2
D13,Break & Enter-Apartment,2014,2,10,0,8
D13,Break & Enter-Apartment,2014,1,4,0,3
D13,Break & Enter-Apartment,2014,1,5,0,4
D13,Break & Enter-Commercial,2014,4,15,0,11
D13,Break & Enter-Commercial,2014,2,2,1,0
D13,Break & Enter-Commercial,2014,1,1,1,0
D13,Break & Enter-Commercial,2014,2,9,0,7
D13,Break & Enter-Commercial,2014,0,1,0,1
D13,Break & Enter-Commercial,2014,0,2,0,2
D13,Break & Enter-Commercial,2014,0,2,0,2
D13,Break & Enter-Commercial,2014,0,1,0,1
D13,Break & Enter-Commercial,2014,2,5,0,3
D13,Break & Enter-Commercial,2014,4,8,0,4
D13,Break & Enter-Commercial,2014,1,4,0,3
D14,Fraud,2014,2,10,0,8
D12,Other,2014,3,3,1,0
D13,Theft Under $5000,2014,4,19,0,15
D14,Break & Enter-Apartment,2014,4,14,0,10
D14,Fraud,2014,4,28,0,24
D12,Other,2014,11,13,0,2
D13,Theft Under $5000,2014,3,33,0,30
D13,Break & Enter-House,2014,3,11,0,8
D14,Break & Enter-Apartment,2014,5,16,0,11
D14,Fraud,2014,4,27,0,23
D12,Other,2014,7,7,1,0
D14,Break & Enter-Apartment,2014,9,20,0,11
D13,Break & Enter-Other,2014,0,3,0,3
D13,Theft Under $5000,2014,3,37,0,34
D13,Break & Enter-Other,2014,1,1,1,0
D14,Break & Enter-Apartment,2014,9,19,0,10
D14,Fraud,2014,1,1,1,0
D12,Other,2014,10,11,0,1
D13,Theft Under $5000,2014,23,138,0,115
D13,Break & Enter-Other,2014,0,2,0,2
D14,Break & Enter-Commercial,2014,11,26,0,15
D14,Fraud,2014,10,28,0,18
D12,Other,2014,1,1,1,0
D13,Theft Under $5000,2014,15,26,0,11
D13,Break & Enter-Other,2014,2,5,0,3
D14,Break & Enter-Commercial,2014,5,12,0,7
D14,Fraud,2014,6,14,0,8
D12,Other,2014,2,2,1,0
D13,Theft Under $5000,2014,5,14,0,9
D13,Break & Enter-Other,2014,0,2,0,2
D14,Break & Enter-Commercial,2014,1,1,1,0
D14,Break & Enter-Commercial,2014,6,8,0,2
D14,Break & Enter-Commercial,2014,2,7,0,5
D14,Break & Enter-Commercial,2014,5,17,0,12
D14,Break & Enter-Commercial,2014,6,12,0,6
D14,Break & Enter-Commercial,2014,7,20,0,13
D14,Break & Enter-Commercial,2014,10,16,0,6
D14,Break & Enter-Commercial,2014,15,28,0,13
D14,Break & Enter-Commercial,2014,9,20,0,11
D14,Break & Enter-Commercial,2014,7,21,0,14
D14,Break & Enter-Commercial,2014,5,9,0,4
D14,Break & Enter-House,2014,2,13,0,11
D14,Break & Enter-House,2014,5,20,0,15
D14,Break & Enter-House,2014,3,6,0,3
D14,Break & Enter-House,2014,0,1,0,1
D14,Break & Enter-House,2014,3,9,0,6
D14,Break & Enter-House,2014,2,5,0,3
D14,Break & Enter-House,2014,2,17,0,15
D14,Break & Enter-House,2014,4,5,0,1
D14,Break & Enter-House,2014,9,22,0,13
D14,Break & Enter-House,2014,6,11,0,5
D14,Break & Enter-House,2014,1,1,1,0
D14,Break & Enter-House,2014,0,4,0,4
D14,Break & Enter-Other,2014,2,4,0,2
D14,Break & Enter-Other,2014,0,8,0,8
D14,Break & Enter-Other,2014,1,1,1,0
D14,Break & Enter-Other,2014,1,2,0,1
D14,Break & Enter-Other,2014,0,6,0,6
D14,Break & Enter-Other,2014,2,5,0,3
D14,Break & Enter-Other,2014,1,2,0,1
D13,Theft Under $5000,2014,39,131,0,92
D14,Fraud,2014,11,33,0,22
D12,Other,2014,11,12,0,1
D13,Theft Under $5000,2014,48,113,0,65
D13,Break & Enter-Other,2014,0,1,0,1
D14,Fraud,2014,15,55,0,40
D12,Other,2014,7,8,0,1
D13,Theft Under $5000,2014,47,118,0,71
D13,Break & Enter-Other,2014,0,1,0,1
D14,Other,2014,36,88,0,52
D12,Other,2014,8,10,0,2
D13,Assault,2014,1,1,1,0
D14,Other,2014,1,1,1,0
D13,Break & Enter-Other,2014,1,1,1,0
D14,Other,2014,21,58,0,37
D12,Other,2014,6,6,1,0
D13,Assault,2014,44,54,0,10
D14,Other,2014,4,19,0,15
D13,Fraud,2014,12,29,0,17
D12,Other,2014,38,41,0,3
D13,Assault,2014,31,53,0,22
D14,Other,2014,28,77,0,49
D13,Fraud,2014,9,15,0,6
D12,Other,2014,46,52,0,6
D13,Assault,2014,10,17,0,7
D14,Other,2014,16,36,0,20
D13,Fraud,2014,1,3,0,2
D12,Other,2014,2,2,1,0
D13,Assault,2014,47,66,0,19
D14,Other,2014,59,135,0,76
D13,Fraud,2014,22,33,0,11
D12,Other,2014,8,8,1,0
D13,Assault,2014,4,7,0,3
D14,Other,2014,18,46,0,28
D13,Fraud,2014,5,9,0,4
D12,Other,2014,10,14,0,4
D13,Assault,2014,4,4,1,0
D14,Other,2014,7,13,0,6
D13,Fraud,2014,2,4,0,2
D12,Other,2014,26,26,1,0
D13,Assault,2014,10,17,0,7
D14,Other,2014,29,75,0,46
D13,Fraud,2014,5,8,0,3
D12,Other,2014,11,12,0,1
D13,Assault,2014,26,33,0,7
D14,Other,2014,48,100,0,52
D13,Fraud,2014,13,26,0,13
D12,Other,2014,35,38,0,3
D13,Assault,2014,12,15,0,3
D14,Other,2014,38,114,0,76
D13,Fraud,2014,1,1,1,0
D12,Other,2014,8,9,0,1
D13,Assault,2014,1,1,1,0
D14,Other,2014,17,57,0,40
D13,Fraud,2014,3,5,0,2
D12,Other,2014,17,20,0,3
D13,Assault,2014,9,12,0,3
D14,Other,2014,43,80,0,37
D13,Fraud,2014,23,33,0,10
D12,Other,2014,46,49,0,3
D14,Other,2014,44,98,0,54
D13,Assault,2014,82,110,0,28
D12,Other,2014,94,95,0,1
D13,Fraud,2014,12,21,0,9
D13,Assault,2014,35,50,0,15
D12,Other,2014,89,94,0,5
D14,Theft Over $5000,2014,2,3,0,1
D13,Fraud,2014,12,21,0,9
D13,Assault,2014,1,1,1,0
D12,Other,2014,11,12,0,1
D14,Theft Over $5000,2014,3,5,0,2
D13,Other,2014,0,1,0,1
D13,Assault,2014,29,37,0,8
D12,Other Criminal Violations - Offensive Weapons,2014,4,4,1,0
D14,Theft Over $5000,2014,0,2,0,2
D13,Other,2014,20,62,0,42
D13,Attempt Murder,2014,1,1,1,0
D12,Other Criminal Violations - Offensive Weapons,2014,8,9,0,1
D14,Theft Over $5000,2014,1,11,0,10
D13,Other,2014,14,40,0,26
D13,Attempt Murder,2014,2,2,1,0
D12,Other Criminal Violations - Offensive Weapons,2014,1,1,1,0
D14,Theft Over $5000,2014,2,5,0,3
D13,Other,2014,4,14,0,10
D13,Other,2014,20,29,0,9
D12,Other Criminal Violations - Offensive Weapons,2014,6,6,1,0
D14,Theft Over $5000,2014,1,7,0,6
D13,Other,2014,30,68,0,38
D13,Other,2014,11,17,0,6
D12,Other Criminal Violations - Offensive Weapons,2014,1,1,1,0
D14,Theft Over $5000,2014,3,4,0,1
D13,Other,2014,8,19,0,11
D13,Other,2014,4,9,0,5
D12,Other Criminal Violations - Offensive Weapons,2014,7,7,1,0
D14,Theft Over $5000,2014,0,1,0,1
D13,Other,2014,1,10,0,9
D13,Other,2014,16,23,0,7
D12,Other Criminal Violations - Offensive Weapons,2014,5,6,0,1
D14,Theft Over $5000,2014,1,6,0,5
D13,Other,2014,2,20,0,18
D13,Other,2014,5,6,0,1
D12,Other Criminal Violations - Offensive Weapons,2014,2,2,1,0
D14,Theft Over $5000,2014,1,3,0,2
D13,Other,2014,18,46,0,28
D13,Other,2014,2,2,1,0
D12,Other Criminal Violations - Offensive Weapons,2014,4,6,0,2
D12,Other Criminal Violations - Offensive Weapons,2014,4,5,0,1
D12,Other Criminal Violations - Offensive Weapons,2014,17,17,1,0
D12,Other Criminal Violations - Offensive Weapons,2014,1,1,1,0
D12,Other,2014,7,7,1,0
D12,Other,2014,2,2,1,0
D12,Other,2014,1,1,1,0
D12,Other,2014,4,4,1,0
D12,Other,2014,1,1,1,0
D12,Other,2014,2,2,1,0
D12,Other,2014,1,1,1,0
D12,Other,2014,2,2,1,0
D12,Other,2014,8,8,1,0
D12,Other,2014,3,3,1,0
D14,Theft Over $5000,2014,0,1,0,1
D13,Other,2014,10,26,0,16
D14,Theft Over $5000,2014,2,9,0,7
D13,Other,2014,0,1,0,1
D13,Other,2014,4,10,0,6
D14,Theft Over $5000,2014,1,5,0,4
D13,Other,2014,37,79,0,42
D14,Theft Over $5000,2014,2,11,0,9
D13,Other,2014,20,56,0,36
D14,Theft Over $5000,2014,0,6,0,6
D13,Other,2014,15,36,0,21
D14,Theft Under $5000,2014,82,216,0,134
D13,Theft Over $5000,2014,4,9,0,5
D13,Other,2014,1,2,0,1
D13,Other,2014,6,12,0,6
D22,Sexual Violation,2014,5,8,0,3
D22,Assault,2014,14,22,0,8
D22,Sexual Violation,2014,8,15,0,7
D22,Sexual Violation,2014,3,4,0,1
D22,Assault,2014,37,60,0,23
D22,Sexual Violation,2014,2,4,0,2
D22,Assault,2014,14,23,0,9
D22,Sexual Violation,2014,1,7,0,6
D22,Assault,2014,92,140,0,48
D22,Sexual Violation,2014,0,1,0,1
D22,Assault,2014,6,10,0,4
D22,Sexual Violation,2014,1,1,1,0
D22,Assault,2014,48,78,0,30
D22,Assault,2014,16,20,0,4
D22,Sexual Violation,2014,1,1,1,0
D22,Sexual Violation,2014,2,5,0,3
D22,Sexual Violation,2014,0,3,0,3
D22,Sexual Violation,2014,3,5,0,2
D22,Sexual Violation,2014,1,4,0,3
D22,Sexual Violation,2014,6,13,0,7
D22,Other,2014,4,4,1,0
D22,Other,2014,2,2,1,0
D22,Other,2014,2,2,1,0
D22,Assault,2014,64,87,0,23
D22,Other,2014,17,18,0,1
D22,Other,2014,5,5,1,0
D22,Attempt Murder,2014,2,2,1,0
D22,Other,2014,9,9,1,0
D22,Other,2014,9,9,1,0
D22,Attempt Murder,2014,1,1,1,0
D22,Other,2014,10,10,1,0
D22,Other,2014,3,3,1,0
D22,Attempt Murder,2014,1,1,1,0
D22,Other,2014,4,4,1,0
D22,Other,2014,32,33,0,1
D22,Other,2014,7,11,0,4
D22,Other,2014,2,2,1,0
D22,Other,2014,4,4,1,0
D22,Other,2014,4,7,0,3
D22,Other,2014,10,10,1,0
D22,Other,2014,19,20,0,1
D22,Other,2014,8,21,0,13
D22,Other,2014,3,3,1,0
D22,Other,2014,8,10,0,2
D22,Other,2014,25,48,0,23
D22,Other,2014,13,13,1,0
D22,Other,2014,28,28,1,0
D22,Other,2014,5,12,0,7
D22,Other,2014,3,3,1,0
D22,Auto Theft,2014,1,9,0,8
D22,Other,2014,3,10,0,7
D22,Other,2014,6,6,1,0
D22,Auto Theft,2014,4,23,0,19
D22,Other,2014,0,1,0,1
D22,Other,2014,4,5,0,1
D22,Auto Theft,2014,4,28,0,24
D22,Other,2014,5,15,0,10
D22,Other,2014,20,20,1,0
D22,Auto Theft,2014,10,65,0,55
D22,Other,2014,2,4,0,2
D22,Other,2014,13,14,0,1
D14,Theft Under $5000,2014,22,120,0,98
D22,Auto Theft,2014,0,11,0,11
D22,Auto Theft,2014,2,6,0,4
D22,Auto Theft,2014,4,27,0,23
D22,Auto Theft,2014,2,18,0,16
D22,Auto Theft,2014,1,9,0,8
D22,Auto Theft,2014,2,8,0,6
D22,Auto Theft,2014,10,29,0,19
D22,Auto Theft,2014,0,3,0,3
D22,Auto Theft,2014,3,9,0,6
D22,Auto Theft,2014,2,21,0,19
D22,Auto Theft,2014,7,39,0,32
D22,Break & Enter-Apartment,2014,2,3,0,1
D22,Break & Enter-Apartment,2014,1,5,0,4
D22,Break & Enter-Apartment,2014,2,7,0,5
D22,Break & Enter-Apartment,2014,2,9,0,7
D22,Break & Enter-Apartment,2014,8,14,0,6
D22,Break & Enter-Apartment,2014,0,7,0,7
D22,Break & Enter-Apartment,2014,1,2,0,1
D22,Break & Enter-Apartment,2014,1,1,1,0
D22,Break & Enter-Apartment,2014,1,4,0,3
D22,Break & Enter-Apartment,2014,0,2,0,2
D22,Break & Enter-Apartment,2014,5,15,0,10
D22,Break & Enter-Apartment,2014,4,8,0,4
D22,Break & Enter-Apartment,2014,0,3,0,3
D22,Break & Enter-Apartment,2014,1,8,0,7
D22,Break & Enter-Commercial,2014,0,5,0,5
D22,Break & Enter-Commercial,2014,2,5,0,3
D22,Break & Enter-Commercial,2014,0,10,0,10
D22,Break & Enter-Commercial,2014,7,41,0,34
D22,Break & Enter-Commercial,2014,0,1,0,1
D22,Break & Enter-Commercial,2014,1,4,0,3
D22,Break & Enter-Commercial,2014,1,6,0,5
D22,Break & Enter-Commercial,2014,0,2,0,2
D22,Break & Enter-Commercial,2014,3,6,0,3
D22,Break & Enter-Commercial,2014,1,2,0,1
D22,Break & Enter-Commercial,2014,6,17,0,11
D22,Break & Enter-Commercial,2014,0,1,0,1
D22,Break & Enter-Commercial,2014,0,9,0,9
D22,Other,2014,9,35,0,26
D14,Other,2014,9,16,0,7
D22,Break & Enter-Commercial,2014,5,18,0,13
D14,Other,2014,4,5,0,1
D14,Theft Under $5000,2014,6,54,0,48
D22,Other,2014,9,11,0,2
D22,Other,2014,9,16,0,7
D22,Other,2014,16,55,0,39
D22,Break & Enter-House,2014,4,9,0,5
D14,Other,2014,9,20,0,11
D22,Other,2014,16,19,0,3
D14,Theft Under $5000,2014,46,206,0,160
D22,Other,2014,5,8,0,3
D14,Other,2014,4,4,1,0
D22,Other,2014,5,37,0,32
D14,Theft Under $5000,2014,15,86,0,71
D22,Other,2014,20,30,0,10
D14,Other,2014,1,1,1,0
D22,Other,2014,84,89,0,5
D22,Break & Enter-House,2014,13,32,0,19
D14,Robbery-Financial,2014,2,2,1,0
D22,Other,2014,2,3,0,1
D22,Other,2014,19,22,0,3
D22,Other,2014,28,83,0,55
D14,Theft Under $5000,2014,0,1,0,1
D22,Break & Enter-House,2014,6,22,0,16
D14,Other,2014,11,11,1,0
D14,Robbery-Financial,2014,4,4,1,0
D22,Other,2014,14,22,0,8
D22,Other,2014,34,35,0,1
D22,Other,2014,1,6,0,5
D14,Theft Under $5000,2014,0,1,0,1
D22,Break & Enter-House,2014,2,5,0,3
D14,Other,2014,8,8,1,0
D14,Robbery-Financial,2014,2,2,1,0
D22,Other,2014,4,9,0,5
D22,Other,2014,5,5,1,0
D22,Other,2014,24,63,0,39
D14,Theft Under $5000,2014,133,385,0,252
D22,Break & Enter-House,2014,1,11,0,10
D14,Other,2014,35,42,0,7
D14,Robbery-Financial,2014,1,1,1,0
D22,Other,2014,15,32,0,17
D22,Other,2014,32,33,0,1
D22,Other,2014,5,31,0,26
D14,Theft Under $5000,2014,29,104,0,75
D22,Break & Enter-House,2014,0,2,0,2
D14,Other,2014,1,1,1,0
D14,Robbery-Financial,2014,1,1,1,0
D22,Robbery-Financial,2014,2,2,1,0
D22,Other,2014,8,12,0,4
D22,Other,2014,28,89,0,61
D14,Theft Under $5000,2014,5,22,0,17
D22,Break & Enter-House,2014,13,41,0,28
D14,Other,2014,25,27,0,2
D14,Other,2014,13,15,0,2
D14,Other,2014,26,29,0,3
D14,Other,2014,18,20,0,2
D14,Other,2014,138,145,0,7
D14,Other,2014,38,39,0,1
D14,Other,2014,12,14,0,2
D14,Other,2014,32,35,0,3
D14,Other,2014,124,132,0,8
D14,Other,2014,50,56,0,6
D14,Other,2014,50,54,0,4
D14,Other,2014,60,64,0,4
D14,Other,2014,129,134,0,5
D14,Other,2014,6,6,1,0
D14,Other Criminal Violations - Offensive Weapons,2014,2,2,1,0
D14,Other Criminal Violations - Offensive Weapons,2014,2,2,1,0
D14,Other Criminal Violations - Offensive Weapons,2014,1,2,0,1
D14,Other Criminal Violations - Offensive Weapons,2014,10,10,1,0
D14,Other Criminal Violations - Offensive Weapons,2014,1,1,1,0
D14,Other Criminal Violations - Offensive Weapons,2014,12,12,1,0
D14,Other Criminal Violations - Offensive Weapons,2014,3,3,1,0
D14,Other Criminal Violations - Offensive Weapons,2014,3,3,1,0
D14,Other Criminal Violations - Offensive Weapons,2014,9,10,0,1
D14,Other Criminal Violations - Offensive Weapons,2014,2,2,1,0
D14,Other Criminal Violations - Offensive Weapons,2014,1,1,1,0
D14,Other Criminal Violations - Offensive Weapons,2014,6,8,0,2
D14,Other Criminal Violations - Offensive Weapons,2014,9,9,1,0
D14,Other Criminal Violations - Offensive Weapons,2014,3,3,1,0
D14,Other,2014,3,3,1,0
D14,Other,2014,2,2,1,0
D14,Other,2014,5,5,1,0
D14,Other,2014,1,1,1,0
D14,Other,2014,2,2,1,0
D14,Other,2014,2,2,1,0
D14,Other,2014,5,5,1,0
D14,Other,2014,2,2,1,0
D14,Other,2014,6,6,1,0
D22,Other,2014,10,11,0,1
D22,Other,2014,5,5,1,0
D22,Other,2014,9,10,0,1
D22,Other,2014,28,29,0,1
D22,Other,2014,4,4,1,0
D22,Other,2014,33,34,0,1
D22,Other,2014,15,15,1,0
D14,Robbery-Financial,2014,4,4,1,0
D22,Other,2014,0,1,0,1
D14,Robbery-Financial,2014,2,2,1,0
D22,Robbery-Financial,2014,3,3,1,0
D14,Theft Under $5000,2014,43,208,0,165
D22,Theft Over $5000,2014,2,7,0,5
D22,Other,2014,19,20,0,1
D22,Break & Enter-House,2014,8,21,0,13
D14,Robbery-Financial,2014,2,2,1,0
D14,Theft Under $5000,2014,110,235,0,125
D22,Theft Over $5000,2014,0,3,0,3
D22,Robbery-Financial,2014,2,2,1,0
D22,Other,2014,5,7,0,2
D22,Break & Enter-House,2014,5,14,0,9
D14,Robbery-Other,2014,13,22,0,9
D14,Theft Under $5000,2014,1,1,1,0
D22,Theft Over $5000,2014,1,6,0,5
D22,Robbery-Financial,2014,1,1,1,0
D22,Other,2014,266,272,0,6
D22,Break & Enter-House,2014,12,46,0,34
D14,Robbery-Other,2014,7,18,0,11
D14,Theft Under $5000,2014,1,6,0,5
D22,Theft Over $5000,2014,7,33,0,26
D22,Robbery-Financial,2014,1,1,1,0
D22,Other,2014,5,6,0,1
D22,Break & Enter-House,2014,3,8,0,5
D14,Robbery-Other,2014,12,19,0,7
D14,Theft Under $5000,2014,79,293,0,214
D22,Theft Over $5000,2014,1,6,0,5
D22,Robbery-Other,2014,2,9,0,7
D22,Other,2014,36,37,0,1
D22,Break & Enter-House,2014,2,5,0,3
D14,Robbery-Other,2014,6,7,0,1
D14,Theft Under $5000,2014,50,199,0,149
D22,Theft Over $5000,2014,1,3,0,2
D22,Robbery-Other,2014,2,4,0,2
D22,Other,2014,10,10,1,0
D22,Break & Enter-House,2014,8,30,0,22
D14,Robbery-Other,2014,0,2,0,2
D14,Theft Under $5000,2014,89,354,0,265
D22,Theft Over $5000,2014,0,3,0,3
D22,Robbery-Other,2014,9,12,0,3
D22,Other,2014,52,59,0,7
D22,Break & Enter-House,2014,20,41,0,21
D14,Theft Under $5000,2014,112,280,0,168
D22,Theft Over $5000,2014,1,2,0,1
D22,Robbery-Other,2014,5,16,0,11
D14,Robbery-Other,2014,24,47,0,23
D14,Assault,2014,57,69,0,12
D22,Other,2014,1,1,1,0
D22,Break & Enter-Other,2014,0,1,0,1
D14,Robbery-Other,2014,2,3,0,1
D14,Assault,2014,1,1,1,0
D22,Other Criminal Violations - Offensive Weapons,2014,4,4,1,0
D22,Theft Over $5000,2014,0,3,0,3
D22,Robbery-Other,2014,6,13,0,7
D22,Break & Enter-Other,2014,0,2,0,2
D14,Robbery-Other,2014,4,5,0,1
D14,Assault,2014,35,45,0,10
D22,Other Criminal Violations - Offensive Weapons,2014,1,1,1,0
D22,Theft Over $5000,2014,2,4,0,2
D22,Robbery-Other,2014,0,1,0,1
D22,Break & Enter-Other,2014,0,2,0,2
D14,Robbery-Other,2014,10,24,0,14
D14,Assault,2014,15,24,0,9
D22,Other Criminal Violations - Offensive Weapons,2014,1,1,1,0
D22,Theft Over $5000,2014,0,3,0,3
D22,Robbery-Other,2014,7,14,0,7
D22,Break & Enter-Other,2014,3,5,0,2
D14,Robbery-Other,2014,12,19,0,7
D14,Assault,2014,66,88,0,22
D22,Other Criminal Violations - Offensive Weapons,2014,9,9,1,0
D22,Theft Over $5000,2014,0,3,0,3
D22,Robbery-Other,2014,4,7,0,3
D22,Break & Enter-Other,2014,1,1,1,0
D14,Robbery-Other,2014,12,18,0,6
D14,Assault,2014,25,32,0,7
D22,Other Criminal Violations - Offensive Weapons,2014,1,2,0,1
D22,Theft Over $5000,2014,2,9,0,7
D22,Robbery-Other,2014,4,12,0,8
D22,Break & Enter-Other,2014,0,2,0,2
D14,Robbery-Other,2014,22,32,0,10
D14,Assault,2014,1,1,1,0
D22,Theft Under $5000,2014,8,76,0,68
D22,Robbery-Other,2014,4,8,0,4
D22,Break & Enter-Other,2014,0,2,0,2
D22,Theft Under $5000,2014,1,1,1,0
D14,Robbery-Other,2014,8,9,0,1
D14,Assault,2014,114,157,0,43
D22,Robbery-Other,2014,4,8,0,4
D22,Break & Enter-Other,2014,0,2,0,2
D14,Robbery-Other,2014,11,13,0,2
D14,Assault,2014,36,50,0,14
D22,Robbery-Other,2014,4,5,0,1
D22,Theft Under $5000,2014,16,126,0,110
D22,Break & Enter-Other,2014,0,1,0,1
D14,Sexual Violation,2014,3,6,0,3
D14,Assault,2014,7,15,0,8
D22,Robbery-Other,2014,6,15,0,9
D22,Theft Under $5000,2014,7,107,0,100
D22,Break & Enter-Other,2014,0,3,0,3
D14,Sexual Violation,2014,0,1,0,1
D14,Assault,2014,43,79,0,36
D22,Robbery-Other,2014,12,14,0,2
D22,Theft Under $5000,2014,292,680,0,388
D22,Fraud,2014,4,15,0,11
D14,Sexual Violation,2014,5,7,0,2
D14,Assault,2014,122,164,0,42
D22,Robbery-Other,2014,12,19,0,7
D22,Theft Under $5000,2014,1,43,0,42
D22,Fraud,2014,1,1,1,0
D14,Sexual Violation,2014,0,2,0,2
D14,Assault,2014,69,105,0,36
D22,Sexual Violation,2014,3,4,0,1
D22,Theft Under $5000,2014,0,1,0,1
D22,Fraud,2014,5,19,0,14
D14,Sexual Violation,2014,5,12,0,7
D14,Assault,2014,51,86,0,35
D22,Sexual Violation,2014,0,1,0,1
D22,Theft Under $5000,2014,5,78,0,73
D22,Fraud,2014,17,30,0,13
D14,Sexual Violation,2014,8,8,1,0
D14,Assault,2014,81,148,0,67
D22,Sexual Violation,2014,0,1,0,1
D22,Theft Under $5000,2014,43,198,0,155
D22,Fraud,2014,71,155,0,84
D14,Sexual Violation,2014,13,17,0,4
D14,Assault,2014,0,1,0,1
D22,Theft Under $5000,2014,63,126,0,63
D22,Fraud,2014,3,19,0,16
D14,Sexual Violation,2014,3,7,0,4
D14,Assault,2014,92,120,0,28
D22,Theft Under $5000,2014,0,1,0,1
D14,Sexual Violation,2014,2,7,0,5
D22,Fraud,2014,5,21,0,16
D22,Theft Under $5000,2014,22,93,0,71
D14,Attempt Murder,2014,2,2,1,0
D14,Sexual Violation,2014,9,10,0,1
D22,Fraud,2014,22,74,0,52
D22,Theft Under $5000,2014,15,125,0,110
D14,Attempt Murder,2014,1,1,1,0
D14,Sexual Violation,2014,15,24,0,9
D22,Fraud,2014,2,7,0,5
D22,Theft Under $5000,2014,22,149,0,127
D14,Attempt Murder,2014,1,1,1,0
D14,Sexual Violation,2014,9,14,0,5
D22,Fraud,2014,5,11,0,6
D22,Theft Under $5000,2014,5,28,0,23
D14,Attempt Murder,2014,2,2,1,0
D14,Sexual Violation,2014,7,9,0,2
D22,Fraud,2014,8,24,0,16
D22,Theft Under $5000,2014,22,99,0,77
D14,Other,2014,11,16,0,5
D14,Sexual Violation,2014,2,6,0,4
D22,Fraud,2014,9,25,0,16
D22,Theft Under $5000,2014,28,160,0,132
D14,Other,2014,10,14,0,4
D14,Sexual Violation,2014,4,8,0,4
D22,Fraud,2014,7,21,0,14
D22,Theft Under $5000,2014,0,1,0,1
D14,Other,2014,7,11,0,4
D14,Other,2014,4,4,1,0
D22,Fraud,2014,9,21,0,12
D22,Theft Under $5000,2014,67,263,0,196
D14,Other,2014,11,15,0,4
D14,Other,2014,8,8,1,0
D22,Fraud,2014,3,29,0,26
D22,Theft Under $5000,2014,0,1,0,1
D14,Other,2014,14,16,0,2
D14,Other,2014,1,1,1,0
D22,Fraud,2014,20,52,0,32
D22,Theft Under $5000,2014,1,1,1,0
D14,Other,2014,17,28,0,11
D14,Other,2014,13,13,1,0
D22,Fraud,2014,0,1,0,1
D22,Assault,2014,31,40,0,9
D14,Other,2014,9,22,0,13
D22,Other,2014,11,45,0,34
D14,Other,2014,9,9,1,0
D22,Other,2014,0,1,0,1
D22,Assault,2014,15,23,0,8
D14,Other,2014,9,9,1,0
D22,Other,2014,7,30,0,23
D14,Other,2014,1,1,1,0
D22,Assault,2014,31,47,0,16
D14,Other,2014,2,2,1,0
D22,Other,2014,6,61,0,55
D14,Other,2014,19,23,0,4
D22,Assault,2014,91,140,0,49
D14,Other,2014,1,1,1,0
D22,Other,2014,37,144,0,107
D14,Other,2014,31,45,0,14
D22,Assault,2014,31,41,0,10
D14,Other,2014,7,7,1,0
D22,Other,2014,11,42,0,31
D14,Other,2014,10,21,0,11
D22,Assault,2014,39,57,0,18
D14,Other,2014,21,22,0,1
D22,Other,2014,13,30,0,17
D14,Other,2014,8,11,0,3
D22,Assault,2014,57,86,0,29
D22,Other,2014,24,73,0,49
D23,Robbery-Other,2014,8,12,0,4
D22,Other Criminal Violations - Offensive Weapons,2014,1,1,1,0
D23,Robbery-Other,2014,6,20,0,14
D23,Robbery-Other,2014,41,78,0,37
D23,Robbery-Other,2014,0,1,0,1
D22,Other Criminal Violations - Offensive Weapons,2014,6,7,0,1
D23,Break & Enter-Commercial,2014,1,3,0,2
D23,Robbery-Other,2014,13,20,0,7
D22,Other Criminal Violations - Offensive Weapons,2014,2,2,1,0
D23,Sexual Violation,2014,1,2,0,1
D31,Attempt Murder,2014,1,1,1,0
D23,Break & Enter-Commercial,2014,2,11,0,9
D22,Other Criminal Violations - Offensive Weapons,2014,4,4,1,0
D23,Sexual Violation,2014,2,6,0,4
D31,Attempt Murder,2014,1,1,1,0
D31,Other,2014,100,114,0,14
D23,Break & Enter-Commercial,2014,1,3,0,2
D23,Theft Over $5000,2014,0,1,0,1
D22,Other Criminal Violations - Offensive Weapons,2014,0,1,0,1
D23,Sexual Violation,2014,2,3,0,1
D31,Attempt Murder,2014,0,3,0,3
D31,Break & Enter-Other,2014,2,5,0,3
D23,Other,2014,2,2,1,0
D23,Break & Enter-Commercial,2014,0,1,0,1
D23,Break & Enter-Commercial,2014,0,2,0,2
D23,Break & Enter-Commercial,2014,2,9,0,7
D23,Break & Enter-Commercial,2014,21,71,0,50
D23,Break & Enter-Commercial,2014,3,7,0,4
D23,Break & Enter-House,2014,1,2,0,1
D23,Break & Enter-House,2014,3,11,0,8
D23,Break & Enter-House,2014,2,9,0,7
D23,Break & Enter-House,2014,3,8,0,5
D23,Break & Enter-House,2014,2,8,0,6
D23,Break & Enter-House,2014,1,10,0,9
D23,Break & Enter-House,2014,13,52,0,39
D23,Break & Enter-House,2014,1,20,0,19
D23,Break & Enter-Other,2014,1,2,0,1
D23,Break & Enter-Other,2014,0,1,0,1
D23,Break & Enter-Other,2014,0,1,0,1
D23,Break & Enter-Other,2014,0,2,0,2
D23,Break & Enter-Other,2014,3,10,0,7
D23,Break & Enter-Other,2014,0,1,0,1
D23,Fraud,2014,0,2,0,2
D23,Fraud,2014,8,19,0,11
D23,Fraud,2014,8,20,0,12
D23,Fraud,2014,0,2,0,2
D23,Fraud,2014,16,42,0,26
D23,Fraud,2014,32,86,0,54
D23,Fraud,2014,2,11,0,9
D23,Fraud,2014,1,1,1,0
D23,Fraud,2014,6,18,0,12
D23,Fraud,2014,10,24,0,14
D23,Fraud,2014,74,197,0,123
D23,Fraud,2014,8,36,0,28
D23,Other,2014,0,3,0,3
D23,Other,2014,9,30,0,21
D23,Other,2014,7,40,0,33
D23,Other,2014,1,2,0,1
D23,Other,2014,18,82,0,64
D23,Other,2014,29,93,0,64
D23,Other,2014,2,15,0,13
D23,Other,2014,8,26,0,18
D23,Other,2014,4,19,0,15
D23,Other,2014,69,209,0,140
D23,Other,2014,17,73,0,56
D23,Theft Over $5000,2014,0,1,0,1
D23,Theft Over $5000,2014,0,2,0,2
D31,Other Criminal Violations - Offensive Weapons,2014,34,46,0,12
D23,Theft Over $5000,2014,1,5,0,4
D23,Theft Over $5000,2014,2,5,0,3
D23,Theft Over $5000,2014,0,1,0,1
D23,Sexual Violation,2014,6,10,0,4
D23,Sexual Violation,2014,31,40,0,9
D22,Other Criminal Violations - Offensive Weapons,2014,1,1,1,0
D31,Other Criminal Violations - Offensive Weapons,2014,7,9,0,2
D23,Other,2014,4,4,1,0
D23,Theft Over $5000,2014,1,2,0,1
D22,Other Criminal Violations - Offensive Weapons,2014,5,5,1,0
D31,Attempt Murder,2014,1,1,1,0
D23,Other,2014,2,2,1,0
D31,Other Criminal Violations - Offensive Weapons,2014,37,43,0,6
D23,Sexual Violation,2014,5,12,0,7
D31,Other Criminal Violations - Offensive Weapons,2014,11,13,0,2
D31,Break & Enter-Other,2014,0,2,0,2
D23,Sexual Violation,2014,3,3,1,0
D23,Theft Over $5000,2014,0,1,0,1
D22,Other Criminal Violations - Offensive Weapons,2014,3,3,1,0
D31,Attempt Murder,2014,2,2,1,0
D31,Other Criminal Violations - Offensive Weapons,2014,9,10,0,1
D31,Break & Enter-Other,2014,3,6,0,3
D23,Other,2014,11,12,0,1
D23,Sexual Violation,2014,4,6,0,2
D23,Theft Over $5000,2014,3,41,0,38
D22,Other Criminal Violations - Offensive Weapons,2014,6,7,0,1
D31,Other,2014,24,34,0,10
D31,Other Criminal Violations - Offensive Weapons,2014,24,29,0,5
D31,Fraud,2014,1,1,1,0
D23,Other,2014,2,2,1,0
D23,Sexual Violation,2014,33,42,0,9
D23,Theft Over $5000,2014,0,4,0,4
D22,Other,2014,1,1,1,0
D31,Other,2014,15,23,0,8
D31,Other Criminal Violations - Offensive Weapons,2014,3,4,0,1
D31,Fraud,2014,29,63,0,34
D31,Other,2014,61,64,0,3
D23,Sexual Violation,2014,13,18,0,5
D23,Theft Under $5000,2014,2,5,0,3
D22,Other,2014,4,4,1,0
D31,Other,2014,55,74,0,19
D31,Other Criminal Violations - Offensive Weapons,2014,21,30,0,9
D31,Fraud,2014,25,37,0,12
D31,Other,2014,18,20,0,2
D23,Theft Under $5000,2014,73,132,0,59
D22,Other,2014,1,1,1,0
D23,Other,2014,7,7,1,0
D31,Other,2014,4,4,1,0
D31,Other,2014,12,22,0,10
D31,Fraud,2014,31,55,0,24
D31,Other,2014,77,83,0,6
D31,Other,2014,23,35,0,12
D23,Theft Under $5000,2014,2,83,0,81
D31,Other,2014,4,4,1,0
D23,Other,2014,3,4,0,1
D22,Other,2014,1,1,1,0
D31,Other,2014,11,12,0,1
D31,Fraud,2014,19,53,0,34
D31,Other,2014,2,4,0,2
D23,Theft Under $5000,2014,34,214,0,180
D31,Other,2014,12,12,1,0
D23,Other,2014,10,11,0,1
D22,Other,2014,1,1,1,0
D31,Other,2014,24,24,1,0
D31,Fraud,2014,12,25,0,13
D31,Other,2014,31,48,0,17
D23,Theft Under $5000,2014,118,304,0,186
D31,Other,2014,3,3,1,0
D23,Other,2014,12,12,1,0
D22,Other,2014,1,1,1,0
D31,Other,2014,4,7,0,3
D31,Fraud,2014,1,1,1,0
D31,Other,2014,7,9,0,2
D23,Theft Under $5000,2014,0,19,0,19
D31,Other,2014,1,1,1,0
D23,Other,2014,6,6,1,0
D22,Other,2014,2,2,1,0
D31,Other,2014,81,85,0,4
D31,Fraud,2014,3,10,0,7
D31,Other,2014,37,52,0,15
D23,Theft Under $5000,2014,0,1,0,1
D31,Other,2014,1,1,1,0
D23,Other,2014,2,2,1,0
D22,Other,2014,1,1,1,0
D31,Other,2014,5,5,1,0
D31,Fraud,2014,33,65,0,32
D31,Robbery-Other,2014,16,41,0,25
D23,Theft Under $5000,2014,10,94,0,84
D31,Other,2014,13,13,1,0
D23,Other,2014,9,9,1,0
D22,Other,2014,3,4,0,1
D31,Other,2014,45,48,0,3
D31,Auto Theft,2014,10,43,0,33
D31,Auto Theft,2014,3,22,0,19
D31,Auto Theft,2014,9,45,0,36
D31,Auto Theft,2014,23,70,0,47
D31,Auto Theft,2014,1,36,0,35
D31,Auto Theft,2014,17,68,0,51
D31,Auto Theft,2014,1,10,0,9
D31,Auto Theft,2014,16,85,0,69
D31,Break & Enter-Apartment,2014,5,15,0,10
D31,Break & Enter-Apartment,2014,1,7,0,6
D31,Break & Enter-Apartment,2014,8,19,0,11
D31,Break & Enter-Apartment,2014,1,4,0,3
D31,Break & Enter-Apartment,2014,0,8,0,8
D31,Break & Enter-Apartment,2014,0,1,0,1
D31,Break & Enter-Apartment,2014,6,17,0,11
D31,Break & Enter-Apartment,2014,1,1,1,0
D31,Break & Enter-Apartment,2014,6,21,0,15
D31,Break & Enter-Commercial,2014,4,6,0,2
D31,Break & Enter-Commercial,2014,0,2,0,2
D31,Break & Enter-Commercial,2014,1,4,0,3
D31,Break & Enter-Commercial,2014,17,44,0,27
D31,Break & Enter-Commercial,2014,11,17,0,6
D31,Break & Enter-Commercial,2014,6,11,0,5
D31,Break & Enter-Commercial,2014,1,1,1,0
D31,Break & Enter-Commercial,2014,11,20,0,9
D31,Break & Enter-House,2014,2,5,0,3
D31,Break & Enter-House,2014,2,6,0,4
D31,Break & Enter-House,2014,4,10,0,6
D31,Break & Enter-House,2014,0,6,0,6
D31,Break & Enter-House,2014,1,8,0,7
D31,Break & Enter-House,2014,5,24,0,19
D31,Break & Enter-House,2014,0,4,0,4
D31,Break & Enter-House,2014,7,13,0,6
D31,Break & Enter-Other,2014,1,1,1,0
D31,Break & Enter-Other,2014,0,3,0,3
D31,Break & Enter-Other,2014,0,2,0,2
D31,Robbery-Other,2014,9,23,0,14
D23,Other,2014,10,10,1,0
D23,Other,2014,21,21,1,0
D31,Other,2014,2,2,1,0
D31,Robbery-Other,2014,25,48,0,23
D23,Other,2014,2,2,1,0
D23,Other,2014,48,48,1,0
D32,Other,2014,6,6,1,0
D31,Robbery-Other,2014,12,21,0,9
D31,Fraud,2014,3,7,0,4
D23,Other,2014,12,12,1,0
D23,Other,2014,10,10,1,0
D31,Fraud,2014,36,87,0,51
D32,Other,2014,6,6,1,0
D23,Other,2014,1,1,1,0
D31,Robbery-Other,2014,12,28,0,16
D23,Other,2014,6,7,0,1
D23,Theft Under $5000,2014,9,66,0,57
D31,Other,2014,42,101,0,59
D32,Other,2014,0,1,0,1
D23,Other,2014,24,25,0,1
D31,Robbery-Other,2014,0,1,0,1
D23,Other,2014,21,21,1,0
D23,Theft Under $5000,2014,160,810,0,650
D31,Other,2014,23,51,0,28
D32,Other,2014,1,2,0,1
D23,Other,2014,1,1,1,0
D31,Robbery-Other,2014,14,35,0,21
D23,Other,2014,1,1,1,0
D23,Theft Under $5000,2014,25,186,0,161
D31,Other,2014,65,147,0,82
D32,Other,2014,14,16,0,2
D23,Other,2014,53,55,0,2
D31,Robbery-Other,2014,4,7,0,3
D23,Other,2014,8,12,0,4
D23,Assault,2014,1,1,1,0
D31,Other,2014,28,84,0,56
D32,Other,2014,2,2,1,0
D23,Other,2014,8,8,1,0
D31,Robbery-Other,2014,17,50,0,33
D23,Other,2014,8,8,1,0
D23,Assault,2014,30,39,0,9
D31,Other,2014,32,68,0,36
D32,Other,2014,8,8,1,0
D23,Other,2014,10,10,1,0
D31,Sexual Violation,2014,17,23,0,6
D23,Other,2014,41,48,0,7
D23,Assault,2014,1,1,1,0
D31,Other,2014,4,6,0,2
D32,Other,2014,11,12,0,1
D23,Other,2014,15,17,0,2
D31,Sexual Violation,2014,5,5,1,0
D23,Assault,2014,15,22,0,7
D23,Other,2014,104,111,0,7
D31,Other,2014,60,104,0,44
D23,Other,2014,66,75,0,9
D32,Other,2014,10,12,0,2
D31,Sexual Violation,2014,22,26,0,4
D23,Other,2014,22,24,0,2
D32,Other,2014,3,3,1,0
D23,Assault,2014,62,87,0,25
D23,Other,2014,7,9,0,2
D31,Sexual Violation,2014,5,12,0,7
D23,Auto Theft,2014,0,3,0,3
D31,Other,2014,9,15,0,6
D32,Other,2014,3,3,1,0
D23,Assault,2014,150,203,0,53
D23,Other,2014,2,2,1,0
D31,Sexual Violation,2014,0,3,0,3
D23,Auto Theft,2014,2,7,0,5
D31,Other,2014,81,148,0,67
D32,Other,2014,10,10,1,0
D23,Assault,2014,5,13,0,8
D23,Other,2014,13,14,0,1
D31,Sexual Violation,2014,4,8,0,4
D23,Auto Theft,2014,5,27,0,22
D31,Theft Over $5000,2014,4,9,0,5
D32,Other,2014,27,29,0,2
D23,Assault,2014,1,2,0,1
D23,Other,2014,1,1,1,0
D31,Sexual Violation,2014,25,29,0,4
D23,Auto Theft,2014,5,59,0,54
D31,Theft Over $5000,2014,2,4,0,2
D32,Other,2014,2,2,1,0
D23,Assault,2014,26,44,0,18
D23,Other,2014,17,17,1,0
D31,Sexual Violation,2014,0,2,0,2
D23,Auto Theft,2014,6,64,0,58
D31,Theft Over $5000,2014,2,7,0,5
D32,Other,2014,10,10,1,0
D23,Assault,2014,33,57,0,24
D23,Other,2014,139,150,0,11
D31,Sexual Violation,2014,18,33,0,15
D23,Auto Theft,2014,0,1,0,1
D31,Theft Over $5000,2014,7,15,0,8
D32,Other,2014,13,14,0,1
D23,Assault,2014,168,258,0,90
D31,Other,2014,15,15,1,0
D23,Auto Theft,2014,2,13,0,11
D23,Other,2014,25,30,0,5
D31,Theft Over $5000,2014,0,1,0,1
D32,Other,2014,12,12,1,0
D23,Assault,2014,57,71,0,14
D23,Other,2014,1,1,1,0
D31,Theft Over $5000,2014,4,10,0,6
D32,Other,2014,4,5,0,1
D31,Other,2014,17,17,1,0
D23,Auto Theft,2014,0,10,0,10
D23,Attempt Murder,2014,1,1,1,0
D23,Other Criminal Violations - Offensive Weapons,2014,2,2,1,0
D31,Theft Over $5000,2014,0,1,0,1
D32,Other,2014,29,30,0,1
D31,Other,2014,19,20,0,1
D23,Auto Theft,2014,26,314,0,288
D23,Attempt Murder,2014,2,2,1,0
D23,Other Criminal Violations - Offensive Weapons,2014,1,2,0,1
D31,Theft Over $5000,2014,9,18,0,9
D32,Auto Theft,2014,0,9,0,9
D31,Other,2014,17,17,1,0
D23,Auto Theft,2014,3,45,0,42
D23,Attempt Murder,2014,1,1,1,0
D23,Other Criminal Violations - Offensive Weapons,2014,2,4,0,2
D31,Theft Under $5000,2014,65,165,0,100
D32,Auto Theft,2014,1,38,0,37
D31,Other,2014,22,23,0,1
D23,Break & Enter-Apartment,2014,0,2,0,2
D23,Other,2014,1,1,1,0
D23,Other Criminal Violations - Offensive Weapons,2014,26,29,0,3
D31,Theft Under $5000,2014,34,132,0,98
D32,Auto Theft,2014,1,32,0,31
D31,Other,2014,8,8,1,0
D23,Break & Enter-Apartment,2014,0,5,0,5
D23,Other,2014,9,16,0,7
D23,Other Criminal Violations - Offensive Weapons,2014,1,1,1,0
D31,Theft Under $5000,2014,87,257,0,170
D32,Auto Theft,2014,0,1,0,1
D31,Other,2014,17,18,0,1
D23,Break & Enter-Apartment,2014,2,18,0,16
D23,Other,2014,4,8,0,4
D23,Other Criminal Violations - Offensive Weapons,2014,3,4,0,1
D23,Other Criminal Violations - Offensive Weapons,2014,5,6,0,1
D32,Auto Theft,2014,0,70,0,70
D31,Theft Under $5000,2014,65,190,0,125
D23,Break & Enter-Apartment,2014,1,13,0,12
D31,Other,2014,8,8,1,0
D23,Other,2014,18,34,0,16
D31,Theft Under $5000,2014,16,75,0,59
D23,Break & Enter-Apartment,2014,0,1,0,1
D31,Other,2014,10,10,1,0
D23,Other Criminal Violations - Offensive Weapons,2014,12,15,0,3
D32,Auto Theft,2014,0,17,0,17
D23,Other,2014,22,40,0,18
D31,Theft Under $5000,2014,4,11,0,7
D23,Break & Enter-Apartment,2014,0,6,0,6
D31,Other,2014,79,89,0,10
D23,Other Criminal Violations - Offensive Weapons,2014,4,4,1,0
D32,Auto Theft,2014,8,17,0,9
D23,Other,2014,4,8,0,4
D31,Theft Under $5000,2014,226,405,0,179
D23,Break & Enter-Apartment,2014,0,1,0,1
D31,Other,2014,41,48,0,7
D23,Other,2014,2,2,1,0
D32,Auto Theft,2014,1,22,0,21
D23,Other,2014,6,15,0,9
D31,Theft Under $5000,2014,12,45,0,33
D23,Break & Enter-Apartment,2014,1,15,0,14
D31,Other,2014,150,158,0,8
D32,Auto Theft,2014,0,18,0,18
D23,Other,2014,9,17,0,8
D31,Theft Under $5000,2014,104,339,0,235
D23,Break & Enter-Apartment,2014,2,15,0,13
D31,Other,2014,20,22,0,2
D32,Auto Theft,2014,2,24,0,22
D23,Other,2014,42,69,0,27
D31,Assault,2014,125,186,0,61
D23,Break & Enter-Commercial,2014,1,2,0,1
D31,Other,2014,276,280,0,4
D32,Auto Theft,2014,2,15,0,13
D23,Other,2014,13,27,0,14
D31,Assault,2014,50,67,0,17
D31,Other,2014,1,1,1,0
D23,Robbery-Financial,2014,1,1,1,0
D32,Auto Theft,2014,0,52,0,52
D31,Other,2014,5,6,0,1
D31,Assault,2014,194,253,0,59
D23,Robbery-Other,2014,0,2,0,2
D32,Auto Theft,2014,0,8,0,8
D31,Other,2014,103,110,0,7
D31,Assault,2014,44,58,0,14
D23,Robbery-Other,2014,4,14,0,10
D32,Auto Theft,2014,1,29,0,28
D31,Other,2014,14,16,0,2
D31,Assault,2014,88,104,0,16
D23,Robbery-Other,2014,4,10,0,6
D31,Assault,2014,1,7,0,6
D23,Robbery-Other,2014,0,1,0,1
D31,Assault,2014,138,186,0,48
D23,Robbery-Other,2014,2,16,0,14
D31,Assault,2014,20,23,0,3
D23,Robbery-Other,2014,31,69,0,38
D31,Assault,2014,149,190,0,41
D23,Robbery-Other,2014,0,2,0,2
D31,Attempt Murder,2014,0,2,0,2
D23,Robbery-Other,2014,1,5,0,4
D32,Other,2014,30,110,0,80
D32,Other,2014,3,22,0,19
D32,Other,2014,21,87,0,66
D32,Other,2014,23,51,0,28
D32,Other,2014,24,70,0,46
D32,Other,2014,1,1,1,0
D32,Other,2014,11,39,0,28
D32,Other,2014,125,182,0,57
D32,Theft Over $5000,2014,0,2,0,2
D32,Theft Over $5000,2014,1,2,0,1
D32,Theft Over $5000,2014,0,10,0,10
D32,Theft Over $5000,2014,1,5,0,4
D32,Theft Over $5000,2014,1,5,0,4
D32,Theft Over $5000,2014,0,1,0,1
D32,Theft Over $5000,2014,0,4,0,4
D32,Theft Over $5000,2014,0,2,0,2
D32,Theft Over $5000,2014,1,4,0,3
D32,Theft Over $5000,2014,1,4,0,3
D32,Theft Over $5000,2014,0,1,0,1
D32,Theft Over $5000,2014,3,8,0,5
D33,Other,2014,14,18,0,4
D32,Robbery-Other,2014,12,24,0,12
D32,Auto Theft,2014,1,9,0,8
D32,Break & Enter-House,2014,5,18,0,13
D32,Other,2014,13,16,0,3
D32,Theft Over $5000,2014,0,3,0,3
D32,Theft Over $5000,2014,0,3,0,3
D32,Theft Over $5000,2014,0,4,0,4
D32,Theft Over $5000,2014,1,4,0,3
D32,Theft Over $5000,2014,2,13,0,11
D32,Theft Over $5000,2014,8,17,0,9
D32,Theft Under $5000,2014,16,70,0,54
D33,Break & Enter-Commercial,2014,0,1,0,1
D32,Theft Under $5000,2014,4,97,0,93
D32,Theft Under $5000,2014,26,137,0,111
D32,Theft Under $5000,2014,0,21,0,21
D32,Theft Under $5000,2014,61,164,0,103
D32,Theft Under $5000,2014,5,48,0,43
D32,Theft Under $5000,2014,4,53,0,49
D32,Theft Under $5000,2014,69,136,0,67
D32,Theft Under $5000,2014,28,167,0,139
D32,Theft Under $5000,2014,6,95,0,89
D32,Theft Under $5000,2014,0,1,0,1
D32,Theft Under $5000,2014,5,20,0,15
D32,Theft Under $5000,2014,19,97,0,78
D32,Theft Under $5000,2014,99,289,0,190
D32,Theft Under $5000,2014,5,52,0,47
D32,Theft Under $5000,2014,18,149,0,131
D32,Theft Under $5000,2014,37,126,0,89
D32,Theft Under $5000,2014,159,276,0,117
D32,Theft Under $5000,2014,89,231,0,142
D32,Theft Under $5000,2014,462,745,0,283
D32,Assault,2014,21,34,0,13
D32,Assault,2014,33,41,0,8
D32,Assault,2014,31,44,0,13
D32,Assault,2014,3,4,0,1
D32,Assault,2014,52,68,0,16
D32,Other,2014,5,5,1,0
D32,Break & Enter-House,2014,1,21,0,20
D33,Other,2014,7,7,1,0
D32,Robbery-Other,2014,2,11,0,9
D33,Break & Enter-Commercial,2014,4,9,0,5
D32,Other,2014,1,1,1,0
D32,Break & Enter-House,2014,1,6,0,5
D33,Other,2014,1,1,1,0
D32,Robbery-Other,2014,0,2,0,2
D33,Break & Enter-Commercial,2014,1,1,1,0
D32,Other,2014,11,15,0,4
D32,Break & Enter-Other,2014,0,2,0,2
D33,Other,2014,1,1,1,0
D32,Robbery-Other,2014,2,7,0,5
D32,Robbery-Other,2014,14,21,0,7
D32,Robbery-Other,2014,0,3,0,3
D32,Robbery-Other,2014,0,1,0,1
D32,Robbery-Other,2014,5,13,0,8
D32,Robbery-Other,2014,9,13,0,4
D32,Robbery-Other,2014,0,5,0,5
D32,Robbery-Other,2014,0,5,0,5
D32,Robbery-Other,2014,3,11,0,8
D32,Sexual Violation,2014,7,13,0,6
D32,Sexual Violation,2014,6,10,0,4
D32,Sexual Violation,2014,1,4,0,3
D32,Sexual Violation,2014,0,1,0,1
D32,Sexual Violation,2014,7,9,0,2
D32,Sexual Violation,2014,3,5,0,2
D32,Sexual Violation,2014,0,3,0,3
D32,Sexual Violation,2014,2,8,0,6
D32,Sexual Violation,2014,4,10,0,6
D32,Sexual Violation,2014,3,4,0,1
D32,Sexual Violation,2014,3,6,0,3
D32,Sexual Violation,2014,8,14,0,6
D32,Sexual Violation,2014,10,17,0,7
D32,Sexual Violation,2014,4,5,0,1
D32,Sexual Violation,2014,9,14,0,5
D32,Sexual Violation,2014,5,11,0,6
D32,Sexual Violation,2014,5,10,0,5
D32,Sexual Violation,2014,2,4,0,2
D32,Sexual Violation,2014,4,10,0,6
D32,Other,2014,3,3,1,0
D32,Other,2014,7,7,1,0
D32,Other,2014,6,6,1,0
D32,Other,2014,1,1,1,0
D32,Other,2014,3,3,1,0
D32,Other,2014,3,3,1,0
D32,Other,2014,2,2,1,0
D32,Other,2014,2,2,1,0
D32,Other,2014,2,2,1,0
D32,Other,2014,5,6,0,1
D32,Other,2014,8,8,1,0
D32,Other,2014,6,6,1,0
D32,Other,2014,12,12,1,0
D32,Other,2014,4,4,1,0
D32,Other,2014,9,9,1,0
D32,Other,2014,6,6,1,0
D32,Other,2014,14,14,1,0
D32,Other,2014,8,8,1,0
D32,Other,2014,11,11,1,0
D33,Break & Enter-House,2014,1,19,0,18
D32,Other,2014,2,4,0,2
D32,Break & Enter-Other,2014,2,2,1,0
D33,Other,2014,23,25,0,2
D33,Break & Enter-House,2014,0,25,0,25
D32,Other,2014,30,33,0,3
D32,Break & Enter-Other,2014,1,3,0,2
D33,Other,2014,15,16,0,1
D33,Break & Enter-House,2014,1,16,0,15
D32,Other,2014,8,9,0,1
D32,Break & Enter-Other,2014,1,3,0,2
D33,Other,2014,3,3,1,0
D33,Break & Enter-House,2014,0,6,0,6
D32,Other,2014,7,7,1,0
D32,Break & Enter-Other,2014,1,1,1,0
D33,Other,2014,10,11,0,1
D33,Break & Enter-House,2014,2,32,0,30
D32,Other,2014,26,29,0,3
D32,Break & Enter-Other,2014,1,2,0,1
D33,Other,2014,6,6,1,0
D33,Break & Enter-House,2014,2,10,0,8
D32,Other,2014,1,1,1,0
D32,Break & Enter-Other,2014,0,2,0,2
D33,Other,2014,1,1,1,0
D33,Break & Enter-House,2014,3,6,0,3
D32,Other,2014,15,16,0,1
D32,Break & Enter-Other,2014,1,4,0,3
D33,Other,2014,6,8,0,2
D33,Break & Enter-House,2014,4,20,0,16
D32,Other,2014,7,11,0,4
D32,Break & Enter-Other,2014,1,5,0,4
D33,Other,2014,6,6,1,0
D33,Break & Enter-House,2014,0,11,0,11
D32,Other,2014,6,10,0,4
D32,Break & Enter-Other,2014,1,1,1,0
D33,Other,2014,1,1,1,0
D33,Break & Enter-House,2014,2,10,0,8
D32,Other,2014,15,18,0,3
D32,Break & Enter-Other,2014,0,3,0,3
D33,Other,2014,3,3,1,0
D33,Break & Enter-House,2014,5,21,0,16
D32,Other,2014,42,44,0,2
D32,Break & Enter-Other,2014,1,1,1,0
D33,Other,2014,1,1,1,0
D33,Break & Enter-House,2014,0,4,0,4
D32,Other,2014,3,4,0,1
D32,Break & Enter-Other,2014,0,1,0,1
D33,Other,2014,4,4,1,0
D33,Auto Theft,2014,3,20,0,17
D33,Auto Theft,2014,2,25,0,23
D33,Auto Theft,2014,1,16,0,15
D33,Auto Theft,2014,1,1,1,0
D33,Auto Theft,2014,5,52,0,47
D33,Auto Theft,2014,1,19,0,18
D33,Auto Theft,2014,3,15,0,12
D33,Auto Theft,2014,3,11,0,8
D33,Auto Theft,2014,0,1,0,1
D33,Auto Theft,2014,0,16,0,16
D33,Auto Theft,2014,0,11,0,11
D33,Auto Theft,2014,0,9,0,9
D33,Auto Theft,2014,1,14,0,13
D33,Break & Enter-Apartment,2014,2,18,0,16
D33,Break & Enter-Apartment,2014,1,9,0,8
D33,Break & Enter-Apartment,2014,0,4,0,4
D33,Break & Enter-Apartment,2014,7,42,0,35
D33,Break & Enter-Apartment,2014,5,33,0,28
D33,Break & Enter-Apartment,2014,8,26,0,18
D33,Break & Enter-Apartment,2014,0,6,0,6
D33,Break & Enter-Apartment,2014,5,10,0,5
D33,Break & Enter-Apartment,2014,2,7,0,5
D33,Break & Enter-Apartment,2014,0,2,0,2
D33,Break & Enter-Apartment,2014,2,20,0,18
D33,Break & Enter-Commercial,2014,4,24,0,20
D33,Break & Enter-Commercial,2014,2,7,0,5
D33,Break & Enter-Commercial,2014,1,2,0,1
D33,Break & Enter-Commercial,2014,0,1,0,1
D33,Break & Enter-Commercial,2014,3,6,0,3
D33,Break & Enter-Commercial,2014,0,1,0,1
D33,Break & Enter-Commercial,2014,0,5,0,5
D33,Break & Enter-Commercial,2014,2,9,0,7
D33,Break & Enter-Commercial,2014,1,1,1,0
D33,Break & Enter-Commercial,2014,1,3,0,2
D32,Other,2014,13,15,0,2
D32,Break & Enter-Other,2014,0,1,0,1
D33,Break & Enter-Other,2014,0,4,0,4
D32,Other,2014,34,36,0,2
D32,Fraud,2014,2,23,0,21
D33,Break & Enter-Other,2014,1,6,0,5
D32,Other,2014,17,19,0,2
D32,Fraud,2014,3,27,0,24
D32,Fraud,2014,3,21,0,18
D32,Fraud,2014,1,5,0,4
D32,Fraud,2014,7,46,0,39
D32,Fraud,2014,1,8,0,7
D32,Fraud,2014,6,21,0,15
D32,Fraud,2014,6,25,0,19
D32,Fraud,2014,10,37,0,27
D32,Fraud,2014,8,27,0,19
D32,Fraud,2014,2,10,0,8
D32,Fraud,2014,4,28,0,24
D32,Fraud,2014,17,58,0,41
D32,Fraud,2014,3,12,0,9
D32,Fraud,2014,3,41,0,38
D32,Fraud,2014,119,153,0,34
D32,Fraud,2014,16,46,0,30
D32,Fraud,2014,1,1,1,0
D32,Fraud,2014,16,43,0,27
D32,Fraud,2014,70,111,0,41
D32,Other,2014,7,27,0,20
D32,Other,2014,9,38,0,29
D32,Other,2014,0,1,0,1
D32,Other,2014,5,40,0,35
D32,Other,2014,3,12,0,9
D32,Other,2014,17,70,0,53
D32,Other,2014,6,16,0,10
D32,Other,2014,8,33,0,25
D32,Other,2014,19,42,0,23
D32,Other,2014,8,42,0,34
D32,Other,2014,7,46,0,39
D32,Other,2014,3,9,0,6
D32,Other,2014,14,57,0,43
D33,Break & Enter-Other,2014,0,1,0,1
D32,Other,2014,185,189,0,4
D33,Break & Enter-Other,2014,0,1,0,1
D32,Other,2014,62,65,0,3
D33,Break & Enter-Other,2014,0,1,0,1
D32,Other Criminal Violations - Offensive Weapons,2014,2,2,1,0
D33,Break & Enter-Other,2014,0,2,0,2
D32,Other Criminal Violations - Offensive Weapons,2014,2,2,1,0
D33,Fraud,2014,24,56,0,32
D32,Other Criminal Violations - Offensive Weapons,2014,5,5,1,0
D33,Fraud,2014,12,40,0,28
D32,Other Criminal Violations - Offensive Weapons,2014,2,2,1,0
D33,Fraud,2014,5,12,0,7
D32,Other Criminal Violations - Offensive Weapons,2014,2,3,0,1
D33,Fraud,2014,2,6,0,4
D33,Fraud,2014,32,55,0,23
D32,Other Criminal Violations - Offensive Weapons,2014,6,6,1,0
D33,Fraud,2014,8,28,0,20
D32,Other Criminal Violations - Offensive Weapons,2014,2,2,1,0
D33,Fraud,2014,0,1,0,1
D32,Other Criminal Violations - Offensive Weapons,2014,1,1,1,0
D33,Fraud,2014,12,25,0,13
D32,Other Criminal Violations - Offensive Weapons,2014,2,3,0,1
D33,Fraud,2014,20,48,0,28
D32,Other Criminal Violations - Offensive Weapons,2014,1,1,1,0
D33,Fraud,2014,3,9,0,6
D32,Other Criminal Violations - Offensive Weapons,2014,9,10,0,1
D33,Fraud,2014,19,33,0,14
D32,Other Criminal Violations - Offensive Weapons,2014,7,8,0,1
D33,Fraud,2014,9,23,0,14
D32,Other Criminal Violations - Offensive Weapons,2014,3,4,0,1
D33,Fraud,2014,9,25,0,16
D32,Other Criminal Violations - Offensive Weapons,2014,4,4,1,0
D33,Fraud,2014,0,1,0,1
D32,Other Criminal Violations - Offensive Weapons,2014,1,2,0,1
D33,Fraud,2014,7,19,0,12
D32,Other Criminal Violations - Offensive Weapons,2014,6,6,1,0
D33,Fraud,2014,0,1,0,1
D32,Other,2014,1,1,1,0
D33,Other,2014,17,52,0,35
D32,Other,2014,1,1,1,0
D33,Other,2014,19,53,0,34
D32,Other,2014,3,3,1,0
D33,Other,2014,8,27,0,19
D32,Other,2014,2,2,1,0
D33,Other,2014,1,5,0,4
D32,Other,2014,1,1,1,0
D33,Other,2014,0,2,0,2
D32,Other,2014,2,2,1,0
D33,Other,2014,38,83,0,45
D32,Other,2014,2,2,1,0
D33,Other,2014,16,56,0,40
D32,Other,2014,4,5,0,1
D33,Other,2014,1,1,1,0
D32,Other,2014,5,5,1,0
D33,Other,2014,16,51,0,35
D32,Other,2014,3,3,1,0
D32,Other,2014,2,2,1,0
D32,Other,2014,1,1,1,0
D32,Other,2014,3,3,1,0
D33,Other,2014,14,37,0,23
D33,Other,2014,2,3,0,1
D33,Other,2014,2,5,0,3
D33,Other,2014,11,41,0,30
D32,Assault,2014,19,31,0,12
D32,Assault,2014,23,37,0,14
D32,Assault,2014,40,59,0,19
D32,Assault,2014,21,34,0,13
D32,Assault,2014,14,24,0,10
D32,Assault,2014,0,1,0,1
D32,Assault,2014,6,10,0,4
D32,Assault,2014,45,70,0,25
D32,Assault,2014,73,131,0,58
D32,Assault,2014,6,12,0,6
D32,Assault,2014,56,77,0,21
D32,Assault,2014,47,65,0,18
D32,Assault,2014,42,67,0,25
D32,Assault,2014,25,38,0,13
D32,Assault,2014,44,58,0,14
D32,Attempt Murder,2014,4,4,1,0
D32,Attempt Murder,2014,0,1,0,1
D32,Attempt Murder,2014,0,1,0,1
D32,Other,2014,15,15,1,0
D32,Other,2014,8,11,0,3
D32,Other,2014,6,11,0,5
D32,Other,2014,2,3,0,1
D32,Other,2014,14,21,0,7
D32,Other,2014,7,13,0,6
D32,Other,2014,8,13,0,5
D32,Other,2014,13,21,0,8
D32,Other,2014,11,18,0,7
D32,Other,2014,2,5,0,3
D32,Other,2014,5,9,0,4
D32,Other,2014,7,15,0,8
D32,Other,2014,15,32,0,17
D32,Other,2014,7,11,0,4
D32,Other,2014,15,24,0,9
D32,Other,2014,10,15,0,5
D32,Other,2014,6,12,0,6
D32,Other,2014,7,14,0,7
D32,Other,2014,15,28,0,13
D32,Robbery-Financial,2014,2,2,1,0
D32,Robbery-Financial,2014,1,1,1,0
D32,Auto Theft,2014,1,8,0,7
D32,Robbery-Financial,2014,1,1,1,0
D32,Robbery-Financial,2014,0,2,0,2
D32,Robbery-Financial,2014,1,1,1,0
D32,Robbery-Other,2014,0,3,0,3
D32,Robbery-Other,2014,0,7,0,7
D32,Robbery-Other,2014,2,9,0,7
D32,Robbery-Other,2014,0,1,0,1
D32,Robbery-Other,2014,1,7,0,6
D32,Robbery-Other,2014,0,6,0,6
D32,Robbery-Other,2014,2,13,0,11
D32,Auto Theft,2014,0,23,0,23
D32,Auto Theft,2014,8,52,0,44
D32,Break & Enter-Apartment,2014,1,2,0,1
D32,Break & Enter-Apartment,2014,1,10,0,9
D32,Break & Enter-Apartment,2014,2,8,0,6
D32,Break & Enter-Apartment,2014,1,1,1,0
D32,Break & Enter-Apartment,2014,6,14,0,8
D32,Break & Enter-Apartment,2014,1,2,0,1
D32,Break & Enter-Apartment,2014,0,4,0,4
D32,Break & Enter-Apartment,2014,2,14,0,12
D32,Break & Enter-Apartment,2014,0,2,0,2
D32,Break & Enter-Apartment,2014,0,2,0,2
D32,Break & Enter-Apartment,2014,0,4,0,4
D32,Break & Enter-Apartment,2014,4,16,0,12
D32,Break & Enter-Apartment,2014,0,19,0,19
D32,Break & Enter-Apartment,2014,6,41,0,35
D32,Break & Enter-Apartment,2014,1,6,0,5
D32,Break & Enter-Apartment,2014,0,1,0,1
D32,Break & Enter-Apartment,2014,1,1,1,0
D32,Break & Enter-Commercial,2014,0,3,0,3
D32,Break & Enter-Commercial,2014,1,8,0,7
D32,Break & Enter-Commercial,2014,0,5,0,5
D32,Break & Enter-Commercial,2014,1,17,0,16
D32,Break & Enter-Commercial,2014,3,7,0,4
D32,Break & Enter-Commercial,2014,0,5,0,5
D32,Break & Enter-Commercial,2014,1,2,0,1
D32,Break & Enter-Commercial,2014,0,4,0,4
D32,Break & Enter-Commercial,2014,1,7,0,6
D32,Break & Enter-Commercial,2014,0,5,0,5
D32,Break & Enter-Commercial,2014,0,9,0,9
D32,Break & Enter-Commercial,2014,0,1,0,1
D32,Break & Enter-Commercial,2014,1,2,0,1
D32,Break & Enter-Commercial,2014,1,7,0,6
D32,Break & Enter-Commercial,2014,8,47,0,39
D32,Break & Enter-Commercial,2014,4,22,0,18
D32,Break & Enter-House,2014,1,4,0,3
D32,Break & Enter-House,2014,0,16,0,16
D32,Break & Enter-House,2014,2,48,0,46
D32,Break & Enter-House,2014,0,10,0,10
D32,Break & Enter-House,2014,0,27,0,27
D32,Break & Enter-House,2014,0,5,0,5
D32,Break & Enter-House,2014,8,58,0,50
D32,Break & Enter-House,2014,3,8,0,5
D32,Break & Enter-House,2014,1,24,0,23
D32,Break & Enter-House,2014,4,21,0,17
D32,Break & Enter-House,2014,2,26,0,24
D32,Break & Enter-House,2014,1,26,0,25
D32,Break & Enter-House,2014,0,28,0,28
D41,Other,2014,8,14,0,6
D41,Other,2014,11,21,0,10
D41,Break & Enter-Commercial,2014,2,4,0,2
D41,Other,2014,28,47,0,19
D41,Other,2014,2,5,0,3
D41,Other,2014,20,37,0,17
D41,Break & Enter-Commercial,2014,0,1,0,1
D41,Other,2014,43,82,0,39
D41,Break & Enter-Commercial,2014,1,7,0,6
D41,Robbery-Financial,2014,1,1,1,0
D41,Break & Enter-Commercial,2014,6,12,0,6
D33,Other,2014,12,28,0,16
D41,Robbery-Financial,2014,3,3,1,0
D41,Break & Enter-Commercial,2014,11,60,0,49
D33,Other,2014,7,26,0,19
D41,Robbery-Financial,2014,2,2,1,0
D41,Break & Enter-House,2014,3,11,0,8
D41,Other,2014,406,420,0,14
D33,Other,2014,1,1,1,0
D41,Other,2014,32,66,0,34
D41,Robbery-Financial,2014,1,2,0,1
D41,Break & Enter-House,2014,3,7,0,4
D41,Other,2014,19,23,0,4
D33,Other Criminal Violations - Offensive Weapons,2014,1,1,1,0
D33,Assault,2014,0,1,0,1
D33,Other,2014,10,32,0,22
D41,Other,2014,74,155,0,81
D41,Robbery-Other,2014,4,7,0,3
D41,Break & Enter-House,2014,10,42,0,32
D33,Sexual Violation,2014,2,3,0,1
D41,Other,2014,133,138,0,5
D33,Other Criminal Violations - Offensive Weapons,2014,1,1,1,0
D33,Assault,2014,0,1,0,1
D33,Other,2014,1,2,0,1
D41,Theft Over $5000,2014,0,1,0,1
D41,Theft Over $5000,2014,0,1,0,1
D41,Theft Over $5000,2014,0,3,0,3
D41,Theft Over $5000,2014,3,4,0,1
D41,Theft Over $5000,2014,1,1,1,0
D41,Theft Over $5000,2014,5,6,0,1
D41,Theft Over $5000,2014,0,1,0,1
D41,Theft Over $5000,2014,2,6,0,4
D41,Theft Over $5000,2014,1,2,0,1
D41,Theft Over $5000,2014,5,17,0,12
D41,Theft Under $5000,2014,9,43,0,34
D41,Theft Under $5000,2014,29,101,0,72
D41,Theft Under $5000,2014,62,228,0,166
D41,Theft Under $5000,2014,154,396,0,242
D41,Theft Under $5000,2014,4,29,0,25
D41,Theft Under $5000,2014,68,228,0,160
D41,Theft Under $5000,2014,1,1,1,0
D41,Theft Under $5000,2014,11,42,0,31
D41,Theft Under $5000,2014,44,78,0,34
D41,Theft Under $5000,2014,53,158,0,105
D41,Theft Under $5000,2014,1,12,0,11
D41,Theft Under $5000,2014,0,1,0,1
D41,Theft Under $5000,2014,59,214,0,155
D41,Theft Under $5000,2014,555,901,0,346
D41,Assault,2014,18,26,0,8
D41,Assault,2014,23,37,0,14
D41,Assault,2014,84,130,0,46
D41,Assault,2014,151,224,0,73
D41,Assault,2014,17,29,0,12
D41,Assault,2014,68,120,0,52
D41,Assault,2014,0,1,0,1
D41,Assault,2014,40,64,0,24
D41,Assault,2014,61,88,0,27
D41,Assault,2014,129,203,0,74
D41,Assault,2014,10,13,0,3
D41,Assault,2014,88,133,0,45
D41,Assault,2014,0,1,0,1
D41,Assault,2014,108,160,0,52
D41,Attempt Murder,2014,0,1,0,1
D41,Attempt Murder,2014,1,1,1,0
D41,Attempt Murder,2014,0,1,0,1
D41,Attempt Murder,2014,2,2,1,0
D41,Other,2014,3,7,0,4
D41,Other,2014,14,24,0,10
D41,Other,2014,23,44,0,21
D41,Other,2014,33,66,0,33
D41,Other,2014,3,9,0,6
D41,Other,2014,22,31,0,9
D33,Other Criminal Violations - Offensive Weapons,2014,4,4,1,0
D41,Break & Enter-House,2014,20,66,0,46
D33,Assault,2014,45,54,0,9
D41,Other,2014,17,22,0,5
D41,Robbery-Other,2014,7,13,0,6
D41,Break & Enter-House,2014,3,7,0,4
D33,Other Criminal Violations - Offensive Weapons,2014,4,4,1,0
D33,Assault,2014,5,6,0,1
D33,Sexual Violation,2014,3,6,0,3
D33,Theft Over $5000,2014,3,10,0,7
D33,Attempt Murder,2014,0,3,0,3
D41,Other,2014,80,80,1,0
D41,Robbery-Other,2014,4,9,0,5
D41,Break & Enter-House,2014,2,14,0,12
D33,Theft Over $5000,2014,1,9,0,8
D33,Other,2014,13,20,0,7
D41,Other,2014,101,110,0,9
D41,Robbery-Other,2014,13,43,0,30
D33,Other,2014,1,1,1,0
D41,Break & Enter-House,2014,1,5,0,4
D33,Theft Over $5000,2014,3,4,0,1
D33,Sexual Violation,2014,3,4,0,1
D33,Other,2014,11,20,0,9
D41,Other,2014,2,2,1,0
D41,Robbery-Other,2014,3,11,0,8
D33,Other,2014,1,1,1,0
D41,Break & Enter-House,2014,5,13,0,8
D33,Theft Over $5000,2014,0,3,0,3
D33,Sexual Violation,2014,5,7,0,2
D33,Other,2014,11,13,0,2
D41,Other,2014,10,11,0,1
D41,Robbery-Other,2014,10,22,0,12
D33,Other,2014,1,1,1,0
D41,Break & Enter-House,2014,3,21,0,18
D33,Theft Over $5000,2014,5,8,0,3
D33,Sexual Violation,2014,1,1,1,0
D33,Other,2014,2,2,1,0
D41,Other,2014,116,120,0,4
D41,Robbery-Other,2014,10,22,0,12
D33,Other,2014,0,1,0,1
D41,Break & Enter-House,2014,2,17,0,15
D33,Theft Over $5000,2014,1,5,0,4
D33,Other,2014,15,15,1,0
D33,Other,2014,20,27,0,7
D41,Other,2014,1,1,1,0
D41,Robbery-Other,2014,6,12,0,6
D33,Other,2014,1,1,1,0
D41,Break & Enter-House,2014,13,42,0,29
D33,Theft Over $5000,2014,1,4,0,3
D33,Other,2014,8,8,1,0
D33,Other,2014,21,28,0,7
D33,Other,2014,2,2,1,0
D33,Other,2014,13,16,0,3
D33,Other,2014,8,21,0,13
D33,Other,2014,3,3,1,0
D33,Other,2014,2,5,0,3
D33,Other,2014,3,6,0,3
D33,Other,2014,9,13,0,4
D33,Other,2014,7,14,0,7
D33,Other,2014,0,2,0,2
D33,Other,2014,14,18,0,4
D33,Other,2014,1,2,0,1
D33,Robbery-Financial,2014,3,4,0,1
D33,Robbery-Financial,2014,2,3,0,1
D33,Robbery-Financial,2014,1,1,1,0
D33,Robbery-Other,2014,2,6,0,4
D33,Robbery-Other,2014,0,3,0,3
D33,Robbery-Other,2014,1,2,0,1
D33,Robbery-Other,2014,14,41,0,27
D33,Robbery-Other,2014,1,3,0,2
D33,Robbery-Other,2014,0,1,0,1
D33,Robbery-Other,2014,1,7,0,6
D33,Robbery-Other,2014,1,15,0,14
D33,Robbery-Other,2014,5,5,1,0
D33,Robbery-Other,2014,0,1,0,1
D33,Robbery-Other,2014,0,4,0,4
D33,Robbery-Other,2014,1,7,0,6
D33,Robbery-Other,2014,1,5,0,4
D33,Robbery-Other,2014,0,2,0,2
D33,Robbery-Other,2014,0,1,0,1
D33,Robbery-Other,2014,1,4,0,3
D33,Sexual Violation,2014,5,6,0,1
D33,Sexual Violation,2014,6,12,0,6
D33,Sexual Violation,2014,2,2,1,0
D33,Sexual Violation,2014,3,3,1,0
D33,Sexual Violation,2014,8,16,0,8
D33,Sexual Violation,2014,10,11,0,1
D33,Sexual Violation,2014,3,4,0,1
D33,Sexual Violation,2014,3,5,0,2
D33,Sexual Violation,2014,2,2,1,0
D41,Robbery-Other,2014,17,61,0,44
D41,Break & Enter-Other,2014,0,1,0,1
D41,Other,2014,4,4,1,0
D41,Other,2014,181,193,0,12
D33,Other,2014,2,2,1,0
D41,Robbery-Other,2014,0,8,0,8
D41,Break & Enter-Other,2014,0,3,0,3
D41,Other,2014,4,5,0,1
D41,Other Criminal Violations - Offensive Weapons,2014,2,2,1,0
D41,Robbery-Other,2014,1,1,1,0
D41,Break & Enter-Other,2014,0,6,0,6
D33,Other,2014,1,1,1,0
D33,Theft Over $5000,2014,1,6,0,5
D41,Other Criminal Violations - Offensive Weapons,2014,1,2,0,1
D41,Robbery-Other,2014,18,39,0,21
D41,Break & Enter-Other,2014,4,8,0,4
D33,Theft Over $5000,2014,0,1,0,1
D33,Other,2014,1,1,1,0
D41,Other Criminal Violations - Offensive Weapons,2014,10,11,0,1
D41,Robbery-Other,2014,16,38,0,22
D41,Break & Enter-Other,2014,1,1,1,0
D33,Theft Over $5000,2014,0,2,0,2
D41,Other,2014,41,42,0,1
D33,Other,2014,7,7,1,0
D41,Other Criminal Violations - Offensive Weapons,2014,10,13,0,3
D41,Sexual Violation,2014,1,4,0,3
D41,Break & Enter-Other,2014,2,6,0,4
D33,Theft Over $5000,2014,1,7,0,6
D33,Theft Over $5000,2014,0,3,0,3
D33,Theft Under $5000,2014,91,266,0,175
D33,Theft Under $5000,2014,131,295,0,164
D33,Theft Under $5000,2014,20,84,0,64
D33,Theft Under $5000,2014,2,11,0,9
D33,Theft Under $5000,2014,0,2,0,2
D33,Theft Under $5000,2014,305,474,0,169
D33,Theft Under $5000,2014,0,1,0,1
D33,Theft Under $5000,2014,20,101,0,81
D33,Theft Under $5000,2014,0,2,0,2
D33,Theft Under $5000,2014,41,100,0,59
D33,Theft Under $5000,2014,47,127,0,80
D33,Theft Under $5000,2014,1,1,1,0
D33,Theft Under $5000,2014,2,7,0,5
D33,Theft Under $5000,2014,32,97,0,65
D33,Theft Under $5000,2014,19,74,0,55
D33,Theft Under $5000,2014,29,108,0,79
D33,Theft Under $5000,2014,0,6,0,6
D33,Theft Under $5000,2014,12,60,0,48
D33,Theft Under $5000,2014,0,2,0,2
D33,Assault,2014,40,55,0,15
D33,Assault,2014,54,76,0,22
D33,Assault,2014,22,32,0,10
D33,Assault,2014,1,1,1,0
D33,Assault,2014,0,1,0,1
D33,Assault,2014,66,98,0,32
D33,Assault,2014,75,99,0,24
D33,Assault,2014,0,2,0,2
D33,Assault,2014,46,56,0,10
D33,Assault,2014,39,61,0,22
D33,Assault,2014,5,11,0,6
D33,Assault,2014,34,41,0,7
D33,Assault,2014,19,29,0,10
D33,Assault,2014,21,34,0,13
D41,Break & Enter-Other,2014,0,3,0,3
D41,Other Criminal Violations - Offensive Weapons,2014,15,17,0,2
D41,Sexual Violation,2014,7,11,0,4
D41,Other,2014,60,62,0,2
D41,Break & Enter-Other,2014,1,5,0,4
D41,Other Criminal Violations - Offensive Weapons,2014,2,2,1,0
D41,Sexual Violation,2014,10,12,0,2
D41,Other,2014,7,7,1,0
D41,Break & Enter-Other,2014,1,1,1,0
D41,Break & Enter-Other,2014,1,7,0,6
D41,Break & Enter-Other,2014,2,12,0,10
D41,Fraud,2014,0,1,0,1
D41,Fraud,2014,1,4,0,3
D41,Fraud,2014,3,16,0,13
D41,Fraud,2014,7,34,0,27
D41,Fraud,2014,21,76,0,55
D41,Fraud,2014,0,6,0,6
D41,Fraud,2014,8,54,0,46
D41,Fraud,2014,6,12,0,6
D41,Fraud,2014,17,39,0,22
D41,Fraud,2014,3,30,0,27
D41,Fraud,2014,3,7,0,4
D41,Fraud,2014,8,29,0,21
D41,Fraud,2014,41,103,0,62
D41,Other,2014,4,15,0,11
D41,Other,2014,8,27,0,19
D41,Other,2014,25,76,0,51
D41,Other,2014,64,135,0,71
D41,Other,2014,13,29,0,16
D41,Other,2014,38,98,0,60
D41,Other,2014,14,36,0,22
D41,Other,2014,18,47,0,29
D41,Other,2014,31,87,0,56
D41,Other,2014,0,5,0,5
D33,Other,2014,7,7,1,0
D41,Other,2014,45,45,1,0
D41,Sexual Violation,2014,9,16,0,7
D41,Other,2014,6,6,1,0
D41,Other Criminal Violations - Offensive Weapons,2014,5,5,1,0
D33,Other,2014,4,4,1,0
D41,Sexual Violation,2014,0,2,0,2
D41,Other,2014,9,9,1,0
D41,Other Criminal Violations - Offensive Weapons,2014,22,24,0,2
D33,Other,2014,5,5,1,0
D41,Sexual Violation,2014,5,18,0,13
D41,Other,2014,55,55,1,0
D41,Other Criminal Violations - Offensive Weapons,2014,1,1,1,0
D33,Other,2014,4,5,0,1
D41,Sexual Violation,2014,2,4,0,2
D41,Other,2014,1,1,1,0
D41,Other Criminal Violations - Offensive Weapons,2014,11,12,0,1
D33,Other,2014,2,2,1,0
D41,Sexual Violation,2014,1,5,0,4
D41,Other,2014,37,37,1,0
D41,Other Criminal Violations - Offensive Weapons,2014,8,8,1,0
D41,Sexual Violation,2014,10,17,0,7
D33,Other,2014,8,8,1,0
D41,Other,2014,33,38,0,5
D41,Other,2014,1,1,1,0
D41,Auto Theft,2014,2,6,0,4
D41,Sexual Violation,2014,2,7,0,5
D33,Other,2014,6,6,1,0
D41,Other,2014,1,1,1,0
D41,Auto Theft,2014,2,5,0,3
D41,Sexual Violation,2014,7,13,0,6
D33,Other,2014,3,3,1,0
D41,Other,2014,1,1,1,0
D41,Auto Theft,2014,0,13,0,13
D41,Sexual Violation,2014,11,18,0,7
D33,Other,2014,3,5,0,2
D41,Other,2014,5,5,1,0
D41,Auto Theft,2014,6,45,0,39
D41,Other,2014,5,5,1,0
D33,Other,2014,5,5,1,0
D41,Other,2014,5,5,1,0
D41,Auto Theft,2014,1,8,0,7
D41,Other,2014,12,12,1,0
D33,Other,2014,4,4,1,0
D41,Other,2014,0,1,0,1
D41,Auto Theft,2014,7,52,0,45
D41,Other,2014,13,14,0,1
D33,Other,2014,24,25,0,1
D41,Other,2014,4,4,1,0
D41,Auto Theft,2014,1,7,0,6
D41,Other,2014,27,27,1,0
D33,Other,2014,20,24,0,4
D41,Other,2014,4,4,1,0
D41,Auto Theft,2014,1,5,0,4
D41,Other,2014,11,12,0,1
D33,Other,2014,15,15,1,0
D41,Other,2014,4,4,1,0
D41,Auto Theft,2014,1,26,0,25
D41,Other,2014,22,23,0,1
D33,Other,2014,0,1,0,1
D41,Other,2014,2,2,1,0
D41,Auto Theft,2014,1,2,0,1
D41,Other,2014,4,4,1,0
D33,Other,2014,4,4,1,0
D41,Other,2014,7,9,0,2
D41,Auto Theft,2014,8,21,0,13
D41,Other,2014,9,9,1,0
D33,Other,2014,55,59,0,4
D42,Other,2014,27,27,1,0
D41,Other,2014,12,12,1,0
D41,Auto Theft,2014,8,62,0,54
D42,Other,2014,31,32,0,1
D33,Other,2014,38,43,0,5
D41,Break & Enter-Apartment,2014,0,2,0,2
D42,Other,2014,13,13,1,0
D41,Other,2014,1,1,1,0
D33,Other,2014,4,4,1,0
D41,Break & Enter-Apartment,2014,0,6,0,6
D42,Other,2014,0,1,0,1
D41,Other,2014,9,9,1,0
D33,Other,2014,13,15,0,2
D41,Break & Enter-Apartment,2014,4,16,0,12
D42,Other,2014,1,1,1,0
D41,Other,2014,27,30,0,3
D33,Other,2014,18,21,0,3
D41,Break & Enter-Apartment,2014,4,22,0,18
D42,Other,2014,11,11,1,0
D41,Other,2014,4,6,0,2
D33,Other,2014,2,2,1,0
D41,Break & Enter-Apartment,2014,0,1,0,1
D42,Other,2014,16,17,0,1
D41,Other,2014,21,28,0,7
D33,Other,2014,8,8,1,0
D41,Break & Enter-Apartment,2014,3,17,0,14
D42,Other,2014,27,28,0,1
D41,Other,2014,74,87,0,13
D33,Other,2014,11,12,0,1
D41,Break & Enter-Apartment,2014,1,5,0,4
D42,Other,2014,17,19,0,2
D33,Other,2014,15,15,1,0
D41,Break & Enter-Apartment,2014,1,16,0,15
D42,Other,2014,15,16,0,1
D33,Other,2014,10,13,0,3
D41,Break & Enter-Apartment,2014,5,18,0,13
D42,Other,2014,2,2,1,0
D33,Other,2014,41,42,0,1
D41,Break & Enter-Apartment,2014,5,27,0,22
D42,Other,2014,5,7,0,2
D33,Other,2014,4,4,1,0
D41,Break & Enter-Apartment,2014,4,11,0,7
D42,Other,2014,28,30,0,2
D33,Other,2014,1,1,1,0
D41,Break & Enter-Commercial,2014,0,3,0,3
D42,Other,2014,2,3,0,1
D33,Other Criminal Violations - Offensive Weapons,2014,2,2,1,0
D41,Break & Enter-Commercial,2014,5,17,0,12
D41,Break & Enter-Commercial,2014,2,9,0,7
D42,Auto Theft,2014,4,17,0,13
D33,Other Criminal Violations - Offensive Weapons,2014,4,4,1,0
D41,Break & Enter-Commercial,2014,12,34,0,22
D42,Auto Theft,2014,4,34,0,30
D33,Other Criminal Violations - Offensive Weapons,2014,2,3,0,1
D41,Break & Enter-Commercial,2014,2,3,0,1
D42,Auto Theft,2014,0,7,0,7
D33,Other Criminal Violations - Offensive Weapons,2014,1,1,1,0
D41,Break & Enter-Commercial,2014,16,54,0,38
D33,Other Criminal Violations - Offensive Weapons,2014,9,10,0,1
D33,Other Criminal Violations - Offensive Weapons,2014,8,8,1,0
D33,Other Criminal Violations - Offensive Weapons,2014,1,1,1,0
D33,Other Criminal Violations - Offensive Weapons,2014,1,2,0,1
D33,Other Criminal Violations - Offensive Weapons,2014,5,5,1,0
D33,Other Criminal Violations - Offensive Weapons,2014,1,1,1,0
D42,Break & Enter-Other,2014,1,1,1,0
D42,Fraud,2014,10,26,0,16
D43,Break & Enter-Commercial,2014,2,5,0,3
D42,Fraud,2014,25,62,0,37
D42,Fraud,2014,5,19,0,14
D42,Theft Under $5000,2014,12,76,0,64
D42,Fraud,2014,16,37,0,21
D43,Break & Enter-Commercial,2014,4,9,0,5
D42,Fraud,2014,16,48,0,32
D42,Assault,2014,45,57,0,12
D43,Attempt Murder,2014,2,2,1,0
D43,Break & Enter-Commercial,2014,3,12,0,9
D42,Fraud,2014,15,37,0,22
D42,Other,2014,3,3,1,0
D42,Assault,2014,69,98,0,29
D43,Other,2014,33,65,0,32
D43,Attempt Murder,2014,4,6,0,2
D43,Break & Enter-Commercial,2014,0,1,0,1
D42,Fraud,2014,21,62,0,41
D42,Other,2014,7,7,1,0
D42,Assault,2014,40,52,0,12
D43,Attempt Murder,2014,1,1,1,0
D43,Other,2014,1,6,0,5
D42,Auto Theft,2014,0,10,0,10
D43,Break & Enter-Commercial,2014,9,17,0,8
D42,Fraud,2014,22,56,0,34
D42,Other,2014,1,1,1,0
D42,Sexual Violation,2014,7,10,0,3
D42,Assault,2014,43,65,0,22
D42,Assault,2014,104,127,0,23
D42,Assault,2014,54,69,0,15
D42,Assault,2014,35,59,0,24
D42,Assault,2014,73,93,0,20
D42,Assault,2014,5,13,0,8
D42,Assault,2014,27,41,0,14
D42,Assault,2014,73,92,0,19
D42,Assault,2014,42,55,0,13
D42,Attempt Murder,2014,0,1,0,1
D42,Attempt Murder,2014,0,2,0,2
D42,Attempt Murder,2014,0,1,0,1
D42,Attempt Murder,2014,0,1,0,1
D42,Other,2014,14,25,0,11
D42,Other,2014,30,54,0,24
D42,Other,2014,25,31,0,6
D42,Other,2014,15,22,0,7
D42,Other,2014,29,49,0,20
D42,Other,2014,19,33,0,14
D42,Other,2014,6,10,0,4
D42,Other,2014,15,25,0,10
D42,Other,2014,2,3,0,1
D42,Other,2014,4,9,0,5
D42,Other,2014,13,24,0,11
D42,Other,2014,7,14,0,7
D42,Robbery-Financial,2014,2,2,1,0
D42,Robbery-Financial,2014,3,3,1,0
D42,Robbery-Financial,2014,1,1,1,0
D42,Robbery-Financial,2014,1,1,1,0
D42,Robbery-Financial,2014,1,1,1,0
D42,Robbery-Other,2014,9,31,0,22
D42,Robbery-Other,2014,4,22,0,18
D42,Robbery-Other,2014,18,27,0,9
D42,Robbery-Other,2014,6,21,0,15
D42,Robbery-Other,2014,8,19,0,11
D42,Robbery-Other,2014,4,14,0,10
D42,Robbery-Other,2014,8,35,0,27
D42,Robbery-Other,2014,3,15,0,12
D42,Robbery-Other,2014,1,4,0,3
D42,Robbery-Other,2014,0,8,0,8
D42,Robbery-Other,2014,9,21,0,12
D42,Robbery-Other,2014,3,5,0,2
D42,Robbery-Other,2014,0,1,0,1
D42,Sexual Violation,2014,5,9,0,4
D42,Sexual Violation,2014,8,10,0,2
D42,Sexual Violation,2014,8,9,0,1
D42,Fraud,2014,10,16,0,6
D42,Sexual Violation,2014,11,16,0,5
D42,Other,2014,2,2,1,0
D43,Break & Enter-House,2014,2,8,0,6
D43,Attempt Murder,2014,1,1,1,0
D42,Other,2014,1,1,1,0
D43,Other,2014,39,86,0,47
D42,Sexual Violation,2014,3,5,0,2
D42,Fraud,2014,6,24,0,18
D43,Other,2014,86,150,0,64
D42,Auto Theft,2014,2,20,0,18
D42,Fraud,2014,20,44,0,24
D43,Attempt Murder,2014,3,3,1,0
D43,Break & Enter-House,2014,4,11,0,7
D43,Other,2014,11,25,0,14
D42,Other,2014,2,2,1,0
D42,Auto Theft,2014,0,7,0,7
D42,Fraud,2014,8,19,0,11
D42,Sexual Violation,2014,9,14,0,5
D43,Other,2014,9,11,0,2
D43,Break & Enter-House,2014,5,11,0,6
D43,Other,2014,44,96,0,52
D43,Other,2014,12,13,0,1
D42,Auto Theft,2014,2,41,0,39
D42,Other,2014,28,76,0,48
D42,Sexual Violation,2014,7,9,0,2
D43,Other,2014,14,19,0,5
D43,Break & Enter-House,2014,13,19,0,6
D43,Theft Over $5000,2014,0,1,0,1
D43,Other,2014,20,21,0,1
D42,Auto Theft,2014,4,31,0,27
D43,Break & Enter-House,2014,3,5,0,2
D42,Other,2014,29,79,0,50
D43,Other,2014,7,7,1,0
D43,Other,2014,6,9,0,3
D43,Theft Over $5000,2014,2,5,0,3
D42,Sexual Violation,2014,0,2,0,2
D42,Auto Theft,2014,1,20,0,19
D43,Theft Over $5000,2014,0,1,0,1
D43,Other,2014,15,29,0,14
D43,Break & Enter-House,2014,10,21,0,11
D42,Other,2014,15,42,0,27
D43,Other,2014,7,8,0,1
D42,Auto Theft,2014,1,23,0,22
D42,Sexual Violation,2014,4,5,0,1
D43,Theft Over $5000,2014,2,3,0,1
D43,Other,2014,20,32,0,12
D43,Break & Enter-House,2014,2,9,0,7
D42,Other,2014,0,1,0,1
D43,Other,2014,29,31,0,2
D42,Auto Theft,2014,2,15,0,13
D42,Sexual Violation,2014,6,13,0,7
D43,Theft Over $5000,2014,4,9,0,5
D43,Other,2014,46,78,0,32
D43,Break & Enter-House,2014,3,22,0,19
D42,Other,2014,13,39,0,26
D43,Other,2014,53,53,1,0
D42,Break & Enter-Apartment,2014,0,1,0,1
D42,Sexual Violation,2014,1,1,1,0
D43,Theft Over $5000,2014,0,3,0,3
D43,Other,2014,9,13,0,4
D43,Break & Enter-House,2014,5,14,0,9
D42,Other,2014,25,66,0,41
D43,Other,2014,10,10,1,0
D42,Break & Enter-Apartment,2014,0,2,0,2
D42,Sexual Violation,2014,0,1,0,1
D43,Theft Over $5000,2014,0,1,0,1
D43,Other,2014,14,22,0,8
D43,Break & Enter-House,2014,1,1,1,0
D42,Other,2014,18,57,0,39
D43,Other,2014,5,5,1,0
D42,Break & Enter-Apartment,2014,3,11,0,8
D42,Other,2014,19,20,0,1
D43,Theft Over $5000,2014,0,3,0,3
D43,Other,2014,35,43,0,8
D43,Break & Enter-House,2014,4,10,0,6
D42,Other,2014,16,43,0,27
D43,Other,2014,30,31,0,1
D43,Other,2014,4,4,1,0
D43,Other,2014,33,33,1,0
D43,Other,2014,53,58,0,5
D43,Other,2014,6,6,1,0
D43,Other,2014,36,36,1,0
D43,Auto Theft,2014,1,4,0,3
D43,Auto Theft,2014,2,30,0,28
D43,Auto Theft,2014,1,8,0,7
D43,Auto Theft,2014,1,12,0,11
D43,Auto Theft,2014,1,12,0,11
D43,Auto Theft,2014,8,22,0,14
D43,Auto Theft,2014,1,2,0,1
D43,Auto Theft,2014,4,25,0,21
D43,Auto Theft,2014,1,21,0,20
D43,Auto Theft,2014,4,21,0,17
D43,Auto Theft,2014,8,24,0,16
D43,Auto Theft,2014,2,16,0,14
D43,Auto Theft,2014,1,26,0,25
D43,Break & Enter-Apartment,2014,2,8,0,6
D43,Break & Enter-Apartment,2014,1,4,0,3
D43,Break & Enter-Apartment,2014,4,17,0,13
D43,Break & Enter-Apartment,2014,10,22,0,12
D43,Break & Enter-Apartment,2014,3,4,0,1
D43,Break & Enter-Apartment,2014,0,1,0,1
D43,Break & Enter-Apartment,2014,5,11,0,6
D43,Break & Enter-Apartment,2014,11,24,0,13
D43,Break & Enter-Apartment,2014,13,31,0,18
D43,Break & Enter-Apartment,2014,9,29,0,20
D43,Break & Enter-Commercial,2014,0,1,0,1
D43,Break & Enter-Commercial,2014,12,17,0,5
D43,Break & Enter-Commercial,2014,0,2,0,2
D43,Break & Enter-Commercial,2014,1,6,0,5
D43,Break & Enter-Commercial,2014,0,3,0,3
D43,Break & Enter-Commercial,2014,0,5,0,5
D43,Break & Enter-Commercial,2014,1,3,0,2
D43,Other,2014,5,8,0,3
D43,Theft Over $5000,2014,0,1,0,1
D42,Other,2014,24,75,0,51
D43,Break & Enter-House,2014,22,39,0,17
D43,Other,2014,35,49,0,14
D42,Other,2014,30,30,1,0
D43,Theft Over $5000,2014,1,3,0,2
D42,Break & Enter-Apartment,2014,9,17,0,8
D42,Other,2014,3,11,0,8
D43,Break & Enter-House,2014,2,8,0,6
D43,Other,2014,63,98,0,35
D42,Other,2014,1,1,1,0
D43,Break & Enter-House,2014,6,13,0,7
D43,Other,2014,10,12,0,2
D42,Other,2014,8,28,0,20
D43,Theft Over $5000,2014,2,7,0,5
D42,Break & Enter-Apartment,2014,2,4,0,2
D43,Theft Over $5000,2014,1,2,0,1
D43,Break & Enter-Other,2014,1,2,0,1
D43,Other,2014,40,50,0,10
D42,Other,2014,20,58,0,38
D42,Break & Enter-Apartment,2014,0,3,0,3
D42,Other,2014,9,9,1,0
D43,Theft Over $5000,2014,3,8,0,5
D43,Break & Enter-Other,2014,0,1,0,1
D43,Robbery-Financial,2014,2,2,1,0
D42,Other,2014,12,31,0,19
D42,Break & Enter-Apartment,2014,0,1,0,1
D42,Other,2014,5,5,1,0
D43,Theft Under $5000,2014,8,19,0,11
D43,Break & Enter-Other,2014,1,2,0,1
D43,Robbery-Financial,2014,1,1,1,0
D42,Theft Over $5000,2014,0,1,0,1
D43,Robbery-Financial,2014,1,1,1,0
D43,Theft Under $5000,2014,519,690,0,171
D42,Theft Over $5000,2014,2,19,0,17
D43,Break & Enter-Other,2014,3,7,0,4
D42,Other,2014,16,16,1,0
D42,Break & Enter-Apartment,2014,0,2,0,2
D42,Theft Over $5000,2014,1,3,0,2
D43,Robbery-Financial,2014,1,1,1,0
D43,Break & Enter-Other,2014,1,2,0,1
D43,Theft Under $5000,2014,11,55,0,44
D42,Break & Enter-Apartment,2014,0,3,0,3
D42,Other,2014,10,10,1,0
D42,Theft Over $5000,2014,0,1,0,1
D43,Robbery-Other,2014,0,6,0,6
D43,Break & Enter-Other,2014,1,7,0,6
D43,Theft Under $5000,2014,21,60,0,39
D42,Break & Enter-Apartment,2014,1,6,0,5
D42,Other,2014,19,19,1,0
D42,Theft Over $5000,2014,0,6,0,6
D43,Robbery-Other,2014,6,29,0,23
D43,Break & Enter-Other,2014,4,7,0,3
D43,Theft Under $5000,2014,47,88,0,41
D42,Break & Enter-Apartment,2014,0,7,0,7
D42,Other,2014,18,19,0,1
D42,Theft Over $5000,2014,2,4,0,2
D43,Robbery-Other,2014,2,8,0,6
D43,Break & Enter-Other,2014,3,7,0,4
D43,Theft Under $5000,2014,138,239,0,101
D42,Break & Enter-Commercial,2014,2,4,0,2
D42,Other,2014,7,8,0,1
D42,Theft Over $5000,2014,4,16,0,12
D43,Robbery-Other,2014,6,15,0,9
D43,Fraud,2014,2,6,0,4
D43,Theft Under $5000,2014,19,56,0,37
D42,Break & Enter-Commercial,2014,7,32,0,25
D42,Other,2014,4,4,1,0
D42,Theft Over $5000,2014,0,7,0,7
D43,Robbery-Other,2014,15,34,0,19
D43,Fraud,2014,50,102,0,52
D43,Theft Under $5000,2014,43,173,0,130
D42,Break & Enter-Commercial,2014,0,2,0,2
D42,Other,2014,11,11,1,0
D42,Theft Over $5000,2014,0,1,0,1
D43,Robbery-Other,2014,18,39,0,21
D43,Fraud,2014,6,12,0,6
D43,Fraud,2014,10,15,0,5
D43,Fraud,2014,13,29,0,16
D43,Fraud,2014,24,55,0,31
D43,Fraud,2014,4,6,0,2
D43,Fraud,2014,9,18,0,9
D43,Fraud,2014,12,23,0,11
D43,Fraud,2014,5,13,0,8
D43,Fraud,2014,18,34,0,16
D43,Fraud,2014,41,68,0,27
D43,Fraud,2014,7,18,0,11
D43,Fraud,2014,33,64,0,31
D43,Other,2014,13,22,0,9
D43,Other,2014,33,67,0,34
D43,Other,2014,10,25,0,15
D43,Other,2014,12,28,0,16
D43,Other,2014,26,55,0,29
D43,Other,2014,47,96,0,49
D43,Other,2014,10,29,0,19
D43,Other,2014,27,65,0,38
D43,Other,2014,1,1,1,0
D42,Theft Over $5000,2014,1,3,0,2
D43,Theft Under $5000,2014,38,97,0,59
D43,Robbery-Other,2014,7,14,0,7
D42,Theft Over $5000,2014,2,4,0,2
D43,Theft Under $5000,2014,1,5,0,4
D42,Other,2014,6,7,0,1
D43,Robbery-Other,2014,5,18,0,13
D42,Break & Enter-Commercial,2014,0,4,0,4
D42,Theft Over $5000,2014,1,1,1,0
D43,Theft Under $5000,2014,96,191,0,95
D42,Other,2014,36,40,0,4
D43,Robbery-Other,2014,0,1,0,1
D42,Break & Enter-Commercial,2014,1,3,0,2
D42,Theft Under $5000,2014,75,167,0,92
D43,Theft Under $5000,2014,122,266,0,144
D42,Other,2014,51,54,0,3
D43,Robbery-Other,2014,8,16,0,8
D42,Break & Enter-Commercial,2014,1,17,0,16
D42,Theft Under $5000,2014,61,235,0,174
D43,Theft Under $5000,2014,18,64,0,46
D42,Other,2014,5,5,1,0
D43,Robbery-Other,2014,2,10,0,8
D42,Break & Enter-Commercial,2014,6,49,0,43
D42,Theft Under $5000,2014,2,5,0,3
D43,Theft Under $5000,2014,61,175,0,114
D42,Other,2014,38,42,0,4
D43,Robbery-Other,2014,13,27,0,14
D43,Robbery-Other,2014,29,55,0,26
D43,Robbery-Other,2014,0,3,0,3
D43,Robbery-Other,2014,16,35,0,19
D43,Sexual Violation,2014,4,4,1,0
D43,Sexual Violation,2014,6,13,0,7
D43,Sexual Violation,2014,4,6,0,2
D43,Sexual Violation,2014,10,15,0,5
D43,Sexual Violation,2014,8,11,0,3
D43,Sexual Violation,2014,14,21,0,7
D43,Sexual Violation,2014,6,7,0,1
D43,Sexual Violation,2014,3,5,0,2
D43,Sexual Violation,2014,10,21,0,11
D43,Sexual Violation,2014,8,16,0,8
D43,Sexual Violation,2014,10,15,0,5
D43,Sexual Violation,2014,0,1,0,1
D43,Assault,2014,25,31,0,6
D43,Assault,2014,75,87,0,12
D42,Theft Under $5000,2014,8,76,0,68
D43,Assault,2014,41,44,0,3
D42,Theft Under $5000,2014,33,100,0,67
D43,Assault,2014,39,48,0,9
D42,Break & Enter-Commercial,2014,4,18,0,14
D42,Theft Under $5000,2014,45,124,0,79
D42,Other,2014,24,24,1,0
D43,Assault,2014,86,100,0,14
D42,Break & Enter-Commercial,2014,1,1,1,0
D42,Theft Under $5000,2014,26,91,0,65
D42,Other,2014,45,49,0,4
D43,Assault,2014,123,184,0,61
D42,Break & Enter-Commercial,2014,0,6,0,6
D42,Theft Under $5000,2014,133,273,0,140
D42,Other,2014,44,49,0,5
D43,Assault,2014,35,47,0,12
D42,Break & Enter-Commercial,2014,0,6,0,6
D42,Theft Under $5000,2014,46,166,0,120
D42,Other,2014,21,25,0,4
D43,Assault,2014,30,42,0,12
D42,Break & Enter-Commercial,2014,2,3,0,1
D42,Theft Under $5000,2014,12,26,0,14
D42,Other,2014,27,30,0,3
D43,Assault,2014,98,112,0,14
D42,Break & Enter-House,2014,4,41,0,37
D42,Theft Under $5000,2014,14,57,0,43
D42,Other,2014,15,16,0,1
D43,Assault,2014,6,17,0,11
D43,Assault,2014,104,134,0,30
D43,Assault,2014,1,1,1,0
D43,Assault,2014,251,320,0,69
D43,Assault,2014,15,20,0,5
D43,Assault,2014,98,126,0,28
D43,Attempt Murder,2014,1,1,1,0
D43,Attempt Murder,2014,1,1,1,0
D42,Other,2014,4,7,0,3
D42,Theft Under $5000,2014,124,319,0,195
D42,Other,2014,44,49,0,5
D42,Other,2014,13,16,0,3
D42,Break & Enter-House,2014,5,32,0,27
D42,Other Criminal Violations - Offensive Weapons,2014,6,6,1,0
D42,Break & Enter-House,2014,1,22,0,21
D42,Other Criminal Violations - Offensive Weapons,2014,10,11,0,1
D42,Break & Enter-House,2014,2,11,0,9
D42,Other Criminal Violations - Offensive Weapons,2014,1,1,1,0
D42,Break & Enter-House,2014,7,21,0,14
D42,Other Criminal Violations - Offensive Weapons,2014,5,5,1,0
D42,Break & Enter-House,2014,3,12,0,9
D42,Other Criminal Violations - Offensive Weapons,2014,2,5,0,3
D42,Break & Enter-House,2014,4,48,0,44
D42,Other Criminal Violations - Offensive Weapons,2014,9,10,0,1
D42,Break & Enter-House,2014,1,16,0,15
D42,Other Criminal Violations - Offensive Weapons,2014,11,11,1,0
D42,Break & Enter-House,2014,3,3,1,0
D42,Other Criminal Violations - Offensive Weapons,2014,4,4,1,0
D42,Break & Enter-House,2014,3,53,0,50
D42,Other Criminal Violations - Offensive Weapons,2014,5,6,0,1
D42,Break & Enter-House,2014,1,36,0,35
D42,Other Criminal Violations - Offensive Weapons,2014,6,6,1,0
D42,Break & Enter-House,2014,2,16,0,14
D42,Other Criminal Violations - Offensive Weapons,2014,4,4,1,0
D42,Break & Enter-Other,2014,3,7,0,4
D42,Other,2014,2,2,1,0
D42,Break & Enter-Other,2014,0,1,0,1
D42,Other,2014,1,1,1,0
D42,Break & Enter-Other,2014,0,1,0,1
D42,Other,2014,2,2,1,0
D42,Break & Enter-Other,2014,0,2,0,2
D42,Break & Enter-Other,2014,1,4,0,3
D42,Break & Enter-Other,2014,0,4,0,4
D42,Break & Enter-Other,2014,1,1,1,0
D52,Break & Enter-Commercial,2014,4,10,0,6
D52,Sexual Violation,2014,1,3,0,2
D52,Break & Enter-Commercial,2014,4,6,0,2
D52,Sexual Violation,2014,7,8,0,1
D51,Attempt Murder,2014,2,2,1,0
D52,Break & Enter-Commercial,2014,7,20,0,13
D51,Other,2014,36,37,0,1
D52,Sexual Violation,2014,7,12,0,5
D51,Attempt Murder,2014,2,2,1,0
D52,Theft Under $5000,2014,6,58,0,52
D52,Break & Enter-Commercial,2014,23,48,0,25
D43,Other,2014,2,2,1,0
D51,Other,2014,38,38,1,0
D52,Sexual Violation,2014,5,10,0,5
D51,Attempt Murder,2014,1,2,0,1
D52,Theft Under $5000,2014,0,1,0,1
D52,Break & Enter-House,2014,2,9,0,7
D43,Other,2014,3,3,1,0
D51,Other,2014,2,2,1,0
D52,Sexual Violation,2014,9,13,0,4
D51,Other,2014,8,26,0,18
D52,Theft Under $5000,2014,34,182,0,148
D52,Break & Enter-Other,2014,2,5,0,3
D43,Other,2014,4,5,0,1
D51,Other Criminal Violations - Offensive Weapons,2014,4,5,0,1
D52,Sexual Violation,2014,5,9,0,4
D51,Other,2014,13,41,0,28
D52,Theft Under $5000,2014,51,388,0,337
D52,Break & Enter-Other,2014,0,3,0,3
D43,Other,2014,2,2,1,0
D51,Other Criminal Violations - Offensive Weapons,2014,9,12,0,3
D52,Sexual Violation,2014,14,19,0,5
D51,Other,2014,28,52,0,24
D52,Theft Under $5000,2014,162,711,0,549
D52,Break & Enter-Other,2014,1,1,1,0
D51,Other,2014,28,30,0,2
D51,Other Criminal Violations - Offensive Weapons,2014,20,20,1,0
D52,Sexual Violation,2014,22,44,0,22
D51,Other,2014,0,1,0,1
D52,Theft Under $5000,2014,0,1,0,1
D52,Break & Enter-Other,2014,0,2,0,2
D43,Sexual Violation,2014,31,42,0,11
D51,Fraud,2014,4,22,0,18
D51,Other,2014,50,51,0,1
D51,Other,2014,75,76,0,1
D51,Other,2014,225,229,0,4
D51,Other,2014,9,10,0,1
D51,Other,2014,36,37,0,1
D51,Other,2014,11,11,1,0
D51,Other,2014,3,4,0,1
D51,Other,2014,18,18,1,0
D51,Auto Theft,2014,1,8,0,7
D51,Auto Theft,2014,3,9,0,6
D51,Auto Theft,2014,15,25,0,10
D51,Auto Theft,2014,14,28,0,14
D51,Auto Theft,2014,1,2,0,1
D51,Auto Theft,2014,9,22,0,13
D51,Auto Theft,2014,4,10,0,6
D51,Auto Theft,2014,1,1,1,0
D51,Auto Theft,2014,9,13,0,4
D51,Break & Enter-Apartment,2014,4,25,0,21
D51,Break & Enter-Apartment,2014,6,30,0,24
D51,Break & Enter-Apartment,2014,7,15,0,8
D51,Break & Enter-Apartment,2014,19,50,0,31
D51,Break & Enter-Apartment,2014,0,2,0,2
D51,Break & Enter-Apartment,2014,16,56,0,40
D51,Break & Enter-Apartment,2014,2,10,0,8
D51,Break & Enter-Apartment,2014,12,24,0,12
D51,Break & Enter-Commercial,2014,1,14,0,13
D51,Break & Enter-Commercial,2014,6,20,0,14
D51,Break & Enter-Commercial,2014,21,59,0,38
D51,Break & Enter-Commercial,2014,15,71,0,56
D51,Break & Enter-Commercial,2014,0,1,0,1
D51,Break & Enter-Commercial,2014,7,12,0,5
D51,Break & Enter-Commercial,2014,3,11,0,8
D51,Break & Enter-Commercial,2014,1,2,0,1
D51,Break & Enter-Commercial,2014,4,17,0,13
D51,Break & Enter-House,2014,6,24,0,18
D51,Break & Enter-House,2014,0,1,0,1
D51,Break & Enter-House,2014,5,25,0,20
D51,Break & Enter-House,2014,2,7,0,5
D51,Break & Enter-Other,2014,2,9,0,7
D51,Break & Enter-Other,2014,5,10,0,5
D51,Break & Enter-Other,2014,5,14,0,9
D51,Break & Enter-Other,2014,1,8,0,7
D51,Break & Enter-Other,2014,1,3,0,2
D51,Break & Enter-Other,2014,2,5,0,3
D51,Break & Enter-Other,2014,1,2,0,1
D52,Break & Enter-Other,2014,2,11,0,9
D51,Fraud,2014,23,72,0,49
D43,Sexual Violation,2014,3,5,0,2
D52,Theft Under $5000,2014,1548,2568,0,1020
D51,Other,2014,35,56,0,21
D51,Other Criminal Violations - Offensive Weapons,2014,31,32,0,1
D52,Assault,2014,0,1,0,1
D52,Other,2014,2,2,1,0
D51,Fraud,2014,44,99,0,55
D51,Other,2014,4,6,0,2
D51,Other Criminal Violations - Offensive Weapons,2014,1,1,1,0
D43,Sexual Violation,2014,13,19,0,6
D52,Break & Enter-Other,2014,4,5,0,1
D52,Assault,2014,66,95,0,29
D52,Other,2014,3,3,1,0
D51,Fraud,2014,22,66,0,44
D51,Other,2014,22,37,0,15
D51,Other Criminal Violations - Offensive Weapons,2014,4,5,0,1
D43,Other,2014,10,10,1,0
D52,Break & Enter-Other,2014,4,6,0,2
D52,Assault,2014,1,1,1,0
D52,Other,2014,1,1,1,0
D51,Fraud,2014,3,4,0,1
D51,Other,2014,17,26,0,9
D51,Other Criminal Violations - Offensive Weapons,2014,5,5,1,0
D43,Other,2014,11,11,1,0
D52,Fraud,2014,37,89,0,52
D52,Assault,2014,4,9,0,5
D52,Other,2014,10,10,1,0
D51,Fraud,2014,15,33,0,18
D51,Other,2014,0,1,0,1
D51,Other Criminal Violations - Offensive Weapons,2014,1,1,1,0
D43,Other,2014,11,11,1,0
D52,Fraud,2014,2,2,1,0
D52,Assault,2014,36,49,0,13
D52,Other,2014,6,6,1,0
D51,Fraud,2014,6,19,0,13
D51,Other,2014,13,25,0,12
D51,Other Criminal Violations - Offensive Weapons,2014,9,9,1,0
D43,Other,2014,6,6,1,0
D52,Fraud,2014,1,1,1,0
D52,Assault,2014,0,1,0,1
D52,Other,2014,1,1,1,0
D51,Fraud,2014,1,4,0,3
D51,Robbery-Financial,2014,4,4,1,0
D51,Other,2014,1,1,1,0
D43,Other,2014,11,11,1,0
D52,Fraud,2014,4,8,0,4
D52,Other,2014,18,18,1,0
D52,Assault,2014,63,88,0,25
D52,Other,2014,2,2,1,0
D51,Other,2014,2,2,1,0
D51,Robbery-Other,2014,1,7,0,6
D52,Fraud,2014,1,1,1,0
D51,Other,2014,3,3,1,0
D52,Other,2014,29,29,1,0
D52,Assault,2014,111,146,0,35
D43,Other,2014,26,27,0,1
D51,Fraud,2014,8,30,0,22
D52,Other,2014,12,12,1,0
D51,Robbery-Other,2014,9,35,0,26
D52,Assault,2014,11,15,0,4
D51,Other,2014,13,13,1,0
D52,Fraud,2014,8,30,0,22
D51,Other,2014,37,75,0,38
D43,Other,2014,5,5,1,0
D52,Other,2014,92,104,0,12
D51,Robbery-Other,2014,27,68,0,41
D52,Assault,2014,51,66,0,15
D51,Other,2014,1,1,1,0
D52,Fraud,2014,23,48,0,25
D51,Other,2014,66,143,0,77
D43,Other,2014,4,4,1,0
D52,Other,2014,4,4,1,0
D51,Robbery-Other,2014,55,112,0,57
D52,Assault,2014,19,29,0,10
D51,Other,2014,1,1,1,0
D52,Fraud,2014,7,18,0,11
D51,Other,2014,93,189,0,96
D43,Other,2014,8,10,0,2
D52,Other,2014,44,45,0,1
D51,Robbery-Other,2014,0,2,0,2
D52,Assault,2014,183,264,0,81
D51,Other,2014,1,1,1,0
D52,Fraud,2014,19,35,0,16
D51,Other,2014,115,245,0,130
D43,Other,2014,1,1,1,0
D52,Other,2014,32,36,0,4
D51,Robbery-Other,2014,13,31,0,18
D52,Assault,2014,271,360,0,89
D51,Other,2014,1,1,1,0
D52,Fraud,2014,3,10,0,7
D51,Other,2014,5,14,0,9
D43,Other,2014,12,12,1,0
D52,Other,2014,95,101,0,6
D51,Robbery-Other,2014,10,21,0,11
D51,Robbery-Other,2014,0,1,0,1
D51,Robbery-Other,2014,1,2,0,1
D51,Robbery-Other,2014,10,14,0,4
D51,Sexual Violation,2014,6,18,0,12
D51,Sexual Violation,2014,8,20,0,12
D51,Sexual Violation,2014,22,39,0,17
D51,Sexual Violation,2014,21,35,0,14
D51,Sexual Violation,2014,2,8,0,6
D51,Sexual Violation,2014,10,24,0,14
D51,Sexual Violation,2014,11,19,0,8
D51,Sexual Violation,2014,1,1,1,0
D51,Sexual Violation,2014,17,21,0,4
D51,Sexual Violation,2014,1,1,1,0
D51,Sexual Violation,2014,0,1,0,1
D51,Other,2014,5,5,1,0
D51,Other,2014,3,3,1,0
D51,Other,2014,18,18,1,0
D51,Other,2014,20,20,1,0
D51,Other,2014,1,1,1,0
D51,Other,2014,4,4,1,0
D51,Other,2014,4,4,1,0
D51,Other,2014,3,3,1,0
D51,Other,2014,16,16,1,0
D51,Other,2014,45,47,0,2
D51,Other,2014,75,83,0,8
D51,Other,2014,110,121,0,11
D51,Other,2014,300,314,0,14
D51,Other,2014,8,9,0,1
D51,Other,2014,53,55,0,2
D52,Attempt Murder,2014,1,1,1,0
D52,Fraud,2014,19,59,0,40
D52,Other,2014,17,18,0,1
D43,Other,2014,27,27,1,0
D52,Other,2014,14,14,1,0
D51,Other,2014,50,109,0,59
D52,Attempt Murder,2014,1,1,1,0
D52,Fraud,2014,148,254,0,106
D52,Other,2014,1,1,1,0
D43,Other,2014,3,3,1,0
D52,Other,2014,3,3,1,0
D51,Other,2014,12,43,0,31
D52,Other,2014,22,42,0,20
D52,Other,2014,0,1,0,1
D52,Other,2014,41,45,0,4
D43,Other,2014,25,25,1,0
D52,Other,2014,13,13,1,0
D52,Other,2014,29,29,1,0
D52,Other,2014,48,48,1,0
D52,Other,2014,4,4,1,0
D52,Other,2014,15,16,0,1
D52,Other,2014,3,3,1,0
D52,Other,2014,72,72,1,0
D52,Other,2014,68,68,1,0
D52,Auto Theft,2014,3,7,0,4
D52,Auto Theft,2014,1,2,0,1
D52,Auto Theft,2014,2,3,0,1
D52,Auto Theft,2014,2,11,0,9
D52,Auto Theft,2014,4,11,0,7
D52,Auto Theft,2014,0,1,0,1
D52,Auto Theft,2014,1,7,0,6
D52,Auto Theft,2014,4,14,0,10
D52,Auto Theft,2014,6,13,0,7
D52,Break & Enter-Apartment,2014,2,5,0,3
D52,Break & Enter-Apartment,2014,1,5,0,4
D52,Break & Enter-Apartment,2014,8,28,0,20
D52,Break & Enter-Apartment,2014,3,3,1,0
D52,Break & Enter-Apartment,2014,1,5,0,4
D52,Break & Enter-Apartment,2014,1,9,0,8
D52,Break & Enter-Apartment,2014,8,15,0,7
D52,Break & Enter-Commercial,2014,10,16,0,6
D52,Break & Enter-Commercial,2014,1,1,1,0
D52,Break & Enter-Commercial,2014,3,8,0,5
D52,Break & Enter-Commercial,2014,4,18,0,14
D52,Other,2014,0,1,0,1
D52,Other,2014,46,83,0,37
D52,Other,2014,3,4,0,1
D52,Other,2014,17,25,0,8
D52,Other,2014,1,1,1,0
D52,Other,2014,51,64,0,13
D52,Other,2014,3,5,0,2
D52,Other,2014,1,1,1,0
D52,Other,2014,16,16,1,0
D52,Other,2014,4,7,0,3
D52,Other,2014,38,76,0,38
D52,Other,2014,0,1,0,1
D52,Other,2014,36,133,0,97
D52,Other,2014,5,11,0,6
D52,Other,2014,4,10,0,6
D52,Other,2014,15,25,0,10
D52,Other,2014,21,45,0,24
D52,Other,2014,20,33,0,13
D52,Other,2014,35,107,0,72
D52,Other,2014,75,126,0,51
D52,Other,2014,55,106,0,51
D52,Robbery-Financial,2014,1,1,1,0
D52,Other,2014,140,232,0,92
D52,Robbery-Financial,2014,2,2,1,0
D52,Theft Over $5000,2014,7,16,0,9
D52,Robbery-Other,2014,0,2,0,2
D52,Theft Over $5000,2014,1,1,1,0
D52,Robbery-Other,2014,3,9,0,6
D52,Theft Over $5000,2014,1,8,0,7
D52,Robbery-Other,2014,0,1,0,1
D52,Theft Over $5000,2014,1,12,0,11
D52,Robbery-Other,2014,4,10,0,6
D52,Theft Over $5000,2014,3,6,0,3
D52,Robbery-Other,2014,5,8,0,3
D52,Theft Over $5000,2014,0,2,0,2
D52,Robbery-Other,2014,0,1,0,1
D52,Theft Over $5000,2014,1,9,0,8
D52,Robbery-Other,2014,8,21,0,13
D52,Theft Over $5000,2014,14,37,0,23
D52,Robbery-Other,2014,0,1,0,1
D52,Theft Under $5000,2014,0,1,0,1
D52,Robbery-Other,2014,12,18,0,6
D52,Theft Under $5000,2014,128,421,0,293
D52,Robbery-Other,2014,0,7,0,7
D52,Theft Under $5000,2014,4,28,0,24
D52,Robbery-Other,2014,6,19,0,13
D52,Theft Under $5000,2014,14,55,0,41
D52,Robbery-Other,2014,24,67,0,43
D52,Theft Under $5000,2014,24,203,0,179
D52,Sexual Violation,2014,9,16,0,7
D52,Theft Under $5000,2014,236,866,0,630
D52,Sexual Violation,2014,1,1,1,0
D52,Other,2014,17,25,0,8
D52,Other,2014,106,111,0,5
D52,Other,2014,1277,1298,0,21
D52,Other,2014,1,1,1,0
D52,Other Criminal Violations - Offensive Weapons,2014,2,2,1,0
D52,Other Criminal Violations - Offensive Weapons,2014,2,2,1,0
D52,Other Criminal Violations - Offensive Weapons,2014,6,6,1,0
D52,Other Criminal Violations - Offensive Weapons,2014,6,6,1,0
D52,Other Criminal Violations - Offensive Weapons,2014,3,3,1,0
D52,Other Criminal Violations - Offensive Weapons,2014,3,3,1,0
D52,Other Criminal Violations - Offensive Weapons,2014,11,11,1,0
D52,Other Criminal Violations - Offensive Weapons,2014,22,23,0,1
D52,Other,2014,4,4,1,0
D52,Other,2014,1,1,1,0
D52,Other,2014,4,5,0,1
D52,Other,2014,5,5,1,0
D52,Other,2014,11,12,0,1
D53,Other,2014,8,9,0,1
D53,Other,2014,1,2,0,1
D53,Other,2014,1,1,1,0
D53,Other,2014,1,1,1,0
D53,Other,2014,2,3,0,1
D53,Other,2014,4,5,0,1
D53,Other,2014,2,2,1,0
D43,Other,2014,7,7,1,0
D43,Other,2014,52,56,0,4
D43,Other,2014,18,20,0,2
D43,Other,2014,42,45,0,3
D43,Other,2014,1,1,1,0
D43,Other,2014,48,49,0,1
D43,Other,2014,120,127,0,7
D43,Other,2014,11,11,1,0
D43,Other,2014,16,19,0,3
D43,Other,2014,53,58,0,5
D43,Other,2014,7,7,1,0
D43,Other,2014,70,71,0,1
D43,Other,2014,175,186,0,11
D43,Other,2014,11,12,0,1
D43,Other,2014,55,61,0,6
D43,Other Criminal Violations - Offensive Weapons,2014,2,2,1,0
D43,Other Criminal Violations - Offensive Weapons,2014,9,9,1,0
D43,Other Criminal Violations - Offensive Weapons,2014,2,3,0,1
D43,Other Criminal Violations - Offensive Weapons,2014,4,5,0,1
D43,Other Criminal Violations - Offensive Weapons,2014,12,12,1,0
D43,Other Criminal Violations - Offensive Weapons,2014,18,19,0,1
D43,Other Criminal Violations - Offensive Weapons,2014,1,2,0,1
D43,Other Criminal Violations - Offensive Weapons,2014,1,1,1,0
D43,Other Criminal Violations - Offensive Weapons,2014,5,6,0,1
D43,Other Criminal Violations - Offensive Weapons,2014,9,9,1,0
D43,Other Criminal Violations - Offensive Weapons,2014,23,23,1,0
D43,Other Criminal Violations - Offensive Weapons,2014,1,1,1,0
D43,Other Criminal Violations - Offensive Weapons,2014,10,12,0,2
D43,Other,2014,1,1,1,0
D43,Other,2014,1,1,1,0
D43,Other,2014,1,1,1,0
D43,Other,2014,3,3,1,0
D43,Other,2014,2,2,1,0
D51,Other,2014,1,5,0,4
D51,Other,2014,31,86,0,55
D51,Theft Over $5000,2014,0,4,0,4
D51,Theft Over $5000,2014,3,10,0,7
D51,Theft Over $5000,2014,6,22,0,16
D51,Theft Over $5000,2014,0,7,0,7
D51,Theft Over $5000,2014,1,2,0,1
D51,Theft Over $5000,2014,4,7,0,3
D51,Theft Over $5000,2014,2,8,0,6
D51,Theft Over $5000,2014,2,4,0,2
D51,Theft Over $5000,2014,1,10,0,9
D51,Theft Under $5000,2014,66,314,0,248
D51,Theft Under $5000,2014,303,738,0,435
D51,Theft Under $5000,2014,157,878,0,721
D51,Theft Under $5000,2014,0,1,0,1
D51,Theft Under $5000,2014,0,1,0,1
D51,Theft Under $5000,2014,0,1,0,1
D51,Theft Under $5000,2014,167,653,0,486
D51,Theft Under $5000,2014,2,34,0,32
D51,Theft Under $5000,2014,41,221,0,180
D51,Theft Under $5000,2014,29,158,0,129
D51,Theft Under $5000,2014,2,26,0,24
D51,Theft Under $5000,2014,74,480,0,406
D51,Assault,2014,54,80,0,26
D51,Assault,2014,137,200,0,63
D51,Assault,2014,175,270,0,95
D51,Assault,2014,218,307,0,89
D51,Assault,2014,5,8,0,3
D51,Assault,2014,106,135,0,29
D51,Assault,2014,56,87,0,31
D51,Assault,2014,6,11,0,5
D51,Assault,2014,68,97,0,29
D51,Attempt Murder,2014,0,2,0,2
D51,Attempt Murder,2014,1,1,1,0
D53,Other,2014,3,4,0,1
D53,Other,2014,1,1,1,0
D53,Other,2014,5,7,0,2
D53,Robbery-Other,2014,1,1,1,0
D53,Other,2014,10,10,1,0
D55,Other,2014,9,9,1,0
D53,Robbery-Other,2014,0,1,0,1
D53,Other,2014,13,15,0,2
D53,Robbery-Other,2014,2,5,0,3
D53,Other,2014,1,1,1,0
D55,Other,2014,30,30,1,0
D53,Theft Under $5000,2014,0,1,0,1
D53,Robbery-Other,2014,6,10,0,4
D53,Other,2014,10,10,1,0
D55,Other,2014,12,12,1,0
D53,Robbery-Other,2014,6,9,0,3
D53,Theft Under $5000,2014,2,8,0,6
D53,Other,2014,41,47,0,6
D55,Break & Enter-Commercial,2014,2,6,0,4
D53,Break & Enter-Commercial,2014,1,17,0,16
D55,Auto Theft,2014,0,6,0,6
D53,Robbery-Other,2014,8,13,0,5
D53,Theft Under $5000,2014,74,219,0,145
D53,Other,2014,19,19,1,0
D55,Break & Enter-Commercial,2014,0,3,0,3
D55,Auto Theft,2014,0,1,0,1
D53,Break & Enter-Commercial,2014,8,14,0,6
D53,Other,2014,6,6,1,0
D53,Robbery-Other,2014,2,3,0,1
D53,Theft Under $5000,2014,6,36,0,30
D53,Other,2014,32,44,0,12
D55,Break & Enter-Commercial,2014,1,4,0,3
D55,Auto Theft,2014,2,8,0,6
D53,Break & Enter-Commercial,2014,3,7,0,4
D53,Other,2014,10,10,1,0
D53,Robbery-Other,2014,4,14,0,10
D53,Assault,2014,88,120,0,32
D53,Other,2014,1,1,1,0
D55,Break & Enter-Commercial,2014,1,2,0,1
D53,Other,2014,1,1,1,0
D55,Auto Theft,2014,1,7,0,6
D53,Break & Enter-House,2014,2,28,0,26
D53,Other,2014,14,16,0,2
D53,Robbery-Other,2014,0,2,0,2
D53,Assault,2014,3,3,1,0
D53,Other,2014,38,38,1,0
D55,Break & Enter-House,2014,5,11,0,6
D55,Auto Theft,2014,6,20,0,14
D53,Other,2014,5,9,0,4
D53,Break & Enter-House,2014,3,18,0,15
D53,Other,2014,12,12,1,0
D53,Other,2014,23,23,1,0
D53,Other,2014,2,2,1,0
D53,Other,2014,14,14,1,0
D53,Other,2014,1,1,1,0
D53,Auto Theft,2014,1,6,0,5
D53,Auto Theft,2014,1,8,0,7
D53,Auto Theft,2014,2,5,0,3
D53,Auto Theft,2014,0,1,0,1
D53,Auto Theft,2014,2,4,0,2
D53,Auto Theft,2014,1,6,0,5
D53,Auto Theft,2014,1,2,0,1
D53,Auto Theft,2014,7,15,0,8
D53,Auto Theft,2014,2,11,0,9
D53,Auto Theft,2014,6,7,0,1
D53,Auto Theft,2014,0,1,0,1
D53,Auto Theft,2014,0,4,0,4
D53,Auto Theft,2014,5,11,0,6
D53,Auto Theft,2014,3,5,0,2
D53,Auto Theft,2014,5,14,0,9
D53,Auto Theft,2014,1,1,1,0
D53,Auto Theft,2014,4,6,0,2
D53,Auto Theft,2014,1,2,0,1
D53,Break & Enter-Apartment,2014,3,14,0,11
D53,Break & Enter-Apartment,2014,1,2,0,1
D53,Break & Enter-Apartment,2014,1,5,0,4
D53,Break & Enter-Apartment,2014,2,5,0,3
D53,Break & Enter-Apartment,2014,0,1,0,1
D53,Break & Enter-Apartment,2014,0,3,0,3
D53,Break & Enter-Apartment,2014,5,13,0,8
D53,Break & Enter-Apartment,2014,6,10,0,4
D53,Break & Enter-Apartment,2014,6,14,0,8
D53,Break & Enter-Apartment,2014,2,13,0,11
D53,Break & Enter-Apartment,2014,0,6,0,6
D53,Break & Enter-Apartment,2014,4,12,0,8
D53,Break & Enter-Commercial,2014,14,49,0,35
D53,Break & Enter-Commercial,2014,0,1,0,1
D53,Break & Enter-Commercial,2014,1,3,0,2
D53,Break & Enter-Commercial,2014,1,1,1,0
D53,Break & Enter-Commercial,2014,1,3,0,2
D53,Break & Enter-Commercial,2014,1,4,0,3
D53,Break & Enter-Commercial,2014,4,12,0,8
D53,Break & Enter-Commercial,2014,1,10,0,9
D53,Break & Enter-Commercial,2014,0,1,0,1
D53,Break & Enter-Commercial,2014,6,9,0,3
D53,Break & Enter-Commercial,2014,7,16,0,9
D53,Break & Enter-Commercial,2014,7,8,0,1
D53,Other,2014,4,4,1,0
D55,Auto Theft,2014,2,10,0,8
D55,Break & Enter-House,2014,2,7,0,5
D53,Sexual Violation,2014,8,20,0,12
D53,Break & Enter-House,2014,1,14,0,13
D53,Other Criminal Violations - Offensive Weapons,2014,7,8,0,1
D55,Break & Enter-House,2014,6,28,0,22
D55,Auto Theft,2014,4,18,0,14
D53,Other Criminal Violations - Offensive Weapons,2014,1,1,1,0
D53,Other,2014,1,5,0,4
D55,Auto Theft,2014,2,4,0,2
D53,Sexual Violation,2014,1,2,0,1
D53,Break & Enter-House,2014,3,14,0,11
D53,Other Criminal Violations - Offensive Weapons,2014,2,2,1,0
D53,Other,2014,8,23,0,15
D55,Auto Theft,2014,4,14,0,10
D53,Sexual Violation,2014,1,1,1,0
D53,Break & Enter-House,2014,2,12,0,10
D53,Other Criminal Violations - Offensive Weapons,2014,2,2,1,0
D53,Other,2014,24,66,0,42
D55,Auto Theft,2014,7,23,0,16
D53,Sexual Violation,2014,2,2,1,0
D53,Break & Enter-House,2014,7,24,0,17
D55,Break & Enter-House,2014,6,24,0,18
D53,Other Criminal Violations - Offensive Weapons,2014,1,1,1,0
D53,Other,2014,13,35,0,22
D55,Auto Theft,2014,0,3,0,3
D53,Sexual Violation,2014,1,2,0,1
D53,Break & Enter-House,2014,12,57,0,45
D55,Break & Enter-House,2014,10,38,0,28
D53,Other Criminal Violations - Offensive Weapons,2014,7,8,0,1
D53,Other,2014,3,7,0,4
D55,Auto Theft,2014,0,2,0,2
D53,Sexual Violation,2014,0,1,0,1
D53,Break & Enter-House,2014,5,23,0,18
D55,Break & Enter-House,2014,4,7,0,3
D53,Other Criminal Violations - Offensive Weapons,2014,3,3,1,0
D53,Other,2014,0,1,0,1
D55,Auto Theft,2014,7,22,0,15
D53,Sexual Violation,2014,2,2,1,0
D53,Break & Enter-House,2014,1,17,0,16
D55,Break & Enter-House,2014,11,29,0,18
D53,Other Criminal Violations - Offensive Weapons,2014,4,4,1,0
D53,Other,2014,8,21,0,13
D53,Other,2014,41,86,0,45
D55,Auto Theft,2014,2,12,0,10
D53,Other,2014,19,37,0,18
D53,Sexual Violation,2014,2,2,1,0
D55,Break & Enter-House,2014,0,1,0,1
D53,Break & Enter-House,2014,22,66,0,44
D53,Sexual Violation,2014,5,6,0,1
D55,Auto Theft,2014,3,8,0,5
D53,Other,2014,15,46,0,31
D53,Other Criminal Violations - Offensive Weapons,2014,1,1,1,0
D53,Sexual Violation,2014,4,6,0,2
D53,Other,2014,6,7,0,1
D53,Break & Enter-House,2014,1,4,0,3
D53,Other Criminal Violations - Offensive Weapons,2014,4,4,1,0
D55,Auto Theft,2014,1,7,0,6
D55,Break & Enter-House,2014,13,28,0,15
D53,Sexual Violation,2014,5,9,0,4
D53,Other,2014,1,1,1,0
D53,Break & Enter-House,2014,0,1,0,1
D53,Other Criminal Violations - Offensive Weapons,2014,1,1,1,0
D55,Auto Theft,2014,3,7,0,4
D55,Break & Enter-House,2014,5,19,0,14
D53,Other,2014,0,1,0,1
D53,Sexual Violation,2014,1,5,0,4
D53,Break & Enter-House,2014,3,14,0,11
D53,Other,2014,1,1,1,0
D55,Auto Theft,2014,1,2,0,1
D55,Break & Enter-House,2014,2,17,0,15
D53,Other,2014,23,54,0,31
D53,Sexual Violation,2014,3,10,0,7
D53,Break & Enter-House,2014,7,14,0,7
D53,Other,2014,1,1,1,0
D55,Break & Enter-Apartment,2014,4,6,0,2
D55,Break & Enter-House,2014,5,15,0,10
D53,Other,2014,10,33,0,23
D53,Sexual Violation,2014,4,6,0,2
D53,Break & Enter-Other,2014,2,5,0,3
D53,Other,2014,1,1,1,0
D55,Break & Enter-Apartment,2014,2,6,0,4
D55,Break & Enter-House,2014,12,42,0,30
D53,Theft Over $5000,2014,3,19,0,16
D53,Sexual Violation,2014,2,3,0,1
D53,Break & Enter-Other,2014,0,2,0,2
D55,Break & Enter-Apartment,2014,2,4,0,2
D53,Other,2014,2,2,1,0
D55,Break & Enter-House,2014,4,13,0,9
D53,Sexual Violation,2014,5,8,0,3
D53,Break & Enter-Other,2014,0,1,0,1
D53,Theft Over $5000,2014,0,2,0,2
D55,Break & Enter-House,2014,10,30,0,20
D53,Other,2014,1,1,1,0
D53,Break & Enter-Other,2014,1,1,1,0
D55,Break & Enter-Apartment,2014,3,4,0,1
D53,Theft Over $5000,2014,1,1,1,0
D55,Break & Enter-House,2014,1,5,0,4
D53,Other,2014,1,1,1,0
D53,Break & Enter-Other,2014,0,2,0,2
D55,Break & Enter-Apartment,2014,7,24,0,17
D53,Other,2014,3,3,1,0
D53,Other,2014,8,8,1,0
D53,Assault,2014,12,12,1,0
D53,Break & Enter-Other,2014,1,3,0,2
D53,Other,2014,1,1,1,0
D53,Theft Over $5000,2014,2,3,0,1
D55,Break & Enter-Apartment,2014,7,38,0,31
D55,Break & Enter-House,2014,7,23,0,16
D53,Other,2014,3,3,1,0
D53,Assault,2014,7,10,0,3
D53,Break & Enter-Other,2014,1,3,0,2
D53,Other,2014,3,3,1,0
D53,Theft Over $5000,2014,1,1,1,0
D55,Break & Enter-Apartment,2014,2,10,0,8
D55,Break & Enter-House,2014,14,28,0,14
D53,Other,2014,1,1,1,0
D53,Assault,2014,7,7,1,0
D53,Break & Enter-Other,2014,4,7,0,3
D53,Other,2014,1,1,1,0
D53,Theft Over $5000,2014,0,1,0,1
D55,Break & Enter-Apartment,2014,0,2,0,2
D55,Break & Enter-Other,2014,0,1,0,1
D55,Other,2014,25,26,0,1
D53,Assault,2014,0,2,0,2
D53,Break & Enter-Other,2014,0,1,0,1
D53,Other,2014,1,1,1,0
D53,Theft Over $5000,2014,0,5,0,5
D55,Break & Enter-Apartment,2014,11,19,0,8
D55,Break & Enter-Other,2014,1,2,0,1
D55,Other,2014,5,5,1,0
D53,Assault,2014,15,16,0,1
D53,Assault,2014,2,5,0,3
D53,Assault,2014,12,13,0,1
D53,Assault,2014,24,36,0,12
D53,Assault,2014,20,23,0,3
D53,Assault,2014,10,12,0,2
D53,Assault,2014,37,40,0,3
D53,Assault,2014,40,56,0,16
D53,Assault,2014,47,59,0,12
D53,Assault,2014,62,81,0,19
D53,Assault,2014,7,10,0,3
D53,Assault,2014,3,3,1,0
D53,Assault,2014,43,50,0,7
D53,Assault,2014,10,15,0,5
D53,Attempt Murder,2014,1,1,1,0
D53,Attempt Murder,2014,0,1,0,1
D53,Other,2014,28,41,0,13
D53,Other,2014,2,3,0,1
D53,Other,2014,3,5,0,2
D53,Other,2014,1,3,0,2
D53,Other,2014,3,4,0,1
D53,Other,2014,8,13,0,5
D53,Other,2014,7,14,0,7
D53,Other,2014,8,13,0,5
D53,Other,2014,0,1,0,1
D53,Other,2014,1,1,1,0
D53,Other,2014,5,9,0,4
D53,Other,2014,21,31,0,10
D53,Other,2014,17,25,0,8
D53,Other,2014,16,24,0,8
D53,Other,2014,0,1,0,1
D53,Other,2014,14,29,0,15
D53,Other,2014,7,11,0,4
D53,Robbery-Financial,2014,1,1,1,0
D53,Robbery-Other,2014,2,11,0,9
D53,Robbery-Other,2014,0,1,0,1
D53,Robbery-Other,2014,0,2,0,2
D53,Robbery-Other,2014,0,1,0,1
D53,Robbery-Other,2014,1,2,0,1
D53,Robbery-Other,2014,3,6,0,3
D53,Break & Enter-Other,2014,0,3,0,3
D55,Other,2014,3,3,1,0
D53,Other,2014,2,2,1,0
D55,Break & Enter-Apartment,2014,1,2,0,1
D55,Break & Enter-Other,2014,0,1,0,1
D53,Theft Over $5000,2014,1,9,0,8
D53,Other,2014,1,1,1,0
D53,Break & Enter-Other,2014,1,2,0,1
D53,Other,2014,4,4,1,0
D55,Other,2014,25,25,1,0
D55,Break & Enter-Apartment,2014,0,7,0,7
D55,Break & Enter-Other,2014,4,7,0,3
D55,Other,2014,8,8,1,0
D53,Other,2014,6,6,1,0
D53,Break & Enter-Other,2014,3,4,0,1
D53,Theft Over $5000,2014,1,2,0,1
D53,Other,2014,5,5,1,0
D53,Fraud,2014,40,94,0,54
D55,Break & Enter-Apartment,2014,11,22,0,11
D55,Other,2014,53,54,0,1
D53,Theft Over $5000,2014,0,2,0,2
D53,Other,2014,1,1,1,0
D53,Fraud,2014,4,6,0,2
D55,Break & Enter-Apartment,2014,7,13,0,6
D55,Other,2014,45,45,1,0
D55,Break & Enter-Other,2014,1,1,1,0
D53,Theft Over $5000,2014,2,7,0,5
D53,Other,2014,1,1,1,0
D53,Fraud,2014,0,5,0,5
D55,Break & Enter-Apartment,2014,2,8,0,6
D55,Other,2014,59,61,0,2
D55,Break & Enter-Other,2014,2,4,0,2
D53,Theft Over $5000,2014,1,5,0,4
D53,Other,2014,4,4,1,0
D53,Fraud,2014,2,4,0,2
D55,Break & Enter-Apartment,2014,1,5,0,4
D55,Other,2014,5,5,1,0
D55,Break & Enter-Other,2014,0,2,0,2
D53,Theft Over $5000,2014,5,9,0,4
D53,Other,2014,12,14,0,2
D53,Fraud,2014,4,8,0,4
D55,Break & Enter-Apartment,2014,1,4,0,3
D55,Other,2014,16,17,0,1
D55,Break & Enter-Other,2014,0,2,0,2
D53,Theft Over $5000,2014,3,5,0,2
D53,Other,2014,8,8,1,0
D53,Fraud,2014,3,5,0,2
D55,Break & Enter-Apartment,2014,0,6,0,6
D55,Other,2014,36,40,0,4
D55,Break & Enter-Other,2014,0,2,0,2
D53,Theft Over $5000,2014,0,3,0,3
D53,Other,2014,6,6,1,0
D53,Other,2014,1,1,1,0
D53,Other,2014,6,6,1,0
D53,Other,2014,2,3,0,1
D53,Other,2014,100,105,0,5
D53,Other,2014,2,2,1,0
D53,Other,2014,1,1,1,0
D53,Other,2014,3,3,1,0
D53,Other,2014,1,1,1,0
D53,Other,2014,2,3,0,1
D53,Fraud,2014,5,10,0,5
D55,Other,2014,1,1,1,0
D55,Break & Enter-Commercial,2014,2,3,0,1
D55,Break & Enter-Other,2014,3,7,0,4
D53,Fraud,2014,12,27,0,15
D53,Theft Under $5000,2014,142,530,0,388
D55,Other,2014,18,18,1,0
D55,Break & Enter-Commercial,2014,1,6,0,5
D55,Break & Enter-Other,2014,0,3,0,3
D53,Fraud,2014,5,15,0,10
D53,Theft Under $5000,2014,3,9,0,6
D55,Other,2014,7,7,1,0
D55,Break & Enter-Commercial,2014,1,2,0,1
D55,Break & Enter-Other,2014,0,1,0,1
D53,Fraud,2014,5,7,0,2
D53,Theft Under $5000,2014,8,24,0,16
D55,Other,2014,79,81,0,2
D55,Break & Enter-Commercial,2014,3,12,0,9
D55,Break & Enter-Other,2014,0,1,0,1
D53,Fraud,2014,16,30,0,14
D53,Theft Under $5000,2014,6,34,0,28
D55,Other,2014,35,37,0,2
D55,Break & Enter-Commercial,2014,2,4,0,2
D55,Break & Enter-Other,2014,0,1,0,1
D53,Fraud,2014,56,85,0,29
D53,Theft Under $5000,2014,3,28,0,25
D55,Other,2014,19,21,0,2
D55,Break & Enter-Commercial,2014,4,5,0,1
D55,Fraud,2014,0,1,0,1
D53,Fraud,2014,13,36,0,23
D53,Theft Under $5000,2014,1,9,0,8
D55,Break & Enter-Commercial,2014,4,11,0,7
D55,Fraud,2014,1,13,0,12
D53,Fraud,2014,29,50,0,21
D53,Theft Under $5000,2014,5,25,0,20
D53,Theft Under $5000,2014,4,16,0,12
D53,Theft Under $5000,2014,1,1,1,0
D53,Theft Under $5000,2014,18,94,0,76
D53,Theft Under $5000,2014,21,127,0,106
D53,Theft Under $5000,2014,19,93,0,74
D53,Theft Under $5000,2014,4,14,0,10
D53,Theft Under $5000,2014,1,2,0,1
D53,Theft Under $5000,2014,22,91,0,69
D53,Theft Under $5000,2014,289,521,0,232
D53,Theft Under $5000,2014,52,151,0,99
D53,Theft Under $5000,2014,252,351,0,99
D55,Break & Enter-Commercial,2014,7,16,0,9
D53,Fraud,2014,13,30,0,17
D55,Break & Enter-Commercial,2014,0,1,0,1
D55,Break & Enter-Commercial,2014,3,12,0,9
D53,Fraud,2014,7,19,0,12
D55,Break & Enter-Commercial,2014,3,15,0,12
D53,Other,2014,36,93,0,57
D55,Break & Enter-Commercial,2014,0,3,0,3
D53,Other,2014,0,3,0,3
D53,Other,2014,2,7,0,5
D53,Other,2014,2,10,0,8
D53,Other,2014,8,17,0,9
D55,Fraud,2014,1,10,0,9
D55,Fraud,2014,5,22,0,17
D55,Fraud,2014,5,16,0,11
D55,Fraud,2014,22,56,0,34
D55,Fraud,2014,14,42,0,28
D55,Fraud,2014,4,19,0,15
D55,Fraud,2014,1,6,0,5
D55,Fraud,2014,5,21,0,16
D55,Fraud,2014,15,40,0,25
D55,Fraud,2014,3,12,0,9
D55,Fraud,2014,4,14,0,10
D55,Fraud,2014,28,77,0,49
D55,Theft Under $5000,2014,54,157,0,103
NSA,Sexual Violation,2014,1,1,1,0
D55,Theft Under $5000,2014,33,144,0,111
D11,Break & Enter-Apartment,2015,9,20,0,11
D55,Theft Under $5000,2014,1,2,0,1
D55,Theft Under $5000,2014,25,93,0,68
NSA,Sexual Violation,2014,0,1,0,1
D11,Break & Enter-Apartment,2015,2,6,0,4
D55,Other,2014,4,4,1,0
D55,Theft Under $5000,2014,60,162,0,102
D55,Other,2014,44,60,0,16
D55,Other Criminal Violations - Offensive Weapons,2014,12,12,1,0
NSA,Sexual Violation,2014,0,1,0,1
NSA,Sexual Violation,2014,27,67,0,40
NSA,Sexual Violation,2014,6,6,1,0
NSA,Sexual Violation,2014,0,1,0,1
NSA,Sexual Violation,2014,1,1,1,0
NSA,Sexual Violation,2014,0,1,0,1
NSA,Sexual Violation,2014,0,1,0,1
NSA,Sexual Violation,2014,0,1,0,1
NSA,Other,2014,1,1,1,0
NSA,Other,2014,105,107,0,2
NSA,Other,2014,1,1,1,0
NSA,Other,2014,1,1,1,0
NSA,Other,2014,1,1,1,0
NSA,Other,2014,1,1,1,0
NSA,Other,2014,116,123,0,7
NSA,Other,2014,1,1,1,0
NSA,Other,2014,1,1,1,0
NSA,Other,2014,1,1,1,0
NSA,Other Criminal Violations - Offensive Weapons,2014,22,24,0,2
NSA,Other,2014,18,18,1,0
D11,Other,2015,1,1,1,0
D11,Other,2015,14,15,0,1
D11,Other,2015,1,1,1,0
D11,Other,2015,23,24,0,1
D11,Other,2015,14,17,0,3
D11,Other,2015,22,22,1,0
D11,Other,2015,18,18,1,0
D11,Other,2015,2,2,1,0
D11,Other,2015,5,7,0,2
D11,Other,2015,3,3,1,0
D11,Other,2015,21,22,0,1
D11,Other,2015,8,9,0,1
D11,Other,2015,15,16,0,1
D11,Other,2015,43,46,0,3
D11,Auto Theft,2015,1,5,0,4
D11,Auto Theft,2015,0,14,0,14
D11,Auto Theft,2015,2,20,0,18
D11,Auto Theft,2015,3,16,0,13
D11,Auto Theft,2015,7,14,0,7
D11,Auto Theft,2015,1,6,0,5
D11,Auto Theft,2015,0,5,0,5
D11,Auto Theft,2015,1,2,0,1
D11,Auto Theft,2015,1,6,0,5
D11,Auto Theft,2015,0,12,0,12
D11,Auto Theft,2015,0,2,0,2
D11,Fraud,2015,8,16,0,8
D11,Auto Theft,2015,2,9,0,7
D11,Break & Enter-Apartment,2015,2,2,1,0
D11,Break & Enter-Apartment,2015,14,43,0,29
D55,Fraud,2014,0,1,0,1
D11,Break & Enter-Apartment,2015,10,21,0,11
D55,Other,2014,4,4,1,0
D55,Fraud,2014,8,26,0,18
D55,Other Criminal Violations - Offensive Weapons,2014,10,10,1,0
D11,Other,2015,15,38,0,23
D55,Other Criminal Violations - Offensive Weapons,2014,6,6,1,0
D55,Theft Under $5000,2014,296,678,0,382
D55,Other,2014,12,13,0,1
D55,Other Criminal Violations - Offensive Weapons,2014,0,1,0,1
D55,Other,2014,5,6,0,1
D55,Theft Under $5000,2014,115,234,0,119
D55,Other Criminal Violations - Offensive Weapons,2014,6,6,1,0
D55,Other,2014,19,19,1,0
D11,Break & Enter-Apartment,2015,1,4,0,3
D11,Other,2015,0,1,0,1
D55,Fraud,2014,9,41,0,32
D55,Theft Under $5000,2014,76,209,0,133
D55,Other,2014,3,3,1,0
D55,Other,2014,3,4,0,1
D11,Break & Enter-Apartment,2015,0,2,0,2
D11,Other,2015,27,81,0,54
D55,Fraud,2014,6,11,0,5
D55,Theft Under $5000,2014,9,51,0,42
D55,Other,2014,1,1,1,0
D55,Other,2014,6,6,1,0
D11,Break & Enter-Apartment,2015,6,15,0,9
D11,Other,2015,37,111,0,74
D55,Fraud,2014,4,26,0,22
D55,Theft Under $5000,2014,59,140,0,81
D55,Other,2014,2,2,1,0
D55,Other,2014,6,6,1,0
D11,Break & Enter-Apartment,2015,1,1,1,0
D11,Other,2015,28,66,0,38
D55,Fraud,2014,2,12,0,10
D55,Other,2014,13,27,0,14
D55,Theft Under $5000,2014,5,68,0,63
D55,Other,2014,2,2,1,0
D55,Other,2014,16,16,1,0
D11,Break & Enter-Apartment,2015,0,3,0,3
D11,Other,2015,36,101,0,65
D55,Other,2014,26,67,0,41
D55,Other,2014,20,30,0,10
D55,Assault,2014,47,68,0,21
D55,Other,2014,3,3,1,0
D55,Other,2014,2,2,1,0
D11,Break & Enter-Apartment,2015,2,2,1,0
D55,Other,2014,10,43,0,33
D11,Other,2015,7,40,0,33
D55,Other,2014,19,62,0,43
D55,Other,2014,5,15,0,10
D55,Other,2014,11,41,0,30
D11,Other,2015,4,21,0,17
D55,Assault,2014,39,46,0,7
D11,Break & Enter-Commercial,2015,4,6,0,2
D55,Other,2014,26,26,1,0
D55,Other,2014,2,2,1,0
D11,Break & Enter-Commercial,2015,3,3,1,0
D55,Assault,2014,5,5,1,0
D55,Other,2014,5,5,1,0
D55,Other,2014,15,20,0,5
D55,Other,2014,41,98,0,57
D55,Other,2014,1,1,1,0
D11,Break & Enter-Commercial,2015,5,7,0,2
D11,Other,2015,1,7,0,6
D55,Assault,2014,47,76,0,29
D55,Other,2014,17,17,1,0
D55,Other,2014,15,22,0,7
D55,Other,2014,19,79,0,60
D55,Other,2014,3,3,1,0
D11,Break & Enter-Commercial,2015,5,13,0,8
D11,Other,2015,1,2,0,1
D55,Assault,2014,49,69,0,20
D55,Robbery-Financial,2014,1,1,1,0
D55,Other,2014,4,4,1,0
D55,Other,2014,1,1,1,0
D55,Other,2014,1,1,1,0
D11,Break & Enter-Commercial,2015,3,9,0,6
D11,Other,2015,25,82,0,57
D55,Assault,2014,115,163,0,48
D55,Robbery-Financial,2014,1,1,1,0
D55,Other,2014,6,6,1,0
D55,Other,2014,20,65,0,45
D55,Other,2014,1,1,1,0
D11,Break & Enter-Commercial,2015,1,1,1,0
D11,Other,2015,8,31,0,23
D55,Assault,2014,76,113,0,37
D55,Robbery-Financial,2014,2,2,1,0
D55,Other,2014,1,1,1,0
D55,Other,2014,4,11,0,7
D55,Other,2014,3,3,1,0
D11,Break & Enter-Commercial,2015,2,7,0,5
D11,Other,2015,3,7,0,4
D55,Assault,2014,70,105,0,35
D55,Robbery-Other,2014,0,1,0,1
D55,Robbery-Other,2014,5,11,0,6
D55,Robbery-Other,2014,2,7,0,5
D55,Robbery-Other,2014,6,10,0,4
D55,Robbery-Other,2014,1,3,0,2
D55,Robbery-Other,2014,14,27,0,13
D55,Robbery-Other,2014,12,21,0,9
D55,Robbery-Other,2014,10,14,0,4
D55,Robbery-Other,2014,2,7,0,5
D55,Robbery-Other,2014,6,17,0,11
D55,Robbery-Other,2014,11,23,0,12
D55,Robbery-Other,2014,3,13,0,10
D55,Robbery-Other,2014,8,9,0,1
D55,Robbery-Other,2014,34,55,0,21
D55,Robbery-Other,2014,10,18,0,8
D55,Robbery-Other,2014,8,13,0,5
D55,Robbery-Other,2014,2,5,0,3
D55,Robbery-Other,2014,6,10,0,4
D55,Robbery-Other,2014,3,3,1,0
D55,Sexual Violation,2014,5,9,0,4
D55,Sexual Violation,2014,7,10,0,3
D55,Sexual Violation,2014,4,7,0,3
D55,Sexual Violation,2014,8,10,0,2
D55,Sexual Violation,2014,18,24,0,6
D55,Sexual Violation,2014,14,23,0,9
D55,Sexual Violation,2014,5,9,0,4
D55,Sexual Violation,2014,3,8,0,5
D55,Sexual Violation,2014,0,2,0,2
D55,Sexual Violation,2014,7,8,0,1
D55,Sexual Violation,2014,0,1,0,1
D55,Sexual Violation,2014,2,6,0,4
D55,Sexual Violation,2014,4,6,0,2
D55,Sexual Violation,2014,12,24,0,12
D55,Sexual Violation,2014,5,7,0,2
D55,Sexual Violation,2014,4,5,0,1
D55,Sexual Violation,2014,3,3,1,0
D55,Sexual Violation,2014,6,7,0,1
D55,Sexual Violation,2014,5,8,0,3
D55,Other,2014,9,9,1,0
D55,Other,2014,5,5,1,0
D55,Other,2014,2,2,1,0
D55,Other,2014,17,58,0,41
D55,Other,2014,1,1,1,0
D55,Assault,2014,1,1,1,0
D55,Other,2014,35,104,0,69
D11,Other,2015,12,35,0,23
D55,Other,2014,41,47,0,6
D55,Other,2014,8,37,0,29
D55,Assault,2014,6,14,0,8
D55,Other,2014,17,21,0,4
D11,Theft Over $5000,2015,1,4,0,3
D11,Break & Enter-Commercial,2015,0,1,0,1
D55,Other,2014,1,2,0,1
NSA,Other,2014,91,106,0,15
D55,Assault,2014,32,44,0,12
D11,Break & Enter-Commercial,2015,1,8,0,7
D55,Other,2014,37,42,0,5
NSA,Other,2014,1,1,1,0
D55,Other,2014,9,45,0,36
D55,Assault,2014,127,160,0,33
D11,Theft Over $5000,2015,0,1,0,1
D11,Break & Enter-Commercial,2015,6,15,0,9
D55,Other,2014,16,19,0,3
NSA,Auto Theft,2014,0,2,0,2
D55,Other,2014,72,171,0,99
D55,Assault,2014,5,9,0,4
D11,Theft Over $5000,2015,1,5,0,4
D11,Break & Enter-Commercial,2015,1,1,1,0
D55,Other,2014,82,95,0,13
NSA,Auto Theft,2014,10,31,0,21
D55,Other,2014,21,62,0,41
D55,Other,2014,29,88,0,59
D55,Other,2014,2,16,0,14
D55,Other,2014,17,46,0,29
D55,Other,2014,7,30,0,23
D55,Theft Over $5000,2014,1,2,0,1
D55,Theft Over $5000,2014,1,2,0,1
D55,Theft Over $5000,2014,0,1,0,1
D55,Theft Over $5000,2014,1,4,0,3
D55,Theft Over $5000,2014,3,9,0,6
D55,Theft Over $5000,2014,0,5,0,5
D55,Theft Over $5000,2014,1,3,0,2
D55,Theft Over $5000,2014,2,3,0,1
D55,Theft Over $5000,2014,2,11,0,9
D55,Theft Over $5000,2014,1,4,0,3
D55,Theft Over $5000,2014,5,13,0,8
D55,Theft Over $5000,2014,3,4,0,1
D55,Theft Over $5000,2014,4,8,0,4
D55,Theft Over $5000,2014,1,2,0,1
D55,Theft Over $5000,2014,0,2,0,2
D55,Theft Over $5000,2014,0,2,0,2
D55,Theft Under $5000,2014,53,167,0,114
D55,Theft Under $5000,2014,20,62,0,42
D55,Theft Under $5000,2014,0,2,0,2
D55,Theft Under $5000,2014,29,112,0,83
D55,Theft Under $5000,2014,12,114,0,102
D55,Theft Under $5000,2014,122,310,0,188
D55,Theft Under $5000,2014,33,205,0,172
D55,Theft Under $5000,2014,39,133,0,94
D55,Theft Under $5000,2014,1,10,0,9
D55,Other,2014,61,64,0,3
D11,Break & Enter-Commercial,2015,1,3,0,2
D55,Assault,2014,28,44,0,16
D55,Other,2014,56,62,0,6
D11,Break & Enter-House,2015,4,7,0,3
D55,Assault,2014,26,44,0,18
D55,Other,2014,10,11,0,1
D11,Break & Enter-House,2015,7,16,0,9
D55,Assault,2014,142,181,0,39
NSA,Break & Enter-Apartment,2014,1,1,1,0
D55,Other,2014,17,24,0,7
D11,Theft Over $5000,2015,2,5,0,3
D11,Break & Enter-House,2015,10,21,0,11
D55,Assault,2014,71,106,0,35
NSA,Break & Enter-Commercial,2014,0,1,0,1
D55,Other,2014,78,87,0,9
D11,Break & Enter-House,2015,3,7,0,4
D11,Theft Over $5000,2015,1,2,0,1
D55,Assault,2014,68,83,0,15
D55,Other,2014,1,1,1,0
NSA,Break & Enter-House,2014,5,5,1,0
D55,Assault,2014,18,36,0,18
D11,Break & Enter-House,2015,4,10,0,6
D55,Other,2014,14,16,0,2
NSA,Fraud,2014,1,1,1,0
D55,Assault,2014,56,83,0,27
D11,Break & Enter-House,2015,4,8,0,4
D11,Theft Over $5000,2015,0,1,0,1
D55,Other,2014,24,29,0,5
NSA,Fraud,2014,1,1,1,0
D55,Assault,2014,36,47,0,11
D11,Break & Enter-House,2015,0,4,0,4
D11,Theft Over $5000,2015,0,2,0,2
D55,Other,2014,110,122,0,12
NSA,Fraud,2014,1,1,1,0
D55,Attempt Murder,2014,1,1,1,0
D11,Break & Enter-House,2015,5,13,0,8
D11,Theft Over $5000,2015,0,1,0,1
D55,Other,2014,45,50,0,5
NSA,Fraud,2014,34,60,0,26
D55,Attempt Murder,2014,0,1,0,1
D11,Break & Enter-House,2015,5,8,0,3
D11,Theft Over $5000,2015,0,1,0,1
D55,Other,2014,40,44,0,4
NSA,Fraud,2014,0,1,0,1
D11,Break & Enter-House,2015,1,1,1,0
D55,Attempt Murder,2014,1,1,1,0
D11,Theft Under $5000,2015,0,2,0,2
D55,Other,2014,23,24,0,1
NSA,Other,2014,0,1,0,1
D11,Break & Enter-House,2015,1,6,0,5
D55,Attempt Murder,2014,1,1,1,0
D11,Theft Under $5000,2015,298,444,0,146
D55,Other,2014,88,88,1,0
NSA,Other,2014,0,1,0,1
D11,Break & Enter-Other,2015,0,1,0,1
D55,Attempt Murder,2014,1,1,1,0
D11,Theft Under $5000,2015,44,162,0,118
D55,Other,2014,17,19,0,2
NSA,Other,2014,30,53,0,23
D11,Break & Enter-Other,2015,5,8,0,3
D55,Other,2014,16,28,0,12
D11,Theft Under $5000,2015,67,215,0,148
D55,Other Criminal Violations - Offensive Weapons,2014,10,10,1,0
D55,Other,2014,10,21,0,11
D11,Break & Enter-Other,2015,1,2,0,1
D55,Other Criminal Violations - Offensive Weapons,2014,1,1,1,0
D11,Theft Under $5000,2015,107,249,0,142
NSA,Theft Over $5000,2014,2,4,0,2
D55,Other,2014,14,22,0,8
D11,Break & Enter-Other,2015,0,1,0,1
D55,Other Criminal Violations - Offensive Weapons,2014,4,4,1,0
NSA,Theft Under $5000,2014,0,1,0,1
D11,Theft Under $5000,2015,52,170,0,118
D55,Other,2014,9,16,0,7
D11,Break & Enter-Other,2015,0,1,0,1
D55,Other Criminal Violations - Offensive Weapons,2014,4,4,1,0
NSA,Theft Under $5000,2014,37,91,0,54
D11,Theft Under $5000,2015,3,37,0,34
D55,Other,2014,31,51,0,20
D11,Break & Enter-Other,2015,1,1,1,0
D55,Other Criminal Violations - Offensive Weapons,2014,4,5,0,1
NSA,Theft Under $5000,2014,0,1,0,1
D11,Theft Under $5000,2015,41,74,0,33
D55,Other,2014,20,40,0,20
D11,Fraud,2015,9,34,0,25
D55,Other Criminal Violations - Offensive Weapons,2014,10,10,1,0
NSA,Assault,2014,0,1,0,1
D11,Theft Under $5000,2015,4,12,0,8
D55,Other,2014,31,48,0,17
D11,Fraud,2015,11,38,0,27
D55,Other Criminal Violations - Offensive Weapons,2014,6,6,1,0
NSA,Assault,2014,52,79,0,27
D11,Theft Under $5000,2015,56,73,0,17
D55,Other,2014,3,5,0,2
D11,Fraud,2015,8,41,0,33
D55,Other Criminal Violations - Offensive Weapons,2014,2,2,1,0
NSA,Assault,2014,1,1,1,0
D11,Theft Under $5000,2015,69,205,0,136
D55,Other,2014,10,15,0,5
D11,Fraud,2015,10,32,0,22
D55,Other Criminal Violations - Offensive Weapons,2014,4,6,0,2
NSA,Assault,2014,1,1,1,0
D11,Theft Under $5000,2015,61,152,0,91
D55,Other,2014,39,55,0,16
D11,Fraud,2015,10,38,0,28
D55,Other Criminal Violations - Offensive Weapons,2014,15,18,0,3
D55,Other Criminal Violations - Offensive Weapons,2014,2,2,1,0
D55,Other Criminal Violations - Offensive Weapons,2014,5,5,1,0
D55,Other Criminal Violations - Offensive Weapons,2014,4,4,1,0
D11,Fraud,2015,2,9,0,7
D55,Other,2014,1,1,1,0
D11,Theft Under $5000,2015,2,25,0,23
NSA,Assault,2014,0,1,0,1
D11,Fraud,2015,1,7,0,6
D55,Other,2014,7,17,0,10
D11,Theft Under $5000,2015,1,1,1,0
NSA,Attempt Murder,2014,0,1,0,1
D11,Fraud,2015,0,1,0,1
D55,Other,2014,3,8,0,5
D11,Theft Under $5000,2015,12,53,0,41
NSA,Other,2014,1,1,1,0
D11,Fraud,2015,0,3,0,3
D11,Assault,2015,1,3,0,2
NSA,Other,2014,15,27,0,12
D11,Fraud,2015,11,36,0,25
D11,Assault,2015,1,1,1,0
NSA,Other,2014,0,1,0,1
D11,Fraud,2015,12,25,0,13
D11,Assault,2015,37,54,0,17
NSA,Other,2014,0,1,0,1
D11,Fraud,2015,2,4,0,2
D11,Assault,2015,0,1,0,1
NSA,Other,2014,0,1,0,1
D11,Assault,2015,66,85,0,19
NSA,Robbery-Financial,2014,6,6,1,0
D11,Assault,2015,79,107,0,28
NSA,Robbery-Other,2014,26,36,0,10
D11,Assault,2015,62,75,0,13
NSA,Sexual Violation,2014,1,1,1,0
D11,Assault,2015,95,109,0,14
NSA,Sexual Violation,2014,0,1,0,1
D11,Assault,2015,19,33,0,14
D11,Assault,2015,11,14,0,3
D11,Assault,2015,0,3,0,3
D12,Theft Under $5000,2015,130,192,0,62
D12,Theft Under $5000,2015,29,119,0,90
D12,Theft Under $5000,2015,5,31,0,26
D11,Sexual Violation,2015,8,11,0,3
D12,Sexual Violation,2015,1,1,1,0
D12,Break & Enter-House,2015,0,7,0,7
D13,Break & Enter-Commercial,2015,2,3,0,1
D12,Other,2015,4,4,1,0
D12,Theft Under $5000,2015,84,207,0,123
D12,Theft Under $5000,2015,4,22,0,18
D12,Theft Under $5000,2015,0,1,0,1
D12,Assault,2015,41,54,0,13
D12,Assault,2015,69,86,0,17
D12,Assault,2015,8,10,0,2
D12,Assault,2015,35,54,0,19
D12,Assault,2015,18,23,0,5
D12,Assault,2015,68,87,0,19
D12,Assault,2015,2,8,0,6
D12,Assault,2015,10,14,0,4
D12,Assault,2015,94,117,0,23
D12,Assault,2015,0,1,0,1
D12,Assault,2015,43,53,0,10
D12,Assault,2015,95,140,0,45
D12,Assault,2015,24,30,0,6
D12,Attempt Murder,2015,0,2,0,2
D12,Attempt Murder,2015,1,2,0,1
D12,Attempt Murder,2015,1,2,0,1
D12,Other,2015,9,16,0,7
D12,Other,2015,18,28,0,10
D12,Other,2015,7,11,0,4
D12,Other,2015,12,17,0,5
D12,Other,2015,10,14,0,4
D12,Other,2015,20,28,0,8
D12,Other,2015,1,4,0,3
D12,Other,2015,5,9,0,4
D12,Other,2015,24,37,0,13
D12,Other,2015,12,16,0,4
D12,Other,2015,31,51,0,20
D12,Other,2015,4,5,0,1
D12,Robbery-Financial,2015,1,1,1,0
D12,Robbery-Financial,2015,1,1,1,0
D12,Robbery-Other,2015,4,10,0,6
D12,Robbery-Other,2015,14,19,0,5
D12,Robbery-Other,2015,1,3,0,2
D12,Robbery-Other,2015,6,19,0,13
D12,Robbery-Other,2015,3,3,1,0
D12,Robbery-Other,2015,5,9,0,4
D12,Robbery-Other,2015,0,3,0,3
D12,Robbery-Other,2015,4,6,0,2
D12,Robbery-Other,2015,16,33,0,17
D12,Robbery-Other,2015,6,13,0,7
D12,Robbery-Other,2015,19,36,0,17
D12,Robbery-Other,2015,1,7,0,6
D12,Sexual Violation,2015,2,8,0,6
D12,Sexual Violation,2015,3,6,0,3
D12,Other,2015,55,56,0,1
D11,Assault,2015,3,3,1,0
D12,Break & Enter-Other,2015,1,4,0,3
D13,Break & Enter-Commercial,2015,2,7,0,5
D12,Sexual Violation,2015,2,5,0,3
D11,Other,2015,1,2,0,1
D12,Other,2015,1,1,1,0
D13,Break & Enter-Commercial,2015,6,9,0,3
D12,Sexual Violation,2015,0,1,0,1
D12,Break & Enter-Other,2015,1,4,0,3
D11,Assault,2015,77,102,0,25
D12,Other,2015,7,8,0,1
D12,Other,2015,2,2,1,0
D12,Sexual Violation,2015,6,13,0,7
D11,Other,2015,7,7,1,0
D13,Break & Enter-House,2015,3,14,0,11
D12,Other,2015,11,15,0,4
D12,Other,2015,1,1,1,0
D12,Sexual Violation,2015,19,26,0,7
D11,Assault,2015,23,37,0,14
D11,Other,2015,7,7,1,0
D13,Break & Enter-House,2015,2,7,0,5
D12,Other,2015,71,72,0,1
D12,Other,2015,3,3,1,0
D12,Sexual Violation,2015,1,6,0,5
D11,Assault,2015,6,14,0,8
D11,Other,2015,18,18,1,0
D13,Break & Enter-House,2015,4,8,0,4
D12,Other,2015,22,22,1,0
D12,Other,2015,73,77,0,4
D12,Other,2015,9,10,0,1
D12,Auto Theft,2015,1,8,0,7
D12,Auto Theft,2015,6,43,0,37
D12,Auto Theft,2015,4,11,0,7
D12,Auto Theft,2015,2,16,0,14
D12,Auto Theft,2015,4,18,0,14
D12,Auto Theft,2015,4,14,0,10
D12,Auto Theft,2015,1,2,0,1
D12,Auto Theft,2015,3,22,0,19
D12,Auto Theft,2015,4,42,0,38
D12,Auto Theft,2015,1,19,0,18
D12,Auto Theft,2015,4,39,0,35
D12,Auto Theft,2015,0,8,0,8
D12,Break & Enter-Apartment,2015,2,6,0,4
D12,Break & Enter-Apartment,2015,2,15,0,13
D12,Break & Enter-Apartment,2015,2,7,0,5
D12,Break & Enter-Apartment,2015,3,5,0,2
D12,Break & Enter-Apartment,2015,4,13,0,9
D12,Break & Enter-Apartment,2015,2,9,0,7
D12,Break & Enter-Apartment,2015,2,7,0,5
D12,Break & Enter-Apartment,2015,0,1,0,1
D12,Break & Enter-Apartment,2015,14,24,0,10
D12,Break & Enter-Apartment,2015,2,4,0,2
D12,Break & Enter-Commercial,2015,0,2,0,2
D12,Break & Enter-Commercial,2015,3,12,0,9
D12,Break & Enter-Commercial,2015,2,3,0,1
D12,Break & Enter-Commercial,2015,0,6,0,6
D12,Break & Enter-Commercial,2015,0,1,0,1
D12,Break & Enter-Commercial,2015,2,4,0,2
D12,Break & Enter-Commercial,2015,1,1,1,0
D12,Break & Enter-Commercial,2015,4,4,1,0
D12,Break & Enter-Commercial,2015,4,7,0,3
D12,Break & Enter-Commercial,2015,1,1,1,0
D12,Break & Enter-Commercial,2015,7,13,0,6
D12,Break & Enter-House,2015,0,3,0,3
D12,Break & Enter-House,2015,7,13,0,6
D12,Break & Enter-House,2015,0,4,0,4
D12,Break & Enter-House,2015,1,7,0,6
D12,Break & Enter-House,2015,4,7,0,3
D12,Break & Enter-House,2015,0,4,0,4
D12,Break & Enter-House,2015,4,6,0,2
D12,Break & Enter-House,2015,2,15,0,13
D12,Break & Enter-Other,2015,1,6,0,5
D12,Break & Enter-House,2015,1,8,0,7
D12,Break & Enter-House,2015,5,12,0,7
D12,Sexual Violation,2015,18,29,0,11
D12,Break & Enter-Other,2015,0,1,0,1
D12,Other,2015,1,1,1,0
D11,Assault,2015,40,50,0,10
D11,Other,2015,15,15,1,0
D12,Other,2015,1,1,1,0
D12,Sexual Violation,2015,2,4,0,2
D12,Break & Enter-Other,2015,1,5,0,4
D11,Other,2015,5,6,0,1
D13,Break & Enter-House,2015,2,11,0,9
D12,Other,2015,11,12,0,1
D12,Fraud,2015,7,24,0,17
D13,Other,2015,30,30,1,0
D11,Attempt Murder,2015,1,1,1,0
D11,Other,2015,2,2,1,0
D13,Break & Enter-House,2015,4,16,0,12
D12,Other,2015,7,8,0,1
D12,Fraud,2015,10,45,0,35
D13,Other,2015,18,18,1,0
D11,Attempt Murder,2015,0,1,0,1
D11,Other,2015,1,1,1,0
D13,Break & Enter-House,2015,5,19,0,14
D12,Other,2015,6,6,1,0
D12,Fraud,2015,2,17,0,15
D13,Other,2015,5,5,1,0
D11,Attempt Murder,2015,1,1,1,0
D11,Other,2015,14,14,1,0
D13,Break & Enter-House,2015,0,4,0,4
D12,Other,2015,9,9,1,0
D12,Fraud,2015,4,22,0,18
D13,Other,2015,23,23,1,0
D11,Other,2015,4,9,0,5
D11,Other,2015,6,6,1,0
D13,Break & Enter-House,2015,1,20,0,19
D12,Other,2015,1,1,1,0
D12,Fraud,2015,3,19,0,16
D13,Other,2015,3,3,1,0
D11,Other,2015,13,28,0,15
D11,Other,2015,10,10,1,0
D13,Break & Enter-House,2015,1,3,0,2
D12,Other,2015,12,12,1,0
D12,Fraud,2015,5,25,0,20
D13,Other,2015,1,1,1,0
D11,Other,2015,13,22,0,9
D11,Other,2015,3,3,1,0
D13,Break & Enter-House,2015,6,12,0,6
D12,Other,2015,3,3,1,0
D12,Fraud,2015,1,3,0,2
D13,Other,2015,7,7,1,0
D11,Other,2015,26,36,0,10
D11,Other,2015,16,32,0,16
D11,Other,2015,6,10,0,4
D11,Other,2015,5,9,0,4
D11,Other,2015,1,1,1,0
D11,Other,2015,1,1,1,0
D11,Other,2015,16,27,0,11
D11,Other,2015,12,15,0,3
D11,Other,2015,2,3,0,1
D11,Other,2015,15,23,0,8
D11,Robbery-Financial,2015,1,1,1,0
D11,Robbery-Financial,2015,2,2,1,0
D11,Robbery-Financial,2015,1,1,1,0
D11,Robbery-Financial,2015,3,3,1,0
D11,Robbery-Other,2015,0,1,0,1
D11,Robbery-Other,2015,7,15,0,8
D11,Robbery-Other,2015,6,17,0,11
D11,Robbery-Other,2015,16,36,0,20
D11,Robbery-Other,2015,3,10,0,7
D11,Robbery-Other,2015,13,20,0,7
D11,Robbery-Other,2015,1,8,0,7
D11,Robbery-Other,2015,3,5,0,2
D11,Robbery-Other,2015,1,2,0,1
D11,Robbery-Other,2015,7,18,0,11
D11,Robbery-Other,2015,7,14,0,7
D11,Robbery-Other,2015,5,6,0,1
D11,Robbery-Other,2015,1,1,1,0
D11,Robbery-Other,2015,1,5,0,4
D11,Sexual Violation,2015,6,12,0,6
D11,Sexual Violation,2015,4,9,0,5
D11,Sexual Violation,2015,13,20,0,7
D11,Sexual Violation,2015,9,9,1,0
D11,Sexual Violation,2015,8,10,0,2
D11,Sexual Violation,2015,2,2,1,0
D11,Sexual Violation,2015,3,9,0,6
D11,Sexual Violation,2015,2,3,0,1
D11,Sexual Violation,2015,8,9,0,1
D11,Sexual Violation,2015,2,4,0,2
D11,Sexual Violation,2015,1,1,1,0
D12,Other,2015,2,3,0,1
D11,Other,2015,1,1,1,0
D13,Other,2015,7,7,1,0
D13,Break & Enter-House,2015,3,8,0,5
D12,Fraud,2015,9,16,0,7
D12,Other,2015,13,13,1,0
D11,Other,2015,66,72,0,6
D11,Other,2015,52,60,0,8
D11,Other,2015,38,39,0,1
D11,Other,2015,77,80,0,3
D11,Other,2015,88,94,0,6
D11,Other,2015,6,8,0,2
D11,Other,2015,14,16,0,2
D11,Other,2015,3,3,1,0
D11,Other,2015,6,6,1,0
D11,Other,2015,90,93,0,3
D11,Other,2015,28,30,0,2
D11,Other,2015,18,19,0,1
D11,Other,2015,67,69,0,2
D11,Other,2015,2,2,1,0
D11,Other Criminal Violations - Offensive Weapons,2015,3,3,1,0
D11,Other Criminal Violations - Offensive Weapons,2015,9,9,1,0
D11,Other Criminal Violations - Offensive Weapons,2015,5,5,1,0
D11,Other Criminal Violations - Offensive Weapons,2015,9,9,1,0
D11,Other Criminal Violations - Offensive Weapons,2015,11,12,0,1
D11,Other Criminal Violations - Offensive Weapons,2015,3,3,1,0
D11,Other Criminal Violations - Offensive Weapons,2015,3,3,1,0
D11,Other Criminal Violations - Offensive Weapons,2015,5,5,1,0
D11,Other Criminal Violations - Offensive Weapons,2015,1,1,1,0
D11,Other Criminal Violations - Offensive Weapons,2015,6,7,0,1
D11,Other,2015,2,2,1,0
D11,Other,2015,2,2,1,0
D11,Other,2015,2,2,1,0
D11,Other,2015,2,2,1,0
D11,Other,2015,0,1,0,1
D11,Other,2015,2,2,1,0
D11,Other,2015,1,1,1,0
D12,Other,2015,29,30,0,1
D12,Other,2015,26,28,0,2
D12,Other,2015,7,7,1,0
D12,Other,2015,40,40,1,0
D12,Other,2015,10,11,0,1
D13,Other,2015,4,4,1,0
D13,Break & Enter-House,2015,6,11,0,5
D12,Fraud,2015,5,24,0,19
D12,Other,2015,6,6,1,0
D12,Other,2015,9,9,1,0
D13,Other,2015,47,49,0,2
D12,Other,2015,5,5,1,0
D12,Fraud,2015,4,16,0,12
D13,Other,2015,2,2,1,0
D12,Other,2015,32,34,0,2
D13,Break & Enter-Other,2015,1,1,1,0
D13,Other,2015,12,13,0,1
D12,Other,2015,49,52,0,3
D12,Fraud,2015,26,87,0,61
D13,Break & Enter-Other,2015,0,1,0,1
D13,Other,2015,18,18,1,0
D12,Other,2015,29,29,1,0
D12,Fraud,2015,1,10,0,9
D13,Break & Enter-Other,2015,0,1,0,1
D13,Auto Theft,2015,2,19,0,17
D12,Other,2015,11,12,0,1
D12,Other,2015,15,34,0,19
D13,Break & Enter-Other,2015,2,3,0,1
D13,Auto Theft,2015,0,5,0,5
D12,Other,2015,25,25,1,0
D12,Other,2015,30,67,0,37
D13,Break & Enter-Other,2015,0,1,0,1
D13,Auto Theft,2015,0,3,0,3
D12,Other,2015,24,25,0,1
D12,Other,2015,4,11,0,7
D13,Break & Enter-Other,2015,2,3,0,1
D13,Auto Theft,2015,1,10,0,9
D12,Other,2015,54,57,0,3
D12,Other,2015,21,55,0,34
D13,Break & Enter-Other,2015,2,3,0,1
D13,Auto Theft,2015,1,6,0,5
D12,Other,2015,12,13,0,1
D12,Other,2015,7,21,0,14
D13,Break & Enter-Other,2015,3,5,0,2
D13,Auto Theft,2015,1,6,0,5
D12,Other,2015,26,27,0,1
D12,Other,2015,27,66,0,39
D13,Fraud,2015,17,30,0,13
D13,Auto Theft,2015,1,10,0,9
D12,Other,2015,66,73,0,7
D12,Other,2015,2,4,0,2
D13,Fraud,2015,5,19,0,14
D13,Auto Theft,2015,0,7,0,7
D12,Other,2015,62,65,0,3
D12,Other,2015,2,10,0,8
D13,Fraud,2015,4,7,0,3
D13,Auto Theft,2015,1,4,0,3
D12,Other,2015,86,94,0,8
D12,Other,2015,44,94,0,50
D13,Fraud,2015,11,26,0,15
D12,Other,2015,11,29,0,18
D13,Auto Theft,2015,2,13,0,11
D12,Other,2015,19,22,0,3
D13,Fraud,2015,8,16,0,8
D12,Other,2015,32,85,0,53
D13,Auto Theft,2015,3,19,0,16
D12,Other,2015,1,1,1,0
D13,Fraud,2015,7,14,0,7
D12,Other,2015,5,20,0,15
D13,Auto Theft,2015,10,29,0,19
D12,Other,2015,1,1,1,0
D13,Fraud,2015,9,15,0,6
D12,Theft Over $5000,2015,3,5,0,2
D13,Break & Enter-Apartment,2015,2,4,0,2
D12,Other Criminal Violations - Offensive Weapons,2015,5,5,1,0
D13,Fraud,2015,10,27,0,17
D12,Theft Over $5000,2015,3,8,0,5
D13,Break & Enter-Apartment,2015,3,9,0,6
D12,Other Criminal Violations - Offensive Weapons,2015,13,13,1,0
D13,Fraud,2015,4,9,0,5
D12,Theft Over $5000,2015,2,2,1,0
D13,Break & Enter-Apartment,2015,1,4,0,3
D12,Other Criminal Violations - Offensive Weapons,2015,6,6,1,0
D13,Fraud,2015,4,4,1,0
D12,Theft Over $5000,2015,0,2,0,2
D13,Break & Enter-Apartment,2015,0,6,0,6
D12,Other Criminal Violations - Offensive Weapons,2015,7,7,1,0
D13,Fraud,2015,20,36,0,16
D12,Theft Over $5000,2015,1,4,0,3
D13,Break & Enter-Apartment,2015,1,1,1,0
D12,Other Criminal Violations - Offensive Weapons,2015,1,1,1,0
D13,Fraud,2015,25,42,0,17
D12,Theft Over $5000,2015,0,1,0,1
D13,Break & Enter-Apartment,2015,0,1,0,1
D12,Other Criminal Violations - Offensive Weapons,2015,9,9,1,0
D13,Fraud,2015,14,24,0,10
D12,Theft Over $5000,2015,0,1,0,1
D13,Break & Enter-Apartment,2015,1,7,0,6
D12,Other Criminal Violations - Offensive Weapons,2015,1,1,1,0
D13,Other,2015,18,52,0,34
D13,Break & Enter-Apartment,2015,2,12,0,10
D12,Theft Over $5000,2015,0,3,0,3
D12,Other Criminal Violations - Offensive Weapons,2015,1,2,0,1
D13,Other,2015,22,43,0,21
D13,Break & Enter-Apartment,2015,0,11,0,11
D12,Theft Over $5000,2015,0,3,0,3
D12,Other Criminal Violations - Offensive Weapons,2015,12,12,1,0
D13,Other,2015,6,24,0,18
D13,Break & Enter-Apartment,2015,2,11,0,9
D12,Theft Over $5000,2015,0,1,0,1
D12,Other Criminal Violations - Offensive Weapons,2015,8,8,1,0
D13,Other,2015,21,65,0,44
D13,Break & Enter-Commercial,2015,4,10,0,6
D12,Theft Over $5000,2015,0,1,0,1
D12,Other Criminal Violations - Offensive Weapons,2015,14,15,0,1
D13,Other,2015,14,21,0,7
D13,Break & Enter-Commercial,2015,3,3,1,0
D12,Theft Over $5000,2015,1,3,0,2
D12,Other Criminal Violations - Offensive Weapons,2015,2,2,1,0
D13,Other,2015,8,12,0,4
D13,Break & Enter-Commercial,2015,2,2,1,0
D12,Theft Over $5000,2015,4,4,1,0
D12,Other,2015,6,6,1,0
D13,Other,2015,4,9,0,5
D13,Break & Enter-Commercial,2015,2,5,0,3
D12,Theft Under $5000,2015,20,64,0,44
D12,Other,2015,6,6,1,0
D13,Other,2015,21,41,0,20
D13,Break & Enter-Commercial,2015,2,9,0,7
D12,Theft Under $5000,2015,231,342,0,111
D12,Other,2015,1,1,1,0
D13,Other,2015,6,16,0,10
D13,Break & Enter-Commercial,2015,0,1,0,1
D12,Theft Under $5000,2015,16,47,0,31
D13,Other,2015,4,8,0,4
D13,Break & Enter-Commercial,2015,2,4,0,2
D12,Theft Under $5000,2015,25,72,0,47
D13,Other,2015,35,82,0,47
D13,Break & Enter-Commercial,2015,1,1,1,0
D12,Theft Under $5000,2015,9,35,0,26
D13,Other,2015,1,1,1,0
D12,Theft Under $5000,2015,32,84,0,52
D12,Theft Under $5000,2015,2,8,0,6
D13,Other,2015,26,55,0,29
D13,Other,2015,17,41,0,24
D14,Auto Theft,2015,3,17,0,14
D14,Auto Theft,2015,6,9,0,3
D14,Auto Theft,2015,5,21,0,16
D14,Auto Theft,2015,4,14,0,10
D14,Auto Theft,2015,0,1,0,1
D14,Auto Theft,2015,5,19,0,14
D14,Auto Theft,2015,7,18,0,11
D14,Auto Theft,2015,2,19,0,17
D14,Auto Theft,2015,0,8,0,8
D14,Auto Theft,2015,2,12,0,10
D14,Auto Theft,2015,5,9,0,4
D14,Break & Enter-Apartment,2015,9,15,0,6
D14,Break & Enter-Apartment,2015,3,4,0,1
D14,Break & Enter-Apartment,2015,2,11,0,9
D14,Break & Enter-Apartment,2015,8,18,0,10
D14,Break & Enter-Apartment,2015,6,27,0,21
D14,Break & Enter-Apartment,2015,13,18,0,5
D14,Break & Enter-Apartment,2015,4,7,0,3
D14,Break & Enter-Apartment,2015,1,1,1,0
D14,Break & Enter-Apartment,2015,8,16,0,8
D14,Break & Enter-Apartment,2015,15,26,0,11
D14,Break & Enter-Apartment,2015,1,14,0,13
D14,Break & Enter-Apartment,2015,6,11,0,5
D14,Break & Enter-Apartment,2015,3,6,0,3
D14,Break & Enter-Apartment,2015,9,13,0,4
D14,Break & Enter-Commercial,2015,5,14,0,9
D14,Break & Enter-Commercial,2015,2,5,0,3
D14,Break & Enter-Commercial,2015,0,1,0,1
D14,Break & Enter-Commercial,2015,5,12,0,7
D14,Break & Enter-Commercial,2015,3,8,0,5
D14,Break & Enter-Commercial,2015,6,17,0,11
D14,Break & Enter-Commercial,2015,4,14,0,10
D14,Break & Enter-Commercial,2015,1,1,1,0
D14,Break & Enter-Commercial,2015,5,13,0,8
D14,Break & Enter-Commercial,2015,11,16,0,5
D14,Break & Enter-Commercial,2015,6,15,0,9
D14,Break & Enter-Commercial,2015,9,13,0,4
D14,Break & Enter-House,2015,0,1,0,1
D13,Theft Over $5000,2015,1,2,0,1
D14,Break & Enter-Commercial,2015,10,20,0,10
D14,Break & Enter-Commercial,2015,7,13,0,6
D14,Break & Enter-House,2015,2,15,0,13
D14,Break & Enter-House,2015,5,10,0,5
D14,Break & Enter-House,2015,1,6,0,5
D14,Break & Enter-House,2015,0,1,0,1
D14,Break & Enter-House,2015,1,3,0,2
D14,Break & Enter-House,2015,2,2,1,0
D14,Break & Enter-House,2015,7,13,0,6
D14,Break & Enter-House,2015,2,3,0,1
D14,Break & Enter-House,2015,11,23,0,12
D14,Break & Enter-House,2015,9,18,0,9
D14,Break & Enter-House,2015,0,2,0,2
D14,Other,2015,16,21,0,5
D14,Other,2015,32,35,0,3
D14,Theft Over $5000,2015,0,3,0,3
D14,Break & Enter-Other,2015,2,2,1,0
D13,Theft Over $5000,2015,0,1,0,1
D13,Other,2015,21,22,0,1
D14,Theft Over $5000,2015,0,6,0,6
D14,Break & Enter-Other,2015,1,2,0,1
D14,Other,2015,21,22,0,1
D13,Theft Over $5000,2015,1,3,0,2
D13,Other,2015,20,25,0,5
D14,Theft Over $5000,2015,1,4,0,3
D14,Break & Enter-Other,2015,4,7,0,3
D14,Other,2015,33,38,0,5
D14,Other,2015,14,21,0,7
D13,Theft Over $5000,2015,0,4,0,4
D13,Other,2015,8,8,1,0
D14,Theft Over $5000,2015,1,5,0,4
D14,Break & Enter-Other,2015,0,1,0,1
D14,Other,2015,27,28,0,1
D14,Other,2015,14,17,0,3
D13,Theft Over $5000,2015,1,2,0,1
D13,Other,2015,5,5,1,0
D14,Theft Over $5000,2015,2,4,0,2
D14,Break & Enter-Other,2015,1,2,0,1
D14,Other,2015,121,126,0,5
D14,Other,2015,18,30,0,12
D13,Theft Over $5000,2015,2,4,0,2
D13,Other,2015,5,5,1,0
D14,Theft Under $5000,2015,74,257,0,183
D14,Break & Enter-Other,2015,1,3,0,2
D14,Other,2015,40,43,0,3
D14,Robbery-Financial,2015,2,2,1,0
D13,Theft Over $5000,2015,1,5,0,4
D13,Other,2015,18,18,1,0
D13,Other,2015,9,9,1,0
D13,Other,2015,4,5,0,1
D13,Other,2015,75,88,0,13
D13,Other,2015,1,1,1,0
D13,Other,2015,39,41,0,2
D13,Other,2015,1,1,1,0
D13,Other,2015,27,28,0,1
D13,Other Criminal Violations - Offensive Weapons,2015,7,7,1,0
D13,Other Criminal Violations - Offensive Weapons,2015,5,5,1,0
D13,Other Criminal Violations - Offensive Weapons,2015,1,1,1,0
D13,Other Criminal Violations - Offensive Weapons,2015,6,6,1,0
D13,Other Criminal Violations - Offensive Weapons,2015,1,1,1,0
D13,Other Criminal Violations - Offensive Weapons,2015,1,1,1,0
D13,Other Criminal Violations - Offensive Weapons,2015,2,2,1,0
D13,Other Criminal Violations - Offensive Weapons,2015,5,5,1,0
D13,Other Criminal Violations - Offensive Weapons,2015,7,7,1,0
D13,Other Criminal Violations - Offensive Weapons,2015,4,4,1,0
D13,Other Criminal Violations - Offensive Weapons,2015,3,3,1,0
D13,Other,2015,6,6,1,0
D13,Other,2015,3,3,1,0
D13,Other,2015,4,4,1,0
D13,Other,2015,1,1,1,0
D13,Other,2015,3,3,1,0
D13,Other,2015,1,1,1,0
D13,Other,2015,2,2,1,0
D13,Other,2015,8,8,1,0
D13,Other,2015,1,1,1,0
D14,Other,2015,13,16,0,3
D14,Other,2015,15,15,1,0
D14,Other,2015,7,7,1,0
D14,Other,2015,25,26,0,1
D14,Other,2015,13,14,0,1
D14,Other,2015,137,137,1,0
D14,Other,2015,13,15,0,2
D14,Other,2015,4,5,0,1
D14,Other,2015,23,24,0,1
D14,Other,2015,56,56,1,0
D14,Other,2015,38,41,0,3
D14,Other,2015,30,30,1,0
D14,Other,2015,51,51,1,0
D14,Other,2015,43,44,0,1
D14,Auto Theft,2015,0,8,0,8
D14,Auto Theft,2015,4,12,0,8
D14,Auto Theft,2015,0,3,0,3
D14,Robbery-Financial,2015,2,2,1,0
D13,Other,2015,7,16,0,9
D14,Break & Enter-Other,2015,1,2,0,1
D13,Theft Over $5000,2015,1,3,0,2
D14,Other,2015,7,7,1,0
D14,Break & Enter-Other,2015,1,1,1,0
D14,Robbery-Financial,2015,1,1,1,0
D13,Other,2015,3,4,0,1
D14,Robbery-Other,2015,6,14,0,8
D14,Theft Under $5000,2015,12,141,0,129
D13,Theft Over $5000,2015,1,1,1,0
D14,Other,2015,27,29,0,2
D14,Break & Enter-Other,2015,2,3,0,1
D14,Robbery-Other,2015,3,16,0,13
D14,Theft Under $5000,2015,3,35,0,32
D13,Theft Over $5000,2015,0,3,0,3
D14,Other,2015,124,131,0,7
D14,Break & Enter-Other,2015,0,4,0,4
D14,Robbery-Other,2015,7,17,0,10
D13,Other,2015,3,3,1,0
D14,Theft Under $5000,2015,0,1,0,1
D13,Theft Over $5000,2015,1,1,1,0
D14,Other,2015,72,77,0,5
D14,Break & Enter-Other,2015,1,2,0,1
D14,Robbery-Other,2015,2,5,0,3
D13,Other,2015,21,31,0,10
D14,Theft Under $5000,2015,47,250,0,203
D13,Theft Over $5000,2015,0,3,0,3
D14,Other,2015,44,45,0,1
D14,Break & Enter-Other,2015,0,2,0,2
D14,Robbery-Other,2015,0,1,0,1
D13,Other,2015,11,18,0,7
D14,Theft Under $5000,2015,23,97,0,74
D13,Theft Under $5000,2015,0,1,0,1
D14,Other,2015,58,62,0,4
D14,Fraud,2015,12,44,0,32
D14,Robbery-Other,2015,15,27,0,12
D13,Other,2015,1,1,1,0
D14,Theft Under $5000,2015,52,303,0,251
D13,Theft Under $5000,2015,55,135,0,80
D14,Other,2015,100,104,0,4
D14,Fraud,2015,5,27,0,22
D14,Robbery-Other,2015,1,1,1,0
D13,Other,2015,10,16,0,6
D14,Theft Under $5000,2015,35,114,0,79
D13,Theft Under $5000,2015,13,43,0,30
D14,Other,2015,7,7,1,0
D14,Other Criminal Violations - Offensive Weapons,2015,1,1,1,0
D14,Other Criminal Violations - Offensive Weapons,2015,3,3,1,0
D14,Other Criminal Violations - Offensive Weapons,2015,3,3,1,0
D14,Other Criminal Violations - Offensive Weapons,2015,0,1,0,1
D14,Other Criminal Violations - Offensive Weapons,2015,5,5,1,0
D14,Other Criminal Violations - Offensive Weapons,2015,9,9,1,0
D14,Other Criminal Violations - Offensive Weapons,2015,4,4,1,0
D14,Other Criminal Violations - Offensive Weapons,2015,1,1,1,0
D14,Other Criminal Violations - Offensive Weapons,2015,9,9,1,0
D14,Other Criminal Violations - Offensive Weapons,2015,14,14,1,0
D14,Other Criminal Violations - Offensive Weapons,2015,9,9,1,0
D14,Other Criminal Violations - Offensive Weapons,2015,4,4,1,0
D14,Other Criminal Violations - Offensive Weapons,2015,8,9,0,1
D14,Other Criminal Violations - Offensive Weapons,2015,3,3,1,0
D14,Other,2015,1,2,0,1
D14,Other,2015,1,1,1,0
D14,Other,2015,1,1,1,0
D14,Other,2015,1,1,1,0
D14,Other,2015,6,7,0,1
D14,Other,2015,1,2,0,1
D14,Other,2015,1,1,1,0
D14,Other,2015,0,1,0,1
D14,Other,2015,2,2,1,0
D14,Other,2015,2,2,1,0
D22,Other,2015,11,12,0,1
D22,Other,2015,2,2,1,0
D22,Other,2015,9,10,0,1
D22,Other,2015,28,32,0,4
D22,Other,2015,13,15,0,2
D22,Other,2015,26,26,1,0
D22,Other,2015,1,1,1,0
D22,Other,2015,17,17,1,0
D22,Other,2015,2,2,1,0
D22,Other,2015,6,6,1,0
D22,Other,2015,1,1,1,0
D22,Other,2015,33,42,0,9
D13,Theft Under $5000,2015,65,143,0,78
D14,Theft Under $5000,2015,2,12,0,10
D14,Robbery-Other,2015,2,2,1,0
D13,Theft Under $5000,2015,24,101,0,77
D13,Robbery-Financial,2015,1,1,1,0
D14,Fraud,2015,0,5,0,5
D14,Fraud,2015,22,60,0,38
D14,Robbery-Other,2015,9,17,0,8
D14,Theft Under $5000,2015,40,283,0,243
D14,Fraud,2015,13,34,0,21
D13,Robbery-Financial,2015,1,1,1,0
D13,Theft Under $5000,2015,10,37,0,27
D14,Fraud,2015,8,42,0,34
D14,Theft Under $5000,2015,106,231,0,125
D13,Robbery-Other,2015,6,10,0,4
D14,Robbery-Other,2015,14,23,0,9
D13,Theft Under $5000,2015,11,46,0,35
D14,Fraud,2015,15,39,0,24
D14,Theft Under $5000,2015,0,1,0,1
D13,Robbery-Other,2015,2,8,0,6
D14,Robbery-Other,2015,5,15,0,10
D13,Theft Under $5000,2015,10,40,0,30
D14,Fraud,2015,1,2,0,1
D14,Theft Under $5000,2015,88,335,0,247
D13,Robbery-Other,2015,1,4,0,3
D14,Robbery-Other,2015,11,13,0,2
D13,Theft Under $5000,2015,19,136,0,117
D14,Fraud,2015,4,22,0,18
D14,Theft Under $5000,2015,33,202,0,169
D13,Robbery-Other,2015,8,13,0,5
D14,Robbery-Other,2015,7,15,0,8
D13,Theft Under $5000,2015,4,16,0,12
D14,Fraud,2015,20,72,0,52
D14,Theft Under $5000,2015,48,337,0,289
D13,Robbery-Other,2015,1,3,0,2
D14,Robbery-Other,2015,6,12,0,6
D13,Theft Under $5000,2015,1,5,0,4
D14,Fraud,2015,16,60,0,44
D14,Theft Under $5000,2015,83,240,0,157
D13,Robbery-Other,2015,0,1,0,1
D14,Sexual Violation,2015,2,14,0,12
D13,Theft Under $5000,2015,40,126,0,86
D14,Fraud,2015,6,33,0,27
D14,Assault,2015,37,59,0,22
D13,Robbery-Other,2015,5,9,0,4
D14,Sexual Violation,2015,6,8,0,2
D13,Theft Under $5000,2015,0,1,0,1
D14,Fraud,2015,12,56,0,44
D14,Assault,2015,35,48,0,13
D13,Robbery-Other,2015,4,6,0,2
D14,Sexual Violation,2015,1,1,1,0
D13,Theft Under $5000,2015,34,118,0,84
D14,Fraud,2015,17,43,0,26
D14,Other,2015,13,67,0,54
D14,Other,2015,15,57,0,42
D14,Other,2015,10,32,0,22
D14,Other,2015,42,94,0,52
D14,Other,2015,11,35,0,24
D14,Other,2015,1,1,1,0
D14,Other,2015,53,123,0,70
D14,Other,2015,16,48,0,32
D14,Other,2015,5,6,0,1
D14,Other,2015,34,96,0,62
D14,Other,2015,55,124,0,69
D14,Other,2015,38,103,0,65
D14,Other,2015,27,84,0,57
D14,Other,2015,31,83,0,52
D14,Other,2015,37,83,0,46
D14,Theft Over $5000,2015,1,3,0,2
D14,Theft Over $5000,2015,0,3,0,3
D14,Theft Over $5000,2015,0,1,0,1
D14,Theft Over $5000,2015,2,14,0,12
D14,Theft Over $5000,2015,0,4,0,4
D14,Theft Over $5000,2015,1,1,1,0
D14,Theft Over $5000,2015,2,8,0,6
D14,Theft Over $5000,2015,0,1,0,1
D14,Assault,2015,21,28,0,7
D14,Sexual Violation,2015,7,11,0,4
D13,Theft Under $5000,2015,48,103,0,55
D13,Robbery-Other,2015,0,3,0,3
D14,Assault,2015,73,97,0,24
D14,Sexual Violation,2015,5,7,0,2
D13,Assault,2015,56,70,0,14
D13,Robbery-Other,2015,7,18,0,11
D14,Assault,2015,32,43,0,11
D14,Sexual Violation,2015,16,29,0,13
D13,Assault,2015,43,48,0,5
D13,Robbery-Other,2015,5,10,0,5
D14,Assault,2015,119,180,0,61
D14,Sexual Violation,2015,7,12,0,5
D13,Assault,2015,12,22,0,10
D13,Robbery-Other,2015,5,12,0,7
D14,Assault,2015,40,53,0,13
D14,Sexual Violation,2015,3,6,0,3
D13,Assault,2015,56,75,0,19
D13,Sexual Violation,2015,3,7,0,4
D14,Assault,2015,9,11,0,2
D14,Sexual Violation,2015,10,17,0,7
D13,Assault,2015,6,9,0,3
D13,Assault,2015,6,11,0,5
D13,Assault,2015,4,10,0,6
D13,Assault,2015,34,43,0,9
D13,Assault,2015,22,27,0,5
D13,Assault,2015,2,5,0,3
D13,Assault,2015,105,127,0,22
D13,Assault,2015,50,64,0,14
D13,Assault,2015,29,38,0,9
D13,Attempt Murder,2015,1,1,1,0
D13,Attempt Murder,2015,1,1,1,0
D13,Attempt Murder,2015,1,1,1,0
D13,Other,2015,9,20,0,11
D13,Other,2015,13,18,0,5
D13,Other,2015,3,9,0,6
D13,Other,2015,8,23,0,15
D13,Other,2015,7,7,1,0
D13,Other,2015,6,9,0,3
D13,Other,2015,0,1,0,1
D13,Sexual Violation,2015,0,2,0,2
D14,Sexual Violation,2015,12,24,0,12
D13,Sexual Violation,2015,0,1,0,1
D14,Assault,2015,42,70,0,28
D14,Sexual Violation,2015,7,9,0,2
D13,Sexual Violation,2015,5,6,0,1
D14,Assault,2015,136,185,0,49
D14,Sexual Violation,2015,5,8,0,3
D13,Sexual Violation,2015,0,2,0,2
D14,Assault,2015,1,1,1,0
D14,Sexual Violation,2015,8,15,0,7
D13,Sexual Violation,2015,7,9,0,2
D14,Assault,2015,72,99,0,27
D14,Sexual Violation,2015,4,8,0,4
D13,Sexual Violation,2015,3,5,0,2
D14,Assault,2015,46,93,0,47
D14,Other,2015,5,5,1,0
D13,Sexual Violation,2015,5,10,0,5
D14,Assault,2015,102,178,0,76
D14,Other,2015,3,3,1,0
D13,Sexual Violation,2015,1,2,0,1
D14,Assault,2015,87,124,0,37
D14,Other,2015,0,1,0,1
D13,Sexual Violation,2015,2,2,1,0
D14,Attempt Murder,2015,0,2,0,2
D14,Other,2015,26,26,1,0
D13,Sexual Violation,2015,5,10,0,5
D13,Sexual Violation,2015,9,14,0,5
D13,Sexual Violation,2015,1,5,0,4
D13,Other,2015,1,1,1,0
D13,Other,2015,10,10,1,0
D13,Other,2015,7,7,1,0
D13,Other,2015,3,3,1,0
D13,Other,2015,16,16,1,0
D13,Other,2015,2,2,1,0
D13,Other,2015,1,1,1,0
D13,Other,2015,5,5,1,0
D13,Other,2015,9,9,1,0
D13,Other,2015,9,9,1,0
D13,Other,2015,1,1,1,0
D13,Other,2015,24,24,1,0
D13,Other,2015,11,11,1,0
D13,Other,2015,12,12,1,0
D13,Other,2015,30,34,0,4
D13,Other,2015,44,44,1,0
D14,Other,2015,8,8,1,0
D14,Other,2015,10,11,0,1
D14,Other,2015,4,4,1,0
D14,Other,2015,1,1,1,0
D14,Other,2015,6,6,1,0
D14,Other,2015,25,25,1,0
D14,Other,2015,5,5,1,0
D14,Other,2015,11,11,1,0
D14,Attempt Murder,2015,1,1,1,0
D14,Other,2015,14,14,1,0
D14,Other,2015,7,7,1,0
D14,Attempt Murder,2015,1,2,0,1
D14,Other,2015,27,35,0,8
D14,Attempt Murder,2015,3,3,1,0
D14,Other,2015,12,22,0,10
D14,Other,2015,9,12,0,3
D14,Other,2015,3,6,0,3
D14,Other,2015,10,29,0,19
D14,Other,2015,5,17,0,12
D14,Other,2015,15,26,0,11
D14,Other,2015,15,21,0,6
D14,Other,2015,1,1,1,0
D14,Other,2015,9,17,0,8
D14,Other,2015,40,54,0,14
D22,Other,2015,13,54,0,41
D23,Theft Under $5000,2015,20,73,0,53
D22,Other,2015,9,41,0,32
D22,Other,2015,27,119,0,92
D23,Theft Under $5000,2015,0,1,0,1
D23,Break & Enter-Commercial,2015,0,1,0,1
D22,Other,2015,7,8,0,1
D22,Assault,2015,74,113,0,39
D22,Break & Enter-House,2015,0,6,0,6
D22,Other,2015,0,1,0,1
D23,Break & Enter-Commercial,2015,0,7,0,7
D22,Break & Enter-House,2015,1,4,0,3
D22,Sexual Violation,2015,7,8,0,1
D22,Other,2015,14,15,0,1
D22,Assault,2015,6,7,0,1
D22,Other Criminal Violations - Offensive Weapons,2015,9,11,0,2
D23,Theft Under $5000,2015,34,157,0,123
D22,Sexual Violation,2015,13,21,0,8
D23,Break & Enter-Commercial,2015,3,11,0,8
D22,Other,2015,0,1,0,1
D22,Break & Enter-House,2015,0,1,0,1
D22,Other,2015,7,8,0,1
D23,Theft Under $5000,2015,78,220,0,142
D22,Other Criminal Violations - Offensive Weapons,2015,4,5,0,1
D22,Assault,2015,64,92,0,28
D22,Sexual Violation,2015,4,4,1,0
D23,Break & Enter-Commercial,2015,18,84,0,66
D22,Theft Over $5000,2015,1,3,0,2
D22,Break & Enter-House,2015,4,26,0,22
D22,Other,2015,19,20,0,1
D23,Theft Under $5000,2015,0,1,0,1
D22,Other Criminal Violations - Offensive Weapons,2015,6,7,0,1
D22,Assault,2015,11,13,0,2
D22,Assault,2015,53,66,0,13
D22,Attempt Murder,2015,1,1,1,0
D22,Attempt Murder,2015,2,2,1,0
D22,Attempt Murder,2015,1,1,1,0
D22,Attempt Murder,2015,1,1,1,0
D22,Attempt Murder,2015,1,1,1,0
D22,Other,2015,12,25,0,13
D22,Other,2015,2,2,1,0
D22,Other,2015,10,14,0,4
D22,Other,2015,8,16,0,8
D22,Other,2015,25,54,0,29
D22,Other,2015,15,23,0,8
D22,Other,2015,13,27,0,14
D22,Other,2015,20,39,0,19
D22,Other,2015,5,11,0,6
D22,Other,2015,9,20,0,11
D22,Other,2015,8,10,0,2
D22,Other,2015,17,37,0,20
D22,Other,2015,1,1,1,0
D22,Other,2015,13,31,0,18
D22,Other,2015,5,14,0,9
D22,Other,2015,24,44,0,20
D22,Robbery-Financial,2015,1,1,1,0
D22,Robbery-Financial,2015,3,3,1,0
D22,Robbery-Financial,2015,2,2,1,0
D22,Robbery-Financial,2015,1,2,0,1
D22,Robbery-Financial,2015,1,1,1,0
D22,Robbery-Financial,2015,1,1,1,0
D22,Robbery-Financial,2015,1,1,1,0
D22,Robbery-Other,2015,2,6,0,4
D22,Robbery-Other,2015,1,1,1,0
D22,Robbery-Other,2015,1,5,0,4
D22,Robbery-Other,2015,8,14,0,6
D22,Robbery-Other,2015,12,19,0,7
D22,Robbery-Other,2015,1,4,0,3
D22,Robbery-Other,2015,2,6,0,4
D22,Robbery-Other,2015,1,9,0,8
D22,Robbery-Other,2015,5,13,0,8
D22,Robbery-Other,2015,6,13,0,7
D22,Robbery-Other,2015,1,1,1,0
D22,Robbery-Other,2015,5,10,0,5
D22,Robbery-Other,2015,7,18,0,11
D22,Robbery-Other,2015,0,1,0,1
D22,Robbery-Other,2015,0,1,0,1
D22,Robbery-Other,2015,6,14,0,8
D22,Sexual Violation,2015,1,2,0,1
D22,Break & Enter-House,2015,3,21,0,18
D23,Break & Enter-Commercial,2015,0,3,0,3
D22,Break & Enter-House,2015,5,18,0,13
D22,Theft Over $5000,2015,1,4,0,3
D23,Theft Under $5000,2015,0,1,0,1
D22,Other Criminal Violations - Offensive Weapons,2015,5,6,0,1
D22,Sexual Violation,2015,5,7,0,2
D23,Theft Under $5000,2015,7,60,0,53
D22,Other,2015,2,2,1,0
D22,Break & Enter-House,2015,1,14,0,13
D22,Theft Over $5000,2015,0,4,0,4
D22,Other Criminal Violations - Offensive Weapons,2015,2,2,1,0
D22,Sexual Violation,2015,6,9,0,3
D23,Break & Enter-House,2015,0,4,0,4
D23,Theft Under $5000,2015,15,94,0,79
D22,Auto Theft,2015,6,18,0,12
D22,Break & Enter-House,2015,3,15,0,12
D22,Theft Over $5000,2015,14,39,0,25
D22,Other Criminal Violations - Offensive Weapons,2015,4,4,1,0
D22,Sexual Violation,2015,0,1,0,1
D23,Break & Enter-House,2015,3,14,0,11
D23,Theft Under $5000,2015,133,677,0,544
D22,Auto Theft,2015,0,1,0,1
D22,Break & Enter-House,2015,3,10,0,7
D22,Theft Over $5000,2015,1,3,0,2
D22,Other Criminal Violations - Offensive Weapons,2015,3,3,1,0
D22,Sexual Violation,2015,1,1,1,0
D23,Break & Enter-House,2015,1,13,0,12
D23,Theft Under $5000,2015,30,128,0,98
D22,Auto Theft,2015,3,25,0,22
D22,Break & Enter-House,2015,5,22,0,17
D22,Theft Over $5000,2015,0,6,0,6
D22,Other Criminal Violations - Offensive Weapons,2015,10,12,0,2
D22,Sexual Violation,2015,4,5,0,1
D23,Break & Enter-House,2015,7,13,0,6
D23,Assault,2015,4,6,0,2
D22,Auto Theft,2015,2,25,0,23
D22,Break & Enter-House,2015,4,21,0,17
D22,Theft Over $5000,2015,1,6,0,5
D22,Other Criminal Violations - Offensive Weapons,2015,8,8,1,0
D22,Sexual Violation,2015,1,1,1,0
D23,Break & Enter-House,2015,0,3,0,3
D23,Assault,2015,31,46,0,15
D22,Auto Theft,2015,8,80,0,72
D22,Break & Enter-Other,2015,1,3,0,2
D22,Theft Over $5000,2015,3,3,1,0
D22,Other Criminal Violations - Offensive Weapons,2015,2,2,1,0
D22,Other Criminal Violations - Offensive Weapons,2015,6,7,0,1
D22,Other,2015,9,9,1,0
D22,Other,2015,1,1,1,0
D22,Other,2015,1,1,1,0
D22,Other,2015,2,2,1,0
D22,Other,2015,2,2,1,0
D22,Other,2015,3,4,0,1
D23,Other,2015,4,4,1,0
D23,Other,2015,9,9,1,0
D23,Other,2015,1,1,1,0
D23,Other,2015,3,3,1,0
D23,Other,2015,31,31,1,0
D23,Other,2015,39,41,0,2
D23,Other,2015,7,7,1,0
D23,Other,2015,1,1,1,0
D23,Other,2015,11,11,1,0
D23,Other,2015,13,13,1,0
D23,Other,2015,47,50,0,3
D23,Other,2015,19,20,0,1
D23,Auto Theft,2015,3,23,0,20
D23,Auto Theft,2015,1,26,0,25
D23,Auto Theft,2015,1,53,0,52
D23,Auto Theft,2015,4,62,0,58
D23,Auto Theft,2015,0,3,0,3
D23,Auto Theft,2015,1,11,0,10
D23,Auto Theft,2015,0,14,0,14
D23,Auto Theft,2015,10,273,0,263
D23,Auto Theft,2015,0,37,0,37
D23,Break & Enter-Apartment,2015,2,9,0,7
D23,Break & Enter-Apartment,2015,0,6,0,6
D23,Break & Enter-Apartment,2015,4,18,0,14
D23,Break & Enter-Apartment,2015,5,18,0,13
D23,Break & Enter-Apartment,2015,1,7,0,6
D23,Break & Enter-Apartment,2015,0,3,0,3
D23,Break & Enter-Apartment,2015,0,10,0,10
D23,Break & Enter-Apartment,2015,0,17,0,17
D23,Break & Enter-Commercial,2015,0,1,0,1
D23,Break & Enter-Commercial,2015,0,3,0,3
D23,Break & Enter-Commercial,2015,1,3,0,2
D23,Break & Enter-Commercial,2015,1,3,0,2
D23,Assault,2015,16,25,0,9
D23,Break & Enter-House,2015,1,9,0,8
D23,Assault,2015,1,2,0,1
D22,Theft Over $5000,2015,1,5,0,4
D22,Break & Enter-Other,2015,0,1,0,1
D22,Auto Theft,2015,1,14,0,13
D22,Theft Over $5000,2015,0,2,0,2
D23,Assault,2015,71,103,0,32
D23,Break & Enter-House,2015,4,19,0,15
D23,Assault,2015,134,208,0,74
D23,Assault,2015,1,4,0,3
D22,Sexual Violation,2015,7,12,0,5
D22,Theft Over $5000,2015,2,9,0,7
D23,Assault,2015,0,1,0,1
D23,Break & Enter-House,2015,2,17,0,15
D22,Sexual Violation,2015,0,3,0,3
D22,Theft Over $5000,2015,0,1,0,1
D23,Assault,2015,36,51,0,15
D22,Break & Enter-Other,2015,0,2,0,2
D22,Auto Theft,2015,3,9,0,6
D23,Break & Enter-Other,2015,1,1,1,0
D22,Sexual Violation,2015,5,10,0,5
D22,Theft Over $5000,2015,1,5,0,4
D23,Assault,2015,43,55,0,12
D22,Break & Enter-Other,2015,1,1,1,0
D22,Auto Theft,2015,2,26,0,24
D23,Break & Enter-Other,2015,0,3,0,3
D22,Sexual Violation,2015,3,4,0,1
D22,Theft Over $5000,2015,0,4,0,4
D23,Assault,2015,173,266,0,93
D22,Break & Enter-Other,2015,2,4,0,2
D22,Auto Theft,2015,6,17,0,11
D23,Break & Enter-Other,2015,0,7,0,7
D22,Sexual Violation,2015,3,5,0,2
D22,Theft Over $5000,2015,2,8,0,6
D23,Assault,2015,47,63,0,16
D22,Break & Enter-Other,2015,0,4,0,4
D22,Auto Theft,2015,3,16,0,13
D23,Break & Enter-Other,2015,0,1,0,1
D22,Other,2015,4,4,1,0
D22,Theft Under $5000,2015,21,81,0,60
D23,Attempt Murder,2015,3,3,1,0
D22,Break & Enter-Other,2015,0,5,0,5
D22,Auto Theft,2015,2,15,0,13
D23,Fraud,2015,0,3,0,3
D22,Other,2015,1,1,1,0
D22,Theft Under $5000,2015,0,1,0,1
D23,Attempt Murder,2015,0,2,0,2
D22,Break & Enter-Other,2015,0,3,0,3
D22,Auto Theft,2015,4,28,0,24
D22,Auto Theft,2015,1,1,1,0
D22,Auto Theft,2015,2,13,0,11
D22,Auto Theft,2015,3,19,0,16
D22,Auto Theft,2015,2,37,0,35
D22,Break & Enter-Apartment,2015,4,13,0,9
D22,Break & Enter-Apartment,2015,1,3,0,2
D22,Break & Enter-Apartment,2015,8,22,0,14
D22,Break & Enter-Apartment,2015,6,12,0,6
D22,Break & Enter-Apartment,2015,2,13,0,11
D22,Break & Enter-Apartment,2015,1,14,0,13
D22,Break & Enter-Apartment,2015,0,2,0,2
D22,Break & Enter-Apartment,2015,1,7,0,6
D22,Break & Enter-Apartment,2015,1,3,0,2
D22,Break & Enter-Apartment,2015,4,11,0,7
D22,Break & Enter-Apartment,2015,0,1,0,1
D22,Break & Enter-Apartment,2015,2,9,0,7
D22,Break & Enter-Apartment,2015,0,4,0,4
D22,Break & Enter-Apartment,2015,2,10,0,8
D22,Break & Enter-Commercial,2015,1,6,0,5
D22,Break & Enter-Commercial,2015,0,1,0,1
D22,Break & Enter-Commercial,2015,2,7,0,5
D22,Break & Enter-Commercial,2015,11,56,0,45
D22,Break & Enter-Commercial,2015,5,7,0,2
D22,Break & Enter-Commercial,2015,2,6,0,4
D22,Break & Enter-Commercial,2015,7,14,0,7
D22,Break & Enter-Commercial,2015,4,8,0,4
D22,Break & Enter-Commercial,2015,2,2,1,0
D22,Break & Enter-Commercial,2015,6,16,0,10
D22,Break & Enter-Commercial,2015,5,18,0,13
D22,Break & Enter-Commercial,2015,8,12,0,4
D22,Break & Enter-House,2015,10,22,0,12
D22,Break & Enter-House,2015,1,25,0,24
D22,Break & Enter-House,2015,4,15,0,11
D23,Attempt Murder,2015,2,5,0,3
D22,Other,2015,4,4,1,0
D22,Theft Under $5000,2015,29,128,0,99
D23,Fraud,2015,6,24,0,18
D22,Break & Enter-Other,2015,0,2,0,2
D23,Other,2015,10,15,0,5
D22,Other,2015,18,18,1,0
D23,Fraud,2015,1,17,0,16
D22,Theft Under $5000,2015,19,106,0,87
D23,Fraud,2015,11,34,0,23
D22,Fraud,2015,7,29,0,22
D23,Other,2015,0,1,0,1
D22,Other,2015,7,7,1,0
D22,Fraud,2015,2,19,0,17
D23,Other,2015,4,13,0,9
D22,Theft Under $5000,2015,259,590,0,331
D23,Fraud,2015,35,88,0,53
D22,Other,2015,17,17,1,0
D22,Fraud,2015,6,28,0,22
D23,Other,2015,18,44,0,26
D22,Theft Under $5000,2015,18,44,0,26
D23,Fraud,2015,1,4,0,3
D22,Other,2015,12,12,1,0
D22,Fraud,2015,52,140,0,88
D23,Other,2015,37,84,0,47
D22,Theft Under $5000,2015,16,70,0,54
D23,Fraud,2015,0,1,0,1
D22,Other,2015,5,5,1,0
D22,Fraud,2015,4,20,0,16
D23,Other,2015,1,1,1,0
D22,Theft Under $5000,2015,58,225,0,167
D23,Fraud,2015,8,22,0,14
D22,Other,2015,10,10,1,0
D22,Fraud,2015,1,1,1,0
D23,Other,2015,13,22,0,9
D22,Theft Under $5000,2015,56,141,0,85
D23,Fraud,2015,8,27,0,19
D22,Other,2015,3,3,1,0
D22,Fraud,2015,10,39,0,29
D23,Other,2015,12,13,0,1
D22,Theft Under $5000,2015,0,1,0,1
D23,Fraud,2015,48,152,0,104
D22,Other,2015,19,19,1,0
D22,Fraud,2015,5,56,0,51
D23,Other,2015,39,83,0,44
D22,Theft Under $5000,2015,23,111,0,88
D23,Fraud,2015,8,38,0,30
D22,Other,2015,4,4,1,0
D22,Fraud,2015,4,19,0,15
D23,Other,2015,15,30,0,15
D22,Theft Under $5000,2015,26,102,0,76
D23,Other,2015,3,5,0,2
D22,Other,2015,13,13,1,0
D22,Fraud,2015,3,19,0,16
D23,Other,2015,12,35,0,23
D23,Robbery-Financial,2015,0,1,0,1
D22,Theft Under $5000,2015,22,121,0,99
D22,Fraud,2015,2,30,0,28
D22,Other,2015,6,6,1,0
D23,Robbery-Financial,2015,0,1,0,1
D23,Other,2015,25,60,0,35
D22,Theft Under $5000,2015,2,11,0,9
D22,Fraud,2015,10,47,0,37
D22,Other,2015,31,31,1,0
D23,Robbery-Financial,2015,1,2,0,1
D23,Other,2015,1,1,1,0
D22,Theft Under $5000,2015,33,134,0,101
D22,Fraud,2015,0,1,0,1
D22,Other,2015,19,21,0,2
D23,Robbery-Other,2015,1,2,0,1
D23,Other,2015,24,75,0,51
D22,Theft Under $5000,2015,29,134,0,105
D22,Fraud,2015,0,3,0,3
D22,Other,2015,1,1,1,0
D23,Robbery-Other,2015,2,8,0,6
D23,Other,2015,35,117,0,82
D22,Theft Under $5000,2015,50,184,0,134
D22,Fraud,2015,5,25,0,20
D22,Other,2015,8,12,0,4
D23,Robbery-Other,2015,2,5,0,3
D23,Other,2015,1,5,0,4
D22,Assault,2015,40,44,0,4
D22,Fraud,2015,2,14,0,12
D22,Other,2015,12,13,0,1
D23,Robbery-Other,2015,9,28,0,19
D23,Other,2015,0,1,0,1
D22,Assault,2015,12,17,0,5
D22,Fraud,2015,16,60,0,44
D22,Other,2015,95,104,0,9
D23,Robbery-Other,2015,46,101,0,55
D23,Other,2015,17,52,0,35
D22,Assault,2015,39,59,0,20
D22,Other,2015,16,44,0,28
D22,Other,2015,23,28,0,5
D23,Other,2015,10,41,0,31
D23,Robbery-Other,2015,2,2,1,0
D22,Assault,2015,94,145,0,51
D22,Other,2015,4,31,0,27
D22,Other,2015,39,46,0,7
D23,Other,2015,62,206,0,144
D23,Robbery-Other,2015,1,1,1,0
D22,Other,2015,14,41,0,27
D22,Assault,2015,36,49,0,13
D23,Other,2015,14,60,0,46
D22,Other,2015,27,27,1,0
D23,Robbery-Other,2015,0,6,0,6
D22,Assault,2015,2,2,1,0
D23,Theft Over $5000,2015,0,1,0,1
D22,Other,2015,49,131,0,82
D22,Other,2015,25,30,0,5
D23,Robbery-Other,2015,6,17,0,11
D22,Assault,2015,49,64,0,15
D23,Theft Over $5000,2015,1,2,0,1
D22,Other,2015,14,40,0,26
D22,Other,2015,22,26,0,4
D23,Robbery-Other,2015,22,69,0,47
D22,Assault,2015,1,1,1,0
D23,Theft Over $5000,2015,0,4,0,4
D22,Other,2015,1,1,1,0
D22,Other,2015,33,39,0,6
D23,Robbery-Other,2015,5,12,0,7
D22,Assault,2015,1,1,1,0
D23,Theft Over $5000,2015,1,5,0,4
D22,Other,2015,17,44,0,27
D22,Other,2015,7,7,1,0
D23,Sexual Violation,2015,1,2,0,1
D22,Assault,2015,33,46,0,13
D23,Theft Over $5000,2015,1,1,1,0
D22,Other,2015,24,74,0,50
D22,Other,2015,264,274,0,10
D22,Assault,2015,19,31,0,12
D23,Theft Over $5000,2015,0,3,0,3
D22,Other,2015,20,53,0,33
D22,Other,2015,11,13,0,2
D22,Assault,2015,47,62,0,15
D23,Theft Over $5000,2015,10,59,0,49
D22,Other,2015,23,50,0,27
D22,Other,2015,44,49,0,5
D22,Assault,2015,7,12,0,5
D23,Theft Over $5000,2015,0,4,0,4
D22,Other,2015,3,22,0,19
D22,Other,2015,10,10,1,0
D23,Theft Under $5000,2015,10,18,0,8
D22,Other,2015,27,78,0,51
D22,Other,2015,46,49,0,3
D23,Theft Under $5000,2015,61,130,0,69
D22,Other,2015,1,4,0,3
D22,Other,2015,2,2,1,0
D22,Other Criminal Violations - Offensive Weapons,2015,5,5,1,0
D22,Other Criminal Violations - Offensive Weapons,2015,1,1,1,0
D22,Other Criminal Violations - Offensive Weapons,2015,3,3,1,0
D31,Other,2015,5,9,0,4
D31,Other,2015,61,104,0,43
D31,Robbery-Financial,2015,0,1,0,1
D31,Robbery-Financial,2015,3,3,1,0
D31,Robbery-Other,2015,11,37,0,26
D31,Robbery-Other,2015,5,15,0,10
D31,Robbery-Other,2015,22,45,0,23
D31,Robbery-Other,2015,12,21,0,9
D31,Robbery-Other,2015,11,25,0,14
D31,Robbery-Other,2015,12,36,0,24
D31,Robbery-Other,2015,8,14,0,6
D31,Robbery-Other,2015,22,71,0,49
D31,Sexual Violation,2015,0,1,0,1
D31,Sexual Violation,2015,12,23,0,11
D31,Sexual Violation,2015,3,13,0,10
D31,Sexual Violation,2015,17,32,0,15
D31,Sexual Violation,2015,7,10,0,3
D31,Sexual Violation,2015,12,16,0,4
D31,Sexual Violation,2015,2,3,0,1
D31,Sexual Violation,2015,14,25,0,11
D31,Other Criminal Violations - Offensive Weapons,2015,7,10,0,3
D31,Sexual Violation,2015,3,3,1,0
D31,Sexual Violation,2015,33,53,0,20
D31,Other,2015,7,7,1,0
D31,Other,2015,11,11,1,0
D31,Other,2015,40,43,0,3
D31,Other,2015,10,10,1,0
D31,Other Criminal Violations - Offensive Weapons,2015,31,42,0,11
D32,Break & Enter-Other,2015,0,1,0,1
D31,Other,2015,11,11,1,0
D31,Other,2015,10,10,1,0
D32,Break & Enter-Other,2015,0,1,0,1
D31,Other,2015,1,1,1,0
D31,Other,2015,1,1,1,0
D32,Break & Enter-Other,2015,0,1,0,1
D23,Sexual Violation,2015,3,3,1,0
D31,Other,2015,17,17,1,0
D31,Other,2015,17,18,0,1
D32,Break & Enter-Other,2015,0,1,0,1
D31,Other,2015,15,61,0,46
D23,Sexual Violation,2015,4,4,1,0
D23,Sexual Violation,2015,9,13,0,4
D23,Sexual Violation,2015,15,22,0,7
D23,Sexual Violation,2015,1,5,0,4
D23,Sexual Violation,2015,0,1,0,1
D23,Sexual Violation,2015,4,8,0,4
D23,Sexual Violation,2015,7,8,0,1
D23,Sexual Violation,2015,24,42,0,18
D23,Sexual Violation,2015,8,16,0,8
D23,Other,2015,2,2,1,0
D23,Other,2015,12,12,1,0
D23,Other,2015,2,2,1,0
D23,Other,2015,15,15,1,0
D23,Other,2015,22,22,1,0
D23,Other,2015,4,5,0,1
D23,Other,2015,2,2,1,0
D23,Other,2015,5,5,1,0
D23,Other,2015,15,15,1,0
D23,Other,2015,61,61,1,0
D23,Other,2015,5,5,1,0
D23,Other,2015,5,5,1,0
D23,Other,2015,23,23,1,0
D23,Other,2015,1,1,1,0
D23,Other,2015,8,8,1,0
D23,Other,2015,13,13,1,0
D23,Other,2015,51,53,0,2
D23,Other,2015,96,107,0,11
D23,Other,2015,10,10,1,0
D23,Other,2015,18,19,0,1
D23,Other,2015,24,27,0,3
D23,Other,2015,114,122,0,8
D23,Other,2015,36,41,0,5
D23,Other Criminal Violations - Offensive Weapons,2015,4,5,0,1
D23,Other Criminal Violations - Offensive Weapons,2015,0,3,0,3
D23,Other Criminal Violations - Offensive Weapons,2015,13,14,0,1
D23,Other Criminal Violations - Offensive Weapons,2015,27,29,0,2
D23,Other Criminal Violations - Offensive Weapons,2015,4,4,1,0
D23,Other Criminal Violations - Offensive Weapons,2015,1,1,1,0
D23,Other Criminal Violations - Offensive Weapons,2015,22,25,0,3
D23,Other Criminal Violations - Offensive Weapons,2015,2,2,1,0
D23,Other,2015,1,1,1,0
D32,Break & Enter-Apartment,2015,0,2,0,2
D32,Theft Over $5000,2015,2,14,0,12
D23,Other,2015,1,1,1,0
D23,Other,2015,7,7,1,0
D23,Other,2015,1,1,1,0
D23,Other,2015,7,9,0,2
D23,Other,2015,2,2,1,0
D31,Other,2015,44,50,0,6
D31,Other,2015,21,25,0,4
D31,Other,2015,118,128,0,10
D31,Other,2015,20,21,0,1
D31,Other,2015,5,5,1,0
D32,Break & Enter-Apartment,2015,1,8,0,7
D31,Other,2015,55,147,0,92
D32,Theft Over $5000,2015,0,1,0,1
D31,Other,2015,21,21,1,0
D31,Other,2015,5,5,1,0
D31,Other,2015,15,17,0,2
D32,Break & Enter-Other,2015,0,1,0,1
D32,Break & Enter-Apartment,2015,1,12,0,11
D31,Other,2015,6,7,0,1
D31,Other,2015,73,81,0,8
D32,Break & Enter-Other,2015,0,4,0,4
D32,Theft Over $5000,2015,1,6,0,5
D31,Other,2015,8,12,0,4
D31,Other,2015,20,59,0,39
D32,Break & Enter-Apartment,2015,0,6,0,6
D31,Other,2015,14,18,0,4
D31,Other,2015,27,34,0,7
D32,Break & Enter-Other,2015,0,3,0,3
D32,Theft Over $5000,2015,0,4,0,4
D31,Other,2015,71,77,0,6
D31,Other,2015,28,56,0,28
D32,Break & Enter-Apartment,2015,0,5,0,5
D31,Other,2015,7,8,0,1
D31,Other,2015,127,138,0,11
D32,Break & Enter-Other,2015,0,1,0,1
D32,Theft Over $5000,2015,1,4,0,3
D31,Other,2015,15,16,0,1
D31,Other,2015,2,3,0,1
D32,Break & Enter-Apartment,2015,4,14,0,10
D32,Other,2015,14,14,1,0
D31,Other,2015,23,29,0,6
D32,Fraud,2015,0,28,0,28
D32,Theft Over $5000,2015,1,6,0,5
D31,Other,2015,54,54,1,0
D31,Other,2015,52,128,0,76
D32,Break & Enter-Apartment,2015,0,12,0,12
D32,Other,2015,8,8,1,0
D31,Other,2015,212,216,0,4
D32,Fraud,2015,2,36,0,34
D32,Theft Over $5000,2015,0,5,0,5
D32,Theft Over $5000,2015,0,6,0,6
D32,Theft Over $5000,2015,1,10,0,9
D32,Theft Over $5000,2015,0,3,0,3
D32,Theft Over $5000,2015,0,5,0,5
D32,Theft Over $5000,2015,1,6,0,5
D32,Theft Over $5000,2015,1,5,0,4
D32,Theft Over $5000,2015,1,22,0,21
D32,Theft Over $5000,2015,3,12,0,9
D32,Theft Under $5000,2015,41,95,0,54
D32,Theft Under $5000,2015,17,108,0,91
D32,Theft Under $5000,2015,16,154,0,138
D32,Theft Under $5000,2015,2,14,0,12
D32,Theft Under $5000,2015,98,226,0,128
D32,Theft Under $5000,2015,4,45,0,41
D32,Theft Under $5000,2015,4,46,0,42
D32,Theft Under $5000,2015,74,172,0,98
D32,Theft Under $5000,2015,34,162,0,128
D32,Theft Under $5000,2015,7,74,0,67
D32,Theft Under $5000,2015,0,1,0,1
D32,Theft Under $5000,2015,0,13,0,13
D32,Theft Under $5000,2015,19,108,0,89
D32,Theft Under $5000,2015,78,248,0,170
D32,Theft Under $5000,2015,2,26,0,24
D32,Theft Under $5000,2015,19,114,0,95
D32,Theft Under $5000,2015,23,122,0,99
D32,Theft Under $5000,2015,192,297,0,105
D32,Theft Under $5000,2015,115,262,0,147
D32,Theft Under $5000,2015,347,644,0,297
D32,Assault,2015,17,34,0,17
D32,Assault,2015,31,44,0,13
D32,Assault,2015,0,1,0,1
D32,Assault,2015,14,25,0,11
D32,Assault,2015,8,11,0,3
D32,Assault,2015,36,57,0,21
D32,Assault,2015,29,43,0,14
D32,Assault,2015,17,31,0,14
D32,Assault,2015,38,63,0,25
D32,Assault,2015,36,70,0,34
D32,Assault,2015,11,25,0,14
D32,Assault,2015,0,1,0,1
D32,Assault,2015,3,6,0,3
D32,Assault,2015,40,73,0,33
D32,Assault,2015,68,103,0,35
D32,Other,2015,4,4,1,0
D32,Fraud,2015,6,50,0,44
D31,Other,2015,2,2,1,0
D32,Break & Enter-Apartment,2015,3,51,0,48
D32,Other,2015,2,2,1,0
D31,Auto Theft,2015,4,46,0,42
D32,Break & Enter-Apartment,2015,0,5,0,5
D32,Other,2015,10,10,1,0
D31,Other,2015,119,143,0,24
D32,Fraud,2015,2,5,0,3
D32,Break & Enter-Apartment,2015,0,3,0,3
D31,Auto Theft,2015,0,18,0,18
D32,Other,2015,8,8,1,0
D31,Other,2015,22,23,0,1
D32,Fraud,2015,12,51,0,39
D32,Break & Enter-Apartment,2015,0,1,0,1
D32,Fraud,2015,1,18,0,17
D31,Other,2015,5,22,0,17
D32,Break & Enter-Apartment,2015,0,3,0,3
D31,Auto Theft,2015,3,53,0,50
D32,Other,2015,8,8,1,0
D31,Other,2015,1,1,1,0
D32,Fraud,2015,5,29,0,24
D31,Other,2015,2,2,1,0
D32,Break & Enter-Commercial,2015,0,2,0,2
D31,Auto Theft,2015,2,41,0,39
D32,Other,2015,11,11,1,0
D31,Other,2015,2,2,1,0
D32,Fraud,2015,8,36,0,28
D32,Fraud,2015,1,1,1,0
D32,Fraud,2015,5,44,0,39
D32,Fraud,2015,2,33,0,31
D32,Fraud,2015,0,3,0,3
D32,Fraud,2015,13,49,0,36
D32,Fraud,2015,9,63,0,54
D32,Fraud,2015,0,10,0,10
D32,Fraud,2015,1,37,0,36
D32,Fraud,2015,17,61,0,44
D32,Fraud,2015,24,73,0,49
D32,Fraud,2015,21,67,0,46
D32,Fraud,2015,55,117,0,62
D32,Other,2015,5,28,0,23
D32,Other,2015,9,49,0,40
D32,Other,2015,6,50,0,44
D32,Other,2015,6,10,0,4
D32,Other,2015,16,66,0,50
D32,Other,2015,7,22,0,15
D32,Other,2015,6,38,0,32
D32,Other,2015,11,57,0,46
D32,Other,2015,19,64,0,45
D32,Other,2015,3,29,0,26
D32,Other,2015,0,7,0,7
D32,Other,2015,11,49,0,38
D32,Other,2015,19,75,0,56
D32,Other,2015,5,21,0,16
D32,Other,2015,22,62,0,40
D32,Other,2015,12,43,0,31
D32,Other,2015,12,38,0,26
D32,Other,2015,13,46,0,33
D32,Other,2015,149,212,0,63
D32,Theft Over $5000,2015,0,1,0,1
D32,Theft Over $5000,2015,1,2,0,1
D32,Theft Over $5000,2015,0,1,0,1
D32,Break & Enter-Commercial,2015,2,7,0,5
D31,Other,2015,60,181,0,121
D31,Other,2015,1,1,1,0
D31,Auto Theft,2015,0,34,0,34
D32,Break & Enter-Commercial,2015,0,7,0,7
D31,Theft Over $5000,2015,1,4,0,3
D31,Other,2015,102,124,0,22
D32,Other,2015,5,5,1,0
D31,Auto Theft,2015,0,1,0,1
D32,Break & Enter-Commercial,2015,0,1,0,1
D31,Theft Over $5000,2015,0,7,0,7
D31,Other Criminal Violations - Offensive Weapons,2015,28,34,0,6
D32,Other,2015,8,10,0,2
D31,Auto Theft,2015,2,72,0,70
D31,Auto Theft,2015,0,11,0,11
D31,Auto Theft,2015,7,78,0,71
D31,Break & Enter-Apartment,2015,2,13,0,11
D31,Break & Enter-Apartment,2015,7,23,0,16
D31,Break & Enter-Apartment,2015,2,5,0,3
D31,Break & Enter-Apartment,2015,6,17,0,11
D31,Break & Enter-Apartment,2015,6,19,0,13
D31,Break & Enter-Apartment,2015,4,27,0,23
D31,Break & Enter-Commercial,2015,1,8,0,7
D31,Break & Enter-Commercial,2015,0,5,0,5
D31,Break & Enter-Commercial,2015,2,5,0,3
D31,Break & Enter-Commercial,2015,4,26,0,22
D31,Break & Enter-Commercial,2015,3,10,0,7
D31,Break & Enter-Commercial,2015,2,7,0,5
D31,Break & Enter-Commercial,2015,5,33,0,28
D31,Break & Enter-House,2015,4,6,0,2
D31,Break & Enter-House,2015,3,10,0,7
D31,Break & Enter-House,2015,1,7,0,6
D31,Break & Enter-House,2015,2,13,0,11
D31,Break & Enter-House,2015,3,7,0,4
D31,Break & Enter-House,2015,6,18,0,12
D31,Break & Enter-House,2015,1,5,0,4
D31,Break & Enter-House,2015,2,8,0,6
D31,Break & Enter-Other,2015,1,1,1,0
D31,Break & Enter-Other,2015,0,1,0,1
D31,Break & Enter-Other,2015,0,4,0,4
D31,Fraud,2015,1,1,1,0
D31,Fraud,2015,22,67,0,45
D31,Fraud,2015,19,42,0,23
D31,Fraud,2015,22,74,0,52
D31,Fraud,2015,12,47,0,35
D31,Fraud,2015,14,41,0,27
D31,Fraud,2015,2,4,0,2
D31,Fraud,2015,42,81,0,39
D31,Fraud,2015,1,3,0,2
D31,Fraud,2015,26,115,0,89
D31,Other,2015,43,108,0,65
D31,Theft Over $5000,2015,3,7,0,4
D32,Other,2015,20,20,1,0
D31,Other Criminal Violations - Offensive Weapons,2015,14,16,0,2
D32,Break & Enter-Commercial,2015,3,19,0,16
D31,Theft Over $5000,2015,2,16,0,14
D32,Other,2015,3,3,1,0
D32,Break & Enter-Commercial,2015,2,6,0,4
D31,Other Criminal Violations - Offensive Weapons,2015,30,39,0,9
D31,Theft Over $5000,2015,2,9,0,7
D32,Other,2015,15,15,1,0
D31,Other Criminal Violations - Offensive Weapons,2015,14,18,0,4
D32,Break & Enter-Commercial,2015,1,5,0,4
D31,Theft Over $5000,2015,0,1,0,1
D32,Other,2015,1,1,1,0
D31,Other Criminal Violations - Offensive Weapons,2015,15,19,0,4
D32,Break & Enter-Commercial,2015,1,13,0,12
D31,Theft Over $5000,2015,1,4,0,3
D32,Other,2015,23,24,0,1
D31,Other Criminal Violations - Offensive Weapons,2015,2,2,1,0
D32,Break & Enter-Commercial,2015,0,1,0,1
D31,Theft Over $5000,2015,0,3,0,3
D32,Other,2015,21,21,1,0
D31,Other Criminal Violations - Offensive Weapons,2015,31,37,0,6
D32,Break & Enter-Commercial,2015,0,10,0,10
D31,Theft Over $5000,2015,4,25,0,21
D32,Other,2015,5,6,0,1
D32,Break & Enter-Commercial,2015,0,5,0,5
D31,Theft Under $5000,2015,30,112,0,82
D32,Other,2015,29,31,0,2
D32,Break & Enter-Commercial,2015,1,1,1,0
D31,Theft Under $5000,2015,30,121,0,91
D32,Auto Theft,2015,1,6,0,5
D32,Break & Enter-Commercial,2015,0,4,0,4
D31,Theft Under $5000,2015,101,274,0,173
D32,Auto Theft,2015,1,26,0,25
D32,Break & Enter-Commercial,2015,0,4,0,4
D31,Theft Under $5000,2015,49,187,0,138
D32,Auto Theft,2015,1,37,0,36
D32,Break & Enter-Commercial,2015,1,65,0,64
D31,Theft Under $5000,2015,7,62,0,55
D32,Auto Theft,2015,1,6,0,5
D32,Break & Enter-Commercial,2015,4,24,0,20
D31,Theft Under $5000,2015,0,6,0,6
D32,Auto Theft,2015,1,37,0,36
D32,Break & Enter-House,2015,0,3,0,3
D31,Theft Under $5000,2015,169,332,0,163
D32,Auto Theft,2015,0,16,0,16
D32,Break & Enter-House,2015,1,11,0,10
D31,Theft Under $5000,2015,6,32,0,26
D32,Break & Enter-House,2015,1,43,0,42
D32,Auto Theft,2015,0,20,0,20
D31,Theft Under $5000,2015,0,1,0,1
D32,Break & Enter-House,2015,1,16,0,15
D32,Auto Theft,2015,1,16,0,15
D31,Theft Under $5000,2015,53,310,0,257
D32,Break & Enter-House,2015,1,18,0,17
D32,Auto Theft,2015,0,25,0,25
D31,Assault,2015,114,172,0,58
D32,Break & Enter-House,2015,3,9,0,6
D32,Auto Theft,2015,0,27,0,27
D31,Assault,2015,43,62,0,19
D32,Break & Enter-House,2015,6,49,0,43
D32,Auto Theft,2015,0,2,0,2
D31,Assault,2015,178,269,0,91
D32,Break & Enter-House,2015,1,10,0,9
D32,Auto Theft,2015,0,9,0,9
D31,Assault,2015,48,77,0,29
D32,Break & Enter-House,2015,0,15,0,15
D32,Auto Theft,2015,0,32,0,32
D31,Assault,2015,73,102,0,29
D32,Break & Enter-House,2015,2,21,0,19
D32,Auto Theft,2015,0,15,0,15
D31,Assault,2015,5,10,0,5
D32,Break & Enter-House,2015,4,34,0,30
D32,Auto Theft,2015,0,20,0,20
D31,Assault,2015,136,194,0,58
D32,Break & Enter-House,2015,2,19,0,17
D32,Auto Theft,2015,1,14,0,13
D31,Assault,2015,20,25,0,5
D32,Break & Enter-House,2015,2,25,0,23
D32,Auto Theft,2015,0,8,0,8
D31,Assault,2015,135,209,0,74
D32,Break & Enter-House,2015,1,17,0,16
D32,Auto Theft,2015,2,28,0,26
D31,Attempt Murder,2015,10,10,1,0
D32,Break & Enter-House,2015,1,7,0,6
D32,Auto Theft,2015,0,29,0,29
D31,Attempt Murder,2015,3,5,0,2
D32,Break & Enter-House,2015,0,1,0,1
D32,Break & Enter-Apartment,2015,0,3,0,3
D31,Attempt Murder,2015,1,1,1,0
D32,Break & Enter-House,2015,1,4,0,3
D32,Break & Enter-Other,2015,0,1,0,1
D32,Break & Enter-Other,2015,1,1,1,0
D32,Break & Enter-Other,2015,0,1,0,1
D32,Break & Enter-Other,2015,0,2,0,2
D32,Break & Enter-Other,2015,0,1,0,1
D32,Break & Enter-Apartment,2015,1,11,0,10
D32,Break & Enter-Apartment,2015,0,6,0,6
D32,Break & Enter-Apartment,2015,2,5,0,3
D31,Attempt Murder,2015,1,1,1,0
D31,Attempt Murder,2015,3,3,1,0
D31,Attempt Murder,2015,1,1,1,0
D31,Other,2015,33,62,0,29
D31,Other,2015,12,19,0,7
D31,Other,2015,39,68,0,29
D31,Other,2015,9,20,0,11
D31,Other,2015,13,24,0,11
D31,Other,2015,2,2,1,0
D31,Other,2015,19,57,0,38
D33,Other,2015,8,9,0,1
D33,Other,2015,2,2,1,0
D33,Other,2015,2,2,1,0
D33,Other,2015,3,4,0,1
D33,Other,2015,1,1,1,0
D33,Other,2015,3,4,0,1
D33,Other,2015,9,10,0,1
D33,Other,2015,5,6,0,1
D33,Other,2015,7,10,0,3
D33,Other,2015,1,1,1,0
D33,Theft Over $5000,2015,0,1,0,1
D33,Other,2015,10,10,1,0
D33,Other,2015,4,4,1,0
D33,Theft Over $5000,2015,0,2,0,2
D33,Auto Theft,2015,1,25,0,24
D33,Theft Over $5000,2015,1,6,0,5
D33,Auto Theft,2015,1,15,0,14
D33,Theft Over $5000,2015,1,3,0,2
D33,Auto Theft,2015,0,7,0,7
D33,Theft Over $5000,2015,1,3,0,2
D33,Auto Theft,2015,2,34,0,32
D32,Other,2015,10,12,0,2
D33,Theft Over $5000,2015,1,5,0,4
D33,Attempt Murder,2015,1,1,1,0
D33,Auto Theft,2015,0,17,0,17
D32,Other,2015,9,9,1,0
D33,Theft Over $5000,2015,0,1,0,1
D33,Auto Theft,2015,4,14,0,10
D33,Auto Theft,2015,1,10,0,9
D33,Auto Theft,2015,0,1,0,1
D33,Auto Theft,2015,0,2,0,2
D33,Auto Theft,2015,2,19,0,17
D33,Auto Theft,2015,0,6,0,6
D33,Auto Theft,2015,0,10,0,10
D33,Auto Theft,2015,0,9,0,9
D33,Auto Theft,2015,0,1,0,1
D33,Break & Enter-Apartment,2015,1,22,0,21
D33,Break & Enter-Apartment,2015,1,3,0,2
D33,Break & Enter-Apartment,2015,0,3,0,3
D33,Break & Enter-Apartment,2015,9,24,0,15
D33,Break & Enter-Apartment,2015,6,28,0,22
D33,Break & Enter-Apartment,2015,0,10,0,10
D33,Break & Enter-Apartment,2015,0,4,0,4
D33,Break & Enter-Apartment,2015,1,9,0,8
D33,Break & Enter-Apartment,2015,0,2,0,2
D33,Break & Enter-Apartment,2015,0,1,0,1
D33,Break & Enter-Apartment,2015,0,18,0,18
D33,Break & Enter-Commercial,2015,8,19,0,11
D33,Break & Enter-Commercial,2015,2,4,0,2
D33,Break & Enter-Commercial,2015,0,1,0,1
D33,Break & Enter-Commercial,2015,0,1,0,1
D33,Break & Enter-Commercial,2015,1,10,0,9
D33,Break & Enter-Commercial,2015,1,7,0,6
D33,Break & Enter-Commercial,2015,1,1,1,0
D33,Break & Enter-Commercial,2015,1,4,0,3
D33,Break & Enter-Commercial,2015,0,3,0,3
D33,Break & Enter-Commercial,2015,2,6,0,4
D33,Break & Enter-Commercial,2015,0,4,0,4
D33,Break & Enter-House,2015,4,44,0,40
D33,Break & Enter-House,2015,8,26,0,18
D32,Assault,2015,17,21,0,4
D33,Attempt Murder,2015,0,1,0,1
D32,Robbery-Other,2015,0,1,0,1
D32,Other,2015,17,19,0,2
D32,Assault,2015,54,82,0,28
D33,Theft Over $5000,2015,0,3,0,3
D33,Other,2015,28,43,0,15
D32,Other,2015,3,3,1,0
D32,Assault,2015,51,86,0,35
D33,Theft Over $5000,2015,1,5,0,4
D33,Other,2015,19,32,0,13
D32,Other,2015,16,24,0,8
D32,Assault,2015,45,66,0,21
D33,Break & Enter-House,2015,9,30,0,21
D33,Other,2015,12,12,1,0
D33,Theft Over $5000,2015,2,12,0,10
D33,Theft Over $5000,2015,0,2,0,2
D33,Theft Under $5000,2015,139,282,0,143
D33,Theft Under $5000,2015,89,241,0,152
D33,Theft Under $5000,2015,17,72,0,55
D33,Theft Under $5000,2015,2,10,0,8
D33,Theft Under $5000,2015,276,483,0,207
D33,Theft Under $5000,2015,26,100,0,74
D33,Theft Under $5000,2015,1,2,0,1
D33,Theft Under $5000,2015,9,74,0,65
D33,Theft Under $5000,2015,50,156,0,106
D33,Theft Under $5000,2015,0,3,0,3
D33,Theft Under $5000,2015,0,2,0,2
D33,Theft Under $5000,2015,38,96,0,58
D33,Theft Under $5000,2015,27,99,0,72
D33,Theft Under $5000,2015,22,74,0,52
D33,Theft Under $5000,2015,0,1,0,1
D33,Theft Under $5000,2015,1,1,1,0
D33,Theft Under $5000,2015,8,57,0,49
D33,Theft Under $5000,2015,1,3,0,2
D33,Assault,2015,54,72,0,18
D33,Assault,2015,75,95,0,20
D33,Assault,2015,33,43,0,10
D33,Assault,2015,2,4,0,2
D33,Assault,2015,1,3,0,2
D33,Assault,2015,88,125,0,37
D33,Assault,2015,65,85,0,20
D33,Assault,2015,2,2,1,0
D33,Assault,2015,38,57,0,19
D33,Assault,2015,31,50,0,19
D33,Assault,2015,1,1,1,0
D33,Assault,2015,2,4,0,2
D33,Assault,2015,30,41,0,11
D33,Assault,2015,33,39,0,6
D33,Assault,2015,9,15,0,6
D33,Assault,2015,0,1,0,1
D33,Assault,2015,0,3,0,3
D33,Assault,2015,43,51,0,8
D33,Assault,2015,1,1,1,0
D33,Assault,2015,1,1,1,0
D33,Attempt Murder,2015,0,1,0,1
D33,Other,2015,12,12,1,0
D33,Break & Enter-House,2015,0,6,0,6
D33,Other,2015,5,8,0,3
D32,Other,2015,2,6,0,4
D32,Assault,2015,24,38,0,14
D33,Other,2015,0,1,0,1
D32,Assault,2015,50,82,0,32
D32,Attempt Murder,2015,0,2,0,2
D33,Other,2015,18,33,0,15
D32,Robbery-Other,2015,5,10,0,5
D32,Attempt Murder,2015,0,2,0,2
D32,Other,2015,9,10,0,1
D33,Break & Enter-House,2015,1,22,0,21
D33,Other,2015,13,24,0,11
D32,Attempt Murder,2015,2,2,1,0
D32,Other,2015,21,22,0,1
D32,Robbery-Other,2015,0,5,0,5
D33,Other,2015,8,8,1,0
D32,Attempt Murder,2015,1,1,1,0
D33,Other,2015,1,2,0,1
D32,Other,2015,49,52,0,3
D33,Other,2015,4,4,1,0
D32,Attempt Murder,2015,3,3,1,0
D32,Robbery-Other,2015,3,9,0,6
D33,Break & Enter-House,2015,0,5,0,5
D33,Other,2015,11,17,0,6
D32,Other,2015,8,8,1,0
D33,Other,2015,1,1,1,0
D32,Attempt Murder,2015,1,1,1,0
D32,Sexual Violation,2015,5,6,0,1
D33,Break & Enter-House,2015,1,4,0,3
D33,Other,2015,14,21,0,7
D32,Other,2015,1,1,1,0
D33,Other,2015,2,2,1,0
D32,Other,2015,7,22,0,15
D32,Sexual Violation,2015,2,3,0,1
D33,Break & Enter-House,2015,5,34,0,29
D33,Other,2015,1,1,1,0
D32,Other,2015,10,12,0,2
D33,Other,2015,10,10,1,0
D32,Other,2015,13,26,0,13
D32,Sexual Violation,2015,1,1,1,0
D33,Break & Enter-House,2015,1,13,0,12
D33,Other,2015,1,4,0,3
D32,Other,2015,37,40,0,3
D33,Other,2015,2,2,1,0
D32,Other,2015,14,24,0,10
D32,Sexual Violation,2015,1,6,0,5
D33,Break & Enter-House,2015,2,13,0,11
D33,Other,2015,12,25,0,13
D32,Other,2015,26,30,0,4
D33,Other,2015,2,2,1,0
D32,Other,2015,2,7,0,5
D32,Sexual Violation,2015,2,5,0,3
D33,Break & Enter-House,2015,2,33,0,31
D33,Other,2015,6,15,0,9
D32,Other,2015,201,207,0,6
D33,Other,2015,1,2,0,1
D33,Other,2015,44,49,0,5
D33,Other,2015,40,42,0,2
D33,Other,2015,14,19,0,5
D33,Other,2015,5,5,1,0
D33,Other,2015,53,60,0,7
D33,Other,2015,35,39,0,4
D33,Other,2015,36,38,0,2
D33,Other,2015,15,16,0,1
D33,Other,2015,1,1,1,0
D33,Other,2015,3,3,1,0
D33,Other,2015,4,4,1,0
D33,Other,2015,18,19,0,1
D33,Other,2015,20,23,0,3
D33,Other,2015,8,8,1,0
D33,Other,2015,23,26,0,3
D33,Other,2015,3,5,0,2
D33,Other,2015,1,1,1,0
D33,Other,2015,12,12,1,0
D33,Other Criminal Violations - Offensive Weapons,2015,12,13,0,1
D33,Other Criminal Violations - Offensive Weapons,2015,4,4,1,0
D33,Other Criminal Violations - Offensive Weapons,2015,1,1,1,0
D33,Other Criminal Violations - Offensive Weapons,2015,3,3,1,0
D33,Other Criminal Violations - Offensive Weapons,2015,5,6,0,1
D33,Other Criminal Violations - Offensive Weapons,2015,8,9,0,1
D33,Other Criminal Violations - Offensive Weapons,2015,3,3,1,0
D33,Other Criminal Violations - Offensive Weapons,2015,5,5,1,0
D33,Other Criminal Violations - Offensive Weapons,2015,3,3,1,0
D33,Other Criminal Violations - Offensive Weapons,2015,5,5,1,0
D33,Other Criminal Violations - Offensive Weapons,2015,0,1,0,1
D33,Other Criminal Violations - Offensive Weapons,2015,5,5,1,0
D33,Other Criminal Violations - Offensive Weapons,2015,2,2,1,0
D33,Other,2015,1,1,1,0
D33,Other,2015,1,2,0,1
D33,Other,2015,2,3,0,1
D33,Other,2015,2,2,1,0
D33,Other,2015,1,1,1,0
D33,Other,2015,1,1,1,0
D33,Other,2015,0,1,0,1
D33,Other,2015,1,1,1,0
D33,Other,2015,1,1,1,0
D32,Other,2015,9,22,0,13
D33,Other,2015,5,9,0,4
D32,Other,2015,3,14,0,11
D32,Other,2015,65,74,0,9
D32,Other,2015,8,15,0,7
D33,Other,2015,8,15,0,7
D32,Other Criminal Violations - Offensive Weapons,2015,2,2,1,0
D32,Other,2015,13,18,0,5
D33,Other,2015,2,2,1,0
D32,Other Criminal Violations - Offensive Weapons,2015,2,3,0,1
D33,Robbery-Financial,2015,1,1,1,0
D32,Sexual Violation,2015,7,9,0,2
D32,Other,2015,9,29,0,20
D32,Other Criminal Violations - Offensive Weapons,2015,3,3,1,0
D33,Robbery-Other,2015,16,27,0,11
D32,Sexual Violation,2015,1,6,0,5
D32,Other,2015,4,10,0,6
D33,Break & Enter-House,2015,0,11,0,11
D33,Robbery-Other,2015,2,5,0,3
D32,Other,2015,1,5,0,4
D33,Break & Enter-Other,2015,1,2,0,1
D32,Sexual Violation,2015,2,4,0,2
D33,Robbery-Other,2015,13,31,0,18
D32,Other,2015,11,21,0,10
D33,Break & Enter-Other,2015,0,1,0,1
D32,Sexual Violation,2015,2,7,0,5
D33,Robbery-Other,2015,7,16,0,9
D32,Other,2015,26,44,0,18
D33,Break & Enter-Other,2015,0,2,0,2
D32,Sexual Violation,2015,1,2,0,1
D33,Robbery-Other,2015,1,5,0,4
D32,Other,2015,7,13,0,6
D32,Other Criminal Violations - Offensive Weapons,2015,3,3,1,0
D33,Break & Enter-Other,2015,0,2,0,2
D32,Sexual Violation,2015,2,5,0,3
D33,Robbery-Other,2015,1,5,0,4
D32,Other,2015,1,1,1,0
D32,Other Criminal Violations - Offensive Weapons,2015,4,5,0,1
D33,Break & Enter-Other,2015,0,3,0,3
D32,Sexual Violation,2015,16,21,0,5
D33,Robbery-Other,2015,0,1,0,1
D32,Other,2015,21,37,0,16
D32,Other Criminal Violations - Offensive Weapons,2015,5,6,0,1
D33,Break & Enter-Other,2015,0,1,0,1
D32,Sexual Violation,2015,5,12,0,7
D33,Robbery-Other,2015,0,1,0,1
D32,Other,2015,21,34,0,13
D32,Other Criminal Violations - Offensive Weapons,2015,4,4,1,0
D32,Other Criminal Violations - Offensive Weapons,2015,1,1,1,0
D32,Other Criminal Violations - Offensive Weapons,2015,3,3,1,0
D32,Other Criminal Violations - Offensive Weapons,2015,7,9,0,2
D32,Other Criminal Violations - Offensive Weapons,2015,1,1,1,0
D32,Other Criminal Violations - Offensive Weapons,2015,4,5,0,1
D32,Other Criminal Violations - Offensive Weapons,2015,9,12,0,3
D32,Other Criminal Violations - Offensive Weapons,2015,4,4,1,0
D32,Other Criminal Violations - Offensive Weapons,2015,5,5,1,0
D32,Other Criminal Violations - Offensive Weapons,2015,5,8,0,3
D32,Other,2015,1,1,1,0
D32,Other,2015,1,1,1,0
D32,Other,2015,5,5,1,0
D32,Other,2015,3,3,1,0
D32,Other,2015,1,1,1,0
D32,Other,2015,1,1,1,0
D32,Other,2015,1,1,1,0
D32,Other,2015,2,2,1,0
D32,Other,2015,3,3,1,0
D32,Other,2015,2,2,1,0
D32,Other,2015,1,1,1,0
D32,Other,2015,3,3,1,0
D32,Other,2015,3,3,1,0
D33,Other,2015,27,33,0,6
D33,Other,2015,7,7,1,0
D33,Other,2015,3,3,1,0
D33,Other,2015,1,1,1,0
D33,Other,2015,31,37,0,6
D33,Robbery-Other,2015,7,16,0,9
D32,Other,2015,12,19,0,7
D33,Fraud,2015,28,74,0,46
D32,Sexual Violation,2015,2,4,0,2
D33,Robbery-Other,2015,5,6,0,1
D32,Other,2015,13,26,0,13
D32,Sexual Violation,2015,1,1,1,0
D33,Fraud,2015,20,59,0,39
D33,Robbery-Other,2015,3,3,1,0
D32,Other,2015,17,38,0,21
D32,Sexual Violation,2015,11,18,0,7
D33,Fraud,2015,2,11,0,9
D33,Sexual Violation,2015,10,13,0,3
D32,Robbery-Financial,2015,1,1,1,0
D33,Fraud,2015,0,3,0,3
D32,Sexual Violation,2015,7,13,0,6
D33,Sexual Violation,2015,7,9,0,2
D32,Robbery-Financial,2015,1,1,1,0
D32,Sexual Violation,2015,5,8,0,3
D33,Fraud,2015,16,59,0,43
D33,Sexual Violation,2015,5,7,0,2
D32,Robbery-Financial,2015,1,3,0,2
D32,Sexual Violation,2015,3,8,0,5
D33,Fraud,2015,12,44,0,32
D33,Sexual Violation,2015,0,1,0,1
D32,Robbery-Other,2015,1,4,0,3
D32,Sexual Violation,2015,6,12,0,6
D33,Fraud,2015,2,2,1,0
D33,Sexual Violation,2015,3,10,0,7
D32,Robbery-Other,2015,2,7,0,5
D32,Other,2015,1,1,1,0
D33,Fraud,2015,10,31,0,21
D33,Sexual Violation,2015,4,10,0,6
D32,Robbery-Other,2015,1,4,0,3
D32,Other,2015,8,8,1,0
D33,Fraud,2015,8,38,0,30
D33,Sexual Violation,2015,1,1,1,0
D32,Robbery-Other,2015,0,1,0,1
D32,Other,2015,5,5,1,0
D33,Fraud,2015,0,1,0,1
D33,Sexual Violation,2015,5,10,0,5
D32,Robbery-Other,2015,4,8,0,4
D32,Other,2015,2,2,1,0
D33,Fraud,2015,0,2,0,2
D33,Sexual Violation,2015,10,13,0,3
D32,Robbery-Other,2015,0,6,0,6
D32,Other,2015,11,11,1,0
D33,Fraud,2015,12,32,0,20
D33,Sexual Violation,2015,0,1,0,1
D32,Robbery-Other,2015,4,19,0,15
D32,Other,2015,1,1,1,0
D33,Fraud,2015,8,25,0,17
D33,Sexual Violation,2015,1,1,1,0
D32,Robbery-Other,2015,3,12,0,9
D32,Other,2015,8,8,1,0
D33,Fraud,2015,6,23,0,17
D33,Sexual Violation,2015,1,2,0,1
D32,Robbery-Other,2015,1,5,0,4
D32,Other,2015,4,4,1,0
D33,Sexual Violation,2015,6,10,0,4
D33,Fraud,2015,0,1,0,1
D32,Robbery-Other,2015,1,3,0,2
D33,Sexual Violation,2015,5,6,0,1
D33,Fraud,2015,10,31,0,21
D32,Robbery-Other,2015,0,1,0,1
D33,Sexual Violation,2015,1,2,0,1
D33,Other,2015,33,83,0,50
D32,Other,2015,5,5,1,0
D32,Robbery-Other,2015,4,6,0,2
D33,Sexual Violation,2015,0,1,0,1
D33,Other,2015,21,57,0,36
D32,Other,2015,6,6,1,0
D32,Robbery-Other,2015,2,6,0,4
D33,Other,2015,21,22,0,1
D33,Other,2015,7,29,0,22
D32,Other,2015,3,4,0,1
D32,Robbery-Other,2015,3,4,0,1
D33,Other,2015,5,10,0,5
D33,Other,2015,4,8,0,4
D32,Other,2015,3,3,1,0
D32,Robbery-Other,2015,2,6,0,4
D33,Other,2015,6,6,1,0
D33,Other,2015,41,96,0,55
D32,Other,2015,13,13,1,0
D33,Other,2015,14,14,1,0
D33,Other,2015,20,66,0,46
D32,Other,2015,6,6,1,0
D33,Other,2015,0,2,0,2
D32,Other,2015,4,4,1,0
D33,Other,2015,13,36,0,23
D32,Other,2015,4,4,1,0
D33,Other,2015,13,35,0,22
D32,Other,2015,8,8,1,0
D33,Other,2015,0,1,0,1
D32,Other,2015,9,9,1,0
D33,Other,2015,18,44,0,26
D32,Other,2015,10,10,1,0
D33,Other,2015,8,25,0,17
D32,Other,2015,15,15,1,0
D33,Other,2015,6,33,0,27
D32,Other,2015,21,24,0,3
D33,Other,2015,0,1,0,1
D32,Other,2015,9,11,0,2
D33,Other,2015,17,41,0,24
D32,Other,2015,2,2,1,0
D32,Other,2015,9,12,0,3
D32,Other,2015,1,2,0,1
D32,Other,2015,27,29,0,2
D33,Other,2015,0,2,0,2
D33,Theft Over $5000,2015,2,14,0,12
D33,Theft Over $5000,2015,2,8,0,6
D41,Break & Enter-House,2015,15,56,0,41
D41,Break & Enter-House,2015,21,54,0,33
D41,Break & Enter-House,2015,2,9,0,7
D41,Break & Enter-House,2015,8,30,0,22
D41,Break & Enter-House,2015,1,4,0,3
D41,Break & Enter-House,2015,4,13,0,9
D41,Break & Enter-House,2015,3,17,0,14
D41,Break & Enter-House,2015,0,1,0,1
D41,Break & Enter-House,2015,8,17,0,9
D41,Break & Enter-House,2015,7,33,0,26
D41,Break & Enter-Other,2015,1,4,0,3
D41,Break & Enter-Other,2015,1,4,0,3
D41,Break & Enter-Other,2015,1,1,1,0
D41,Break & Enter-Other,2015,0,1,0,1
D41,Break & Enter-Other,2015,1,2,0,1
D41,Break & Enter-Other,2015,0,5,0,5
D41,Break & Enter-Other,2015,0,3,0,3
D41,Fraud,2015,1,10,0,9
D41,Fraud,2015,4,19,0,15
D41,Fraud,2015,9,44,0,35
D41,Fraud,2015,16,65,0,49
D41,Fraud,2015,1,10,0,9
D41,Fraud,2015,20,87,0,67
D41,Fraud,2015,8,24,0,16
D41,Fraud,2015,22,64,0,42
D41,Fraud,2015,3,29,0,26
D41,Fraud,2015,1,2,0,1
D41,Fraud,2015,5,35,0,30
D41,Fraud,2015,0,1,0,1
D41,Fraud,2015,35,115,0,80
D41,Fraud,2015,0,1,0,1
D41,Other,2015,5,10,0,5
D41,Other,2015,12,33,0,21
D41,Other,2015,31,115,0,84
D41,Theft Over $5000,2015,1,3,0,2
D41,Other,2015,73,149,0,76
D41,Other,2015,3,16,0,13
D41,Other,2015,51,114,0,63
D41,Theft Over $5000,2015,1,4,0,3
D41,Other,2015,17,39,0,22
D41,Other Criminal Violations - Offensive Weapons,2015,22,23,0,1
D42,Other,2015,27,66,0,39
D41,Theft Over $5000,2015,5,16,0,11
D42,Break & Enter-Commercial,2015,0,4,0,4
D41,Other,2015,24,62,0,38
D41,Other,2015,41,107,0,66
D41,Other,2015,3,4,0,1
D41,Other,2015,42,116,0,74
D41,Other,2015,85,158,0,73
D41,Theft Over $5000,2015,0,1,0,1
D41,Theft Over $5000,2015,2,4,0,2
D41,Theft Over $5000,2015,1,5,0,4
D41,Theft Over $5000,2015,5,15,0,10
D41,Theft Over $5000,2015,0,2,0,2
D41,Theft Over $5000,2015,1,10,0,9
D41,Theft Over $5000,2015,1,4,0,3
D42,Other,2015,18,31,0,13
D33,Other,2015,1,1,1,0
D42,Break & Enter-Commercial,2015,0,2,0,2
D42,Other,2015,11,50,0,39
D42,Other,2015,9,19,0,10
D41,Other Criminal Violations - Offensive Weapons,2015,21,21,1,0
D41,Theft Under $5000,2015,7,34,0,27
D41,Other,2015,9,10,0,1
D42,Break & Enter-Commercial,2015,0,2,0,2
D42,Other,2015,0,1,0,1
D42,Robbery-Financial,2015,2,2,1,0
D41,Other Criminal Violations - Offensive Weapons,2015,16,18,0,2
D41,Theft Under $5000,2015,42,91,0,49
D41,Other,2015,12,12,1,0
D42,Break & Enter-Commercial,2015,2,6,0,4
D42,Theft Over $5000,2015,0,6,0,6
D42,Robbery-Financial,2015,2,2,1,0
D41,Other,2015,1,1,1,0
D41,Theft Under $5000,2015,58,245,0,187
D41,Other,2015,33,35,0,2
D42,Break & Enter-Commercial,2015,14,53,0,39
D42,Theft Over $5000,2015,1,9,0,8
D42,Robbery-Financial,2015,1,1,1,0
D41,Other,2015,2,2,1,0
D41,Theft Under $5000,2015,128,350,0,222
D41,Other,2015,62,65,0,3
D42,Break & Enter-Commercial,2015,2,12,0,10
D42,Theft Over $5000,2015,2,7,0,5
D42,Robbery-Other,2015,14,34,0,20
D41,Other,2015,3,3,1,0
D41,Theft Under $5000,2015,6,21,0,15
D41,Other,2015,12,12,1,0
D42,Break & Enter-Commercial,2015,0,3,0,3
D42,Theft Over $5000,2015,0,2,0,2
D42,Theft Over $5000,2015,0,1,0,1
D42,Theft Over $5000,2015,0,3,0,3
D42,Theft Over $5000,2015,1,14,0,13
D42,Theft Over $5000,2015,1,6,0,5
D42,Theft Over $5000,2015,2,3,0,1
D42,Theft Over $5000,2015,1,7,0,6
D42,Theft Under $5000,2015,19,104,0,85
D42,Theft Under $5000,2015,81,231,0,150
D42,Theft Under $5000,2015,1,5,0,4
D42,Theft Under $5000,2015,8,57,0,49
D42,Theft Under $5000,2015,16,90,0,74
D42,Theft Under $5000,2015,40,109,0,69
D42,Theft Under $5000,2015,23,103,0,80
D42,Theft Under $5000,2015,129,301,0,172
D42,Theft Under $5000,2015,41,139,0,98
D42,Theft Under $5000,2015,1,6,0,5
D42,Theft Under $5000,2015,9,60,0,51
D42,Theft Under $5000,2015,241,411,0,170
D42,Theft Under $5000,2015,9,54,0,45
D42,Assault,2015,47,67,0,20
D42,Assault,2015,60,94,0,34
D42,Assault,2015,55,82,0,27
D42,Assault,2015,43,59,0,16
D42,Assault,2015,110,171,0,61
D42,Assault,2015,56,81,0,25
D42,Assault,2015,48,72,0,24
D42,Assault,2015,70,100,0,30
D42,Assault,2015,0,4,0,4
D42,Assault,2015,20,29,0,9
D42,Assault,2015,50,76,0,26
D42,Assault,2015,27,36,0,9
D42,Attempt Murder,2015,1,1,1,0
D42,Attempt Murder,2015,0,1,0,1
D42,Other,2015,17,35,0,18
D42,Other,2015,20,49,0,29
D42,Other,2015,21,37,0,16
D42,Other,2015,12,24,0,12
D42,Other,2015,28,56,0,28
D42,Other,2015,20,40,0,20
D42,Other,2015,16,29,0,13
D42,Other,2015,22,36,0,14
D42,Other,2015,2,7,0,5
D42,Other,2015,6,14,0,8
D41,Other,2015,1,1,1,0
D42,Break & Enter-Commercial,2015,7,8,0,1
D42,Robbery-Other,2015,13,21,0,8
D41,Theft Under $5000,2015,56,268,0,212
D41,Other,2015,1,1,1,0
D42,Break & Enter-Commercial,2015,2,6,0,4
D41,Theft Under $5000,2015,10,31,0,21
D42,Robbery-Other,2015,6,15,0,9
D41,Other,2015,1,1,1,0
D41,Theft Under $5000,2015,37,90,0,53
D41,Other,2015,1,1,1,0
D42,Break & Enter-House,2015,4,47,0,43
D41,Other,2015,52,56,0,4
D42,Robbery-Other,2015,8,19,0,11
D41,Theft Under $5000,2015,71,199,0,128
D41,Other,2015,3,4,0,1
D42,Break & Enter-House,2015,6,35,0,29
D41,Other,2015,10,12,0,2
D42,Robbery-Other,2015,7,24,0,17
D41,Theft Under $5000,2015,1,3,0,2
D41,Other,2015,2,2,1,0
D42,Break & Enter-House,2015,9,38,0,29
D41,Other,2015,18,20,0,2
D42,Robbery-Other,2015,6,19,0,13
D41,Theft Under $5000,2015,127,424,0,297
D41,Other,2015,4,4,1,0
D42,Break & Enter-House,2015,3,23,0,20
D42,Break & Enter-House,2015,3,15,0,12
D42,Break & Enter-House,2015,1,10,0,9
D42,Break & Enter-House,2015,16,59,0,43
D42,Break & Enter-House,2015,2,27,0,25
D42,Break & Enter-House,2015,9,53,0,44
D42,Break & Enter-House,2015,8,46,0,38
D42,Break & Enter-House,2015,5,15,0,10
D42,Break & Enter-Other,2015,1,3,0,2
D42,Break & Enter-Other,2015,0,2,0,2
D42,Break & Enter-Other,2015,0,1,0,1
D42,Break & Enter-Other,2015,0,2,0,2
D42,Break & Enter-Other,2015,1,4,0,3
D42,Break & Enter-Other,2015,0,1,0,1
D42,Break & Enter-Other,2015,1,2,0,1
D42,Fraud,2015,17,35,0,18
D42,Fraud,2015,37,76,0,39
D42,Fraud,2015,11,24,0,13
D42,Fraud,2015,16,40,0,24
D42,Fraud,2015,27,49,0,22
D42,Fraud,2015,15,32,0,17
D42,Fraud,2015,27,69,0,42
D42,Fraud,2015,29,57,0,28
D42,Fraud,2015,8,12,0,4
D42,Fraud,2015,6,25,0,19
D42,Fraud,2015,33,65,0,32
D42,Fraud,2015,9,28,0,19
D42,Other,2015,15,57,0,42
D42,Other,2015,22,84,0,62
D42,Other,2015,0,1,0,1
D42,Other,2015,15,53,0,38
D42,Other,2015,17,45,0,28
D42,Other,2015,25,67,0,42
D42,Other,2015,20,75,0,55
D42,Other,2015,24,75,0,51
D42,Other,2015,36,78,0,42
D42,Other,2015,4,7,0,3
D42,Other,2015,8,34,0,26
D42,Robbery-Other,2015,11,33,0,22
D42,Other,2015,20,21,0,1
D41,Theft Under $5000,2015,564,925,0,361
D42,Robbery-Other,2015,17,27,0,10
D41,Other,2015,42,43,0,1
D42,Other,2015,27,29,0,2
D41,Assault,2015,26,31,0,5
D42,Robbery-Other,2015,1,1,1,0
D41,Other,2015,7,7,1,0
D42,Other,2015,13,14,0,1
D42,Other,2015,5,5,1,0
D42,Other,2015,27,28,0,1
D42,Other,2015,22,27,0,5
D42,Other,2015,44,46,0,2
D42,Other,2015,20,22,0,2
D42,Other,2015,4,4,1,0
D42,Other,2015,7,7,1,0
D42,Other,2015,27,29,0,2
D42,Other,2015,6,6,1,0
D42,Auto Theft,2015,2,31,0,29
D42,Auto Theft,2015,2,30,0,28
D42,Auto Theft,2015,0,9,0,9
D42,Auto Theft,2015,1,11,0,10
D42,Auto Theft,2015,1,15,0,14
D42,Auto Theft,2015,2,19,0,17
D42,Auto Theft,2015,1,46,0,45
D42,Auto Theft,2015,2,24,0,22
D42,Auto Theft,2015,0,2,0,2
D42,Auto Theft,2015,0,16,0,16
D42,Auto Theft,2015,0,21,0,21
D42,Auto Theft,2015,0,13,0,13
D42,Break & Enter-Apartment,2015,1,1,1,0
D42,Break & Enter-Apartment,2015,1,9,0,8
D42,Break & Enter-Apartment,2015,1,6,0,5
D42,Break & Enter-Apartment,2015,2,9,0,7
D42,Break & Enter-Apartment,2015,1,4,0,3
D42,Break & Enter-Apartment,2015,1,3,0,2
D42,Break & Enter-Apartment,2015,0,1,0,1
D42,Break & Enter-Apartment,2015,1,1,1,0
D42,Break & Enter-Apartment,2015,0,3,0,3
D42,Break & Enter-Apartment,2015,2,12,0,10
D42,Break & Enter-Apartment,2015,0,2,0,2
D42,Break & Enter-Commercial,2015,2,5,0,3
D42,Break & Enter-Commercial,2015,2,13,0,11
D42,Break & Enter-Commercial,2015,1,1,1,0
D41,Assault,2015,36,49,0,13
D41,Other,2015,56,59,0,3
D42,Robbery-Other,2015,3,9,0,6
D41,Assault,2015,74,118,0,44
D41,Other,2015,43,45,0,2
D42,Robbery-Other,2015,16,31,0,15
D41,Assault,2015,161,238,0,77
D41,Auto Theft,2015,1,8,0,7
D42,Robbery-Other,2015,0,2,0,2
D41,Assault,2015,24,33,0,9
D42,Sexual Violation,2015,6,10,0,4
D41,Auto Theft,2015,4,14,0,10
D41,Assault,2015,89,144,0,55
D41,Auto Theft,2015,1,21,0,20
D42,Sexual Violation,2015,8,12,0,4
D41,Assault,2015,40,62,0,22
D41,Auto Theft,2015,3,36,0,33
D42,Sexual Violation,2015,6,6,1,0
D41,Assault,2015,77,91,0,14
D41,Auto Theft,2015,1,6,0,5
D42,Sexual Violation,2015,3,6,0,3
D41,Assault,2015,157,218,0,61
D41,Auto Theft,2015,1,46,0,45
D42,Sexual Violation,2015,13,18,0,5
D41,Assault,2015,3,4,0,1
D41,Auto Theft,2015,0,8,0,8
D42,Sexual Violation,2015,5,12,0,7
D41,Assault,2015,106,155,0,49
D41,Auto Theft,2015,0,12,0,12
D42,Sexual Violation,2015,3,5,0,2
D41,Assault,2015,0,1,0,1
D41,Auto Theft,2015,0,14,0,14
D42,Sexual Violation,2015,2,5,0,3
D41,Assault,2015,144,197,0,53
D41,Auto Theft,2015,0,17,0,17
D42,Sexual Violation,2015,0,3,0,3
D41,Attempt Murder,2015,0,1,0,1
D41,Auto Theft,2015,4,52,0,48
D42,Sexual Violation,2015,2,3,0,1
D41,Attempt Murder,2015,1,4,0,3
D41,Break & Enter-Apartment,2015,1,2,0,1
D42,Sexual Violation,2015,4,8,0,4
D41,Attempt Murder,2015,1,4,0,3
D41,Break & Enter-Apartment,2015,1,4,0,3
D42,Sexual Violation,2015,1,3,0,2
D41,Other,2015,1,2,0,1
D41,Break & Enter-Apartment,2015,6,12,0,6
D42,Other,2015,17,17,1,0
D41,Other,2015,13,20,0,7
D41,Break & Enter-Apartment,2015,5,29,0,24
D42,Other,2015,23,23,1,0
D41,Other,2015,30,42,0,12
D41,Break & Enter-Apartment,2015,3,6,0,3
D42,Other,2015,1,1,1,0
D41,Other,2015,50,80,0,30
D41,Break & Enter-Apartment,2015,3,26,0,23
D41,Break & Enter-Apartment,2015,3,23,0,20
D41,Break & Enter-Apartment,2015,4,16,0,12
D41,Break & Enter-Apartment,2015,0,9,0,9
D41,Break & Enter-Apartment,2015,3,23,0,20
D41,Break & Enter-Apartment,2015,4,10,0,6
D41,Break & Enter-Commercial,2015,0,2,0,2
D41,Break & Enter-Commercial,2015,1,4,0,3
D41,Break & Enter-Commercial,2015,2,9,0,7
D41,Break & Enter-Commercial,2015,10,28,0,18
D41,Break & Enter-Commercial,2015,0,1,0,1
D41,Break & Enter-Commercial,2015,1,26,0,25
D41,Break & Enter-Commercial,2015,0,1,0,1
D41,Break & Enter-Commercial,2015,1,16,0,15
D41,Break & Enter-Commercial,2015,1,10,0,9
D41,Break & Enter-Commercial,2015,0,1,0,1
D41,Break & Enter-Commercial,2015,10,23,0,13
D41,Break & Enter-Commercial,2015,14,46,0,32
D41,Break & Enter-House,2015,4,8,0,4
D41,Break & Enter-House,2015,2,11,0,9
D41,Other,2015,15,19,0,4
D41,Other,2015,23,50,0,27
D41,Other,2015,11,23,0,12
D41,Other,2015,20,29,0,9
D41,Other,2015,41,62,0,21
D41,Other,2015,27,46,0,19
D41,Other,2015,38,67,0,29
D41,Robbery-Financial,2015,3,3,1,0
D41,Robbery-Other,2015,8,9,0,1
D41,Robbery-Other,2015,10,16,0,6
D41,Robbery-Other,2015,6,23,0,17
D41,Robbery-Other,2015,13,36,0,23
D41,Robbery-Other,2015,3,7,0,4
D41,Robbery-Other,2015,10,30,0,20
D41,Robbery-Other,2015,6,18,0,12
D42,Other,2015,8,8,1,0
D42,Other,2015,4,4,1,0
D42,Other,2015,25,25,1,0
D42,Other,2015,9,9,1,0
D42,Other,2015,33,33,1,0
D42,Other,2015,21,22,0,1
D42,Other,2015,3,3,1,0
D42,Other,2015,3,3,1,0
D42,Other,2015,8,8,1,0
D42,Other,2015,6,6,1,0
D42,Other,2015,40,51,0,11
D42,Other,2015,57,66,0,9
D42,Other,2015,1,1,1,0
D42,Other,2015,10,10,1,0
D42,Other,2015,2,2,1,0
D42,Other,2015,27,28,0,1
D42,Other,2015,42,49,0,7
D42,Other,2015,63,72,0,9
D41,Robbery-Other,2015,7,15,0,8
D41,Robbery-Other,2015,22,61,0,39
D41,Robbery-Other,2015,6,30,0,24
D41,Robbery-Other,2015,7,30,0,23
D41,Sexual Violation,2015,3,3,1,0
D41,Sexual Violation,2015,8,10,0,2
D41,Sexual Violation,2015,9,14,0,5
D41,Sexual Violation,2015,7,13,0,6
D41,Sexual Violation,2015,2,5,0,3
D41,Sexual Violation,2015,9,19,0,10
D41,Sexual Violation,2015,5,6,0,1
D41,Sexual Violation,2015,6,8,0,2
D41,Sexual Violation,2015,12,22,0,10
D41,Sexual Violation,2015,1,4,0,3
D41,Sexual Violation,2015,1,3,0,2
D41,Sexual Violation,2015,34,45,0,11
D41,Other,2015,3,3,1,0
D41,Other,2015,13,13,1,0
D41,Other,2015,7,7,1,0
D41,Other,2015,32,32,1,0
D41,Other,2015,4,4,1,0
D41,Other,2015,29,29,1,0
D41,Other,2015,3,3,1,0
D41,Other,2015,11,11,1,0
D41,Other,2015,12,12,1,0
D41,Other,2015,9,9,1,0
D41,Other,2015,21,21,1,0
D41,Other,2015,0,1,0,1
D41,Other,2015,15,16,0,1
D41,Other,2015,24,28,0,4
D41,Other,2015,70,78,0,8
D41,Other,2015,1,1,1,0
D41,Other,2015,416,427,0,11
D41,Other,2015,19,20,0,1
D41,Other,2015,154,160,0,6
D41,Other,2015,39,40,0,1
D41,Other,2015,67,74,0,7
D41,Other,2015,123,136,0,13
D41,Other,2015,5,6,0,1
D41,Other,2015,103,111,0,8
D41,Other,2015,150,166,0,16
D41,Other,2015,2,2,1,0
D41,Other Criminal Violations - Offensive Weapons,2015,4,4,1,0
D41,Other Criminal Violations - Offensive Weapons,2015,3,4,0,1
D41,Other Criminal Violations - Offensive Weapons,2015,7,10,0,3
D41,Other Criminal Violations - Offensive Weapons,2015,26,29,0,3
D41,Other Criminal Violations - Offensive Weapons,2015,5,6,0,1
D41,Other Criminal Violations - Offensive Weapons,2015,10,12,0,2
D41,Other Criminal Violations - Offensive Weapons,2015,7,8,0,1
D41,Other Criminal Violations - Offensive Weapons,2015,8,9,0,1
D43,Robbery-Other,2015,28,38,0,10
D43,Robbery-Other,2015,0,3,0,3
D43,Robbery-Other,2015,7,12,0,5
D43,Robbery-Other,2015,8,23,0,15
D43,Robbery-Other,2015,25,49,0,24
D43,Robbery-Other,2015,2,6,0,4
D43,Robbery-Other,2015,2,2,1,0
D43,Robbery-Other,2015,16,29,0,13
D43,Robbery-Other,2015,12,22,0,10
D43,Robbery-Other,2015,11,29,0,18
D43,Robbery-Other,2015,31,54,0,23
D43,Robbery-Other,2015,2,4,0,2
D43,Robbery-Other,2015,8,36,0,28
D43,Sexual Violation,2015,3,4,0,1
D43,Sexual Violation,2015,5,7,0,2
D43,Sexual Violation,2015,4,4,1,0
D43,Sexual Violation,2015,3,7,0,4
D43,Sexual Violation,2015,9,11,0,2
D43,Sexual Violation,2015,6,14,0,8
D43,Sexual Violation,2015,1,1,1,0
D43,Sexual Violation,2015,2,5,0,3
D43,Sexual Violation,2015,0,1,0,1
D43,Break & Enter-Other,2015,0,1,0,1
D43,Sexual Violation,2015,7,15,0,8
D43,Sexual Violation,2015,1,2,0,1
D43,Sexual Violation,2015,1,1,1,0
D43,Break & Enter-Other,2015,1,5,0,4
D43,Sexual Violation,2015,8,12,0,4
D43,Fraud,2015,21,31,0,10
D43,Sexual Violation,2015,32,53,0,21
D43,Fraud,2015,43,77,0,34
D43,Sexual Violation,2015,2,3,0,1
D43,Sexual Violation,2015,14,19,0,5
D43,Other,2015,7,7,1,0
D43,Other,2015,10,10,1,0
D43,Other,2015,4,4,1,0
D43,Other,2015,9,9,1,0
D43,Other,2015,10,10,1,0
D43,Other,2015,12,12,1,0
D43,Other,2015,1,1,1,0
D43,Other,2015,7,7,1,0
D43,Other,2015,7,7,1,0
D43,Other,2015,1,1,1,0
D43,Other,2015,8,9,0,1
D43,Other,2015,24,24,1,0
D43,Other,2015,0,1,0,1
D43,Other,2015,19,19,1,0
D43,Other,2015,18,21,0,3
D43,Other,2015,79,90,0,11
D43,Other,2015,13,19,0,6
D43,Other,2015,35,35,1,0
D43,Other,2015,52,56,0,4
D43,Other,2015,67,72,0,5
D43,Other,2015,112,123,0,11
D42,Other,2015,33,35,0,2
D43,Fraud,2015,10,26,0,16
D51,Break & Enter-Apartment,2015,4,41,0,37
D51,Break & Enter-Apartment,2015,4,16,0,12
D51,Break & Enter-Apartment,2015,10,30,0,20
D51,Break & Enter-Apartment,2015,1,2,0,1
D51,Break & Enter-Apartment,2015,25,58,0,33
D51,Break & Enter-Apartment,2015,0,14,0,14
D51,Break & Enter-Apartment,2015,1,6,0,5
D51,Break & Enter-Commercial,2015,1,1,1,0
D51,Break & Enter-Commercial,2015,3,13,0,10
D51,Break & Enter-Commercial,2015,6,27,0,21
D51,Break & Enter-Commercial,2015,4,58,0,54
D51,Break & Enter-Commercial,2015,6,44,0,38
D51,Break & Enter-Commercial,2015,3,8,0,5
D51,Break & Enter-Commercial,2015,0,4,0,4
D51,Break & Enter-Commercial,2015,2,21,0,19
D51,Break & Enter-House,2015,4,15,0,11
D43,Fraud,2015,11,18,0,7
D43,Other,2015,12,13,0,1
D51,Break & Enter-House,2015,0,1,0,1
D43,Fraud,2015,20,37,0,17
D51,Break & Enter-House,2015,1,11,0,10
D43,Other,2015,2,2,1,0
D43,Fraud,2015,26,55,0,29
D51,Break & Enter-House,2015,0,1,0,1
D43,Other,2015,21,28,0,7
D43,Fraud,2015,6,18,0,12
D43,Fraud,2015,12,31,0,19
D43,Fraud,2015,7,32,0,25
D43,Fraud,2015,0,2,0,2
D43,Fraud,2015,11,26,0,15
D43,Fraud,2015,65,109,0,44
D43,Fraud,2015,7,18,0,11
D43,Fraud,2015,29,66,0,37
D43,Other,2015,4,18,0,14
D43,Other,2015,40,78,0,38
D43,Other,2015,9,38,0,29
D43,Other,2015,23,48,0,25
D43,Other,2015,33,63,0,30
D43,Other,2015,51,106,0,55
D43,Other,2015,9,28,0,19
D43,Other,2015,20,65,0,45
D43,Other,2015,1,1,1,0
D43,Other,2015,23,57,0,34
D43,Other,2015,3,3,1,0
D43,Other,2015,23,58,0,35
D43,Other,2015,89,168,0,79
D43,Other,2015,4,21,0,17
D43,Other,2015,40,117,0,77
D43,Theft Over $5000,2015,0,1,0,1
D43,Theft Over $5000,2015,3,4,0,1
D43,Theft Over $5000,2015,0,1,0,1
D43,Theft Over $5000,2015,1,3,0,2
D43,Theft Over $5000,2015,2,3,0,1
D43,Theft Over $5000,2015,2,6,0,4
D43,Theft Over $5000,2015,0,2,0,2
D43,Theft Over $5000,2015,1,5,0,4
D43,Theft Over $5000,2015,0,1,0,1
D43,Theft Over $5000,2015,1,2,0,1
D43,Theft Over $5000,2015,1,6,0,5
D43,Theft Over $5000,2015,0,2,0,2
D43,Theft Over $5000,2015,2,8,0,6
D43,Theft Under $5000,2015,7,38,0,31
D43,Theft Under $5000,2015,448,632,0,184
D43,Theft Under $5000,2015,3,27,0,24
D43,Theft Under $5000,2015,29,116,0,87
D43,Theft Under $5000,2015,68,135,0,67
D43,Theft Under $5000,2015,108,235,0,127
D43,Other,2015,67,74,0,7
D51,Break & Enter-House,2015,0,5,0,5
D42,Other,2015,41,56,0,15
D43,Other,2015,10,11,0,1
D42,Other,2015,40,45,0,5
D43,Other,2015,85,92,0,7
D51,Break & Enter-House,2015,0,1,0,1
D51,Break & Enter-Other,2015,2,5,0,3
D51,Break & Enter-Other,2015,0,4,0,4
D51,Break & Enter-Other,2015,3,9,0,6
D51,Break & Enter-Other,2015,2,14,0,12
D51,Break & Enter-Other,2015,0,1,0,1
D51,Break & Enter-Other,2015,1,5,0,4
D51,Break & Enter-Other,2015,1,7,0,6
D51,Break & Enter-Other,2015,1,2,0,1
D51,Fraud,2015,8,27,0,19
D51,Fraud,2015,23,97,0,74
D51,Fraud,2015,36,133,0,97
D51,Fraud,2015,30,103,0,73
D51,Fraud,2015,3,3,1,0
D51,Fraud,2015,8,44,0,36
D51,Fraud,2015,3,26,0,23
D51,Fraud,2015,3,6,0,3
D51,Fraud,2015,9,50,0,41
D51,Other,2015,33,88,0,55
D51,Other,2015,61,129,0,68
D51,Other,2015,98,214,0,116
D51,Other,2015,100,222,0,122
D51,Other,2015,5,8,0,3
D51,Other,2015,32,117,0,85
D51,Theft Over $5000,2015,3,11,0,8
D43,Other,2015,269,292,0,23
D51,Theft Over $5000,2015,0,14,0,14
D51,Other,2015,23,64,0,41
D42,Other,2015,5,5,1,0
D42,Other,2015,7,8,0,1
D42,Other,2015,58,63,0,5
D42,Other,2015,23,25,0,2
D42,Other,2015,1,1,1,0
D42,Other Criminal Violations - Offensive Weapons,2015,7,7,1,0
D42,Other Criminal Violations - Offensive Weapons,2015,8,9,0,1
D42,Other Criminal Violations - Offensive Weapons,2015,7,7,1,0
D42,Other Criminal Violations - Offensive Weapons,2015,5,5,1,0
D42,Other Criminal Violations - Offensive Weapons,2015,17,19,0,2
D42,Other Criminal Violations - Offensive Weapons,2015,4,4,1,0
D42,Other Criminal Violations - Offensive Weapons,2015,10,10,1,0
D42,Other Criminal Violations - Offensive Weapons,2015,7,7,1,0
D42,Other Criminal Violations - Offensive Weapons,2015,2,3,0,1
D42,Other Criminal Violations - Offensive Weapons,2015,11,12,0,1
D42,Other Criminal Violations - Offensive Weapons,2015,5,5,1,0
D42,Other,2015,2,2,1,0
D42,Other,2015,1,1,1,0
D42,Other,2015,3,3,1,0
D42,Other,2015,2,2,1,0
D42,Other,2015,3,4,0,1
D42,Other,2015,2,2,1,0
D42,Other,2015,2,2,1,0
D42,Other,2015,3,3,1,0
D42,Other,2015,1,1,1,0
D43,Other,2015,5,5,1,0
D43,Other,2015,31,34,0,3
D43,Other,2015,5,6,0,1
D43,Other,2015,12,12,1,0
D43,Other,2015,32,32,1,0
D43,Other,2015,47,51,0,4
D43,Other,2015,1,2,0,1
D43,Other,2015,11,13,0,2
D43,Other,2015,21,23,0,2
D43,Other,2015,1,1,1,0
D43,Other,2015,44,44,1,0
D43,Other,2015,71,72,0,1
D43,Other,2015,3,3,1,0
D43,Other,2015,29,31,0,2
D43,Auto Theft,2015,0,6,0,6
D43,Auto Theft,2015,1,23,0,22
D43,Auto Theft,2015,1,7,0,6
D43,Auto Theft,2015,3,7,0,4
D43,Auto Theft,2015,5,15,0,10
D43,Auto Theft,2015,3,21,0,18
D43,Auto Theft,2015,1,13,0,12
D43,Auto Theft,2015,6,17,0,11
D51,Other,2015,1,4,0,3
D43,Other,2015,11,13,0,2
D51,Theft Over $5000,2015,1,2,0,1
D51,Theft Over $5000,2015,1,3,0,2
D51,Theft Over $5000,2015,0,5,0,5
D51,Theft Over $5000,2015,0,2,0,2
D51,Theft Over $5000,2015,2,12,0,10
D51,Theft Under $5000,2015,0,1,0,1
D51,Theft Under $5000,2015,64,368,0,304
D51,Theft Under $5000,2015,227,627,0,400
D51,Theft Under $5000,2015,0,1,0,1
D51,Theft Under $5000,2015,1,1,1,0
D51,Theft Under $5000,2015,110,785,0,675
D51,Theft Under $5000,2015,0,1,0,1
D51,Theft Under $5000,2015,1,1,1,0
D51,Theft Under $5000,2015,134,682,0,548
D51,Theft Under $5000,2015,5,29,0,24
D51,Theft Under $5000,2015,51,263,0,212
D51,Theft Under $5000,2015,22,164,0,142
D51,Theft Under $5000,2015,4,48,0,44
D51,Theft Under $5000,2015,77,352,0,275
D51,Theft Under $5000,2015,0,1,0,1
D51,Theft Under $5000,2015,0,3,0,3
D51,Theft Under $5000,2015,0,1,0,1
D51,Assault,2015,61,93,0,32
D51,Assault,2015,111,165,0,54
D51,Assault,2015,198,288,0,90
D51,Assault,2015,215,335,0,120
D51,Assault,2015,3,6,0,3
D51,Assault,2015,103,139,0,36
D51,Assault,2015,72,88,0,16
D51,Assault,2015,9,14,0,5
D51,Assault,2015,62,93,0,31
D51,Assault,2015,0,1,0,1
D51,Attempt Murder,2015,1,1,1,0
D51,Attempt Murder,2015,1,1,1,0
D51,Attempt Murder,2015,1,4,0,3
D51,Attempt Murder,2015,1,2,0,1
D51,Attempt Murder,2015,1,1,1,0
D51,Other,2015,13,25,0,12
D51,Other,2015,22,41,0,19
D51,Other,2015,34,59,0,25
D51,Other,2015,33,70,0,37
D51,Other,2015,2,2,1,0
D51,Other,2015,23,38,0,15
D51,Other,2015,13,29,0,16
D51,Other,2015,14,25,0,11
D51,Robbery-Financial,2015,2,2,1,0
D51,Robbery-Other,2015,4,12,0,8
D51,Robbery-Other,2015,22,34,0,12
D43,Other,2015,74,78,0,4
D51,Other,2015,30,85,0,55
D43,Auto Theft,2015,0,2,0,2
D43,Theft Under $5000,2015,23,80,0,57
D43,Theft Under $5000,2015,1,1,1,0
D43,Other Criminal Violations - Offensive Weapons,2015,4,4,1,0
D43,Theft Under $5000,2015,19,122,0,103
D43,Auto Theft,2015,0,16,0,16
D43,Other Criminal Violations - Offensive Weapons,2015,20,21,0,1
D43,Theft Under $5000,2015,22,80,0,58
D43,Auto Theft,2015,2,21,0,19
D43,Other Criminal Violations - Offensive Weapons,2015,1,1,1,0
D51,Other,2015,1,1,1,0
D43,Theft Under $5000,2015,0,2,0,2
D43,Auto Theft,2015,1,16,0,15
D43,Other Criminal Violations - Offensive Weapons,2015,4,4,1,0
D51,Theft Over $5000,2015,0,5,0,5
D43,Theft Under $5000,2015,125,200,0,75
D43,Auto Theft,2015,5,19,0,14
D43,Other Criminal Violations - Offensive Weapons,2015,16,18,0,2
D51,Theft Over $5000,2015,0,5,0,5
D43,Theft Under $5000,2015,0,1,0,1
D43,Break & Enter-Apartment,2015,0,4,0,4
D43,Other Criminal Violations - Offensive Weapons,2015,22,25,0,3
D43,Theft Under $5000,2015,135,307,0,172
D43,Break & Enter-Apartment,2015,1,2,0,1
D43,Other Criminal Violations - Offensive Weapons,2015,2,2,1,0
D43,Theft Under $5000,2015,1,35,0,34
D43,Break & Enter-Apartment,2015,2,3,0,1
D43,Other Criminal Violations - Offensive Weapons,2015,3,9,0,6
D43,Theft Under $5000,2015,28,172,0,144
D43,Break & Enter-Apartment,2015,2,27,0,25
D43,Other Criminal Violations - Offensive Weapons,2015,14,16,0,2
D43,Assault,2015,24,33,0,9
D43,Break & Enter-Apartment,2015,4,26,0,22
D43,Break & Enter-Apartment,2015,1,2,0,1
D43,Break & Enter-Apartment,2015,1,7,0,6
D43,Break & Enter-Apartment,2015,7,18,0,11
D43,Break & Enter-Apartment,2015,13,23,0,10
D43,Break & Enter-Apartment,2015,0,1,0,1
D43,Break & Enter-Apartment,2015,6,35,0,29
D43,Break & Enter-Commercial,2015,1,2,0,1
D43,Break & Enter-Commercial,2015,3,5,0,2
D43,Break & Enter-Commercial,2015,1,4,0,3
D43,Break & Enter-Commercial,2015,2,8,0,6
D43,Break & Enter-Commercial,2015,0,4,0,4
D43,Break & Enter-Commercial,2015,3,6,0,3
D43,Break & Enter-Commercial,2015,0,5,0,5
D43,Break & Enter-Commercial,2015,1,1,1,0
D43,Break & Enter-Commercial,2015,9,18,0,9
D43,Break & Enter-Commercial,2015,5,12,0,7
D43,Break & Enter-Commercial,2015,0,1,0,1
D43,Break & Enter-Commercial,2015,9,21,0,12
D43,Break & Enter-House,2015,3,11,0,8
D43,Break & Enter-House,2015,2,7,0,5
D43,Break & Enter-House,2015,2,7,0,5
D43,Break & Enter-House,2015,5,28,0,23
D43,Break & Enter-House,2015,2,17,0,15
D43,Break & Enter-House,2015,8,25,0,17
D43,Break & Enter-House,2015,1,16,0,15
D43,Break & Enter-House,2015,9,29,0,20
D43,Break & Enter-House,2015,1,12,0,11
D43,Break & Enter-House,2015,3,10,0,7
D43,Break & Enter-House,2015,0,1,0,1
D43,Break & Enter-House,2015,6,26,0,20
D43,Break & Enter-House,2015,4,7,0,3
D43,Break & Enter-House,2015,11,27,0,16
D43,Break & Enter-Other,2015,1,2,0,1
D43,Break & Enter-Other,2015,1,2,0,1
D43,Break & Enter-Other,2015,1,2,0,1
D43,Break & Enter-Other,2015,0,2,0,2
D43,Break & Enter-Other,2015,0,2,0,2
D43,Break & Enter-Other,2015,0,2,0,2
D43,Break & Enter-Other,2015,2,2,1,0
D43,Break & Enter-Other,2015,0,5,0,5
D43,Assault,2015,59,82,0,23
D43,Assault,2015,28,35,0,7
D43,Assault,2015,35,50,0,15
D43,Assault,2015,71,90,0,19
D43,Assault,2015,160,199,0,39
D43,Assault,2015,22,35,0,13
D43,Assault,2015,34,42,0,8
D43,Assault,2015,84,126,0,42
D43,Assault,2015,3,4,0,1
D43,Assault,2015,97,131,0,34
D43,Assault,2015,269,348,0,79
D43,Assault,2015,12,14,0,2
D43,Assault,2015,107,143,0,36
D43,Attempt Murder,2015,0,2,0,2
D43,Attempt Murder,2015,0,2,0,2
D43,Attempt Murder,2015,1,1,1,0
D43,Attempt Murder,2015,2,2,1,0
D43,Attempt Murder,2015,3,3,1,0
D43,Attempt Murder,2015,1,1,1,0
D43,Other,2015,8,11,0,3
D43,Other,2015,20,30,0,10
D43,Other,2015,10,17,0,7
D43,Other,2015,28,33,0,5
D43,Other,2015,18,29,0,11
D43,Other,2015,2,2,1,0
D43,Other,2015,46,83,0,37
D43,Other,2015,11,18,0,7
D43,Other,2015,20,33,0,13
D43,Other,2015,24,56,0,32
D43,Other,2015,0,1,0,1
D43,Other,2015,31,56,0,25
D43,Other,2015,68,117,0,49
D43,Other,2015,9,12,0,3
D43,Other,2015,38,67,0,29
D43,Robbery-Financial,2015,3,3,1,0
D43,Robbery-Financial,2015,1,1,1,0
D43,Robbery-Financial,2015,2,2,1,0
D43,Robbery-Financial,2015,2,2,1,0
D43,Robbery-Other,2015,1,3,0,2
D43,Other Criminal Violations - Offensive Weapons,2015,7,12,0,5
D43,Other Criminal Violations - Offensive Weapons,2015,46,48,0,2
D43,Other Criminal Violations - Offensive Weapons,2015,1,1,1,0
D43,Other Criminal Violations - Offensive Weapons,2015,22,24,0,2
D43,Other,2015,1,1,1,0
D43,Other,2015,2,2,1,0
D43,Other,2015,1,1,1,0
D43,Other,2015,2,2,1,0
D43,Other,2015,0,1,0,1
D43,Other,2015,1,1,1,0
D43,Other,2015,3,4,0,1
D43,Other,2015,6,6,1,0
D43,Other,2015,1,1,1,0
D43,Other,2015,2,2,1,0
D51,Other,2015,31,32,0,1
D51,Other,2015,47,48,0,1
D51,Other,2015,72,73,0,1
D51,Other,2015,226,231,0,5
D51,Other,2015,3,4,0,1
D51,Other,2015,49,53,0,4
D51,Other,2015,26,27,0,1
D51,Other,2015,14,16,0,2
D51,Auto Theft,2015,1,8,0,7
D51,Auto Theft,2015,0,10,0,10
D51,Auto Theft,2015,3,17,0,14
D51,Auto Theft,2015,2,21,0,19
D51,Auto Theft,2015,0,1,0,1
D51,Auto Theft,2015,1,10,0,9
D51,Auto Theft,2015,6,14,0,8
D51,Auto Theft,2015,1,4,0,3
D51,Auto Theft,2015,1,7,0,6
D51,Break & Enter-Apartment,2015,5,35,0,30
D52,Other,2015,24,34,0,10
D52,Other,2015,147,155,0,8
D52,Other,2015,1505,1526,0,21
D52,Other Criminal Violations - Offensive Weapons,2015,12,13,0,1
D52,Other Criminal Violations - Offensive Weapons,2015,2,2,1,0
D52,Other Criminal Violations - Offensive Weapons,2015,12,12,1,0
D52,Other Criminal Violations - Offensive Weapons,2015,10,10,1,0
D52,Other Criminal Violations - Offensive Weapons,2015,10,11,0,1
D52,Other Criminal Violations - Offensive Weapons,2015,6,6,1,0
D52,Other Criminal Violations - Offensive Weapons,2015,1,1,1,0
D52,Other Criminal Violations - Offensive Weapons,2015,17,18,0,1
D52,Other Criminal Violations - Offensive Weapons,2015,36,40,0,4
D52,Other,2015,6,7,0,1
D52,Other,2015,1,1,1,0
D52,Other,2015,3,3,1,0
D52,Other,2015,5,6,0,1
D52,Other,2015,1,1,1,0
D52,Other,2015,1,1,1,0
D52,Other,2015,1,1,1,0
D52,Other,2015,4,4,1,0
D52,Other,2015,5,7,0,2
D53,Other,2015,26,27,0,1
D53,Other,2015,2,2,1,0
D53,Other,2015,4,4,1,0
D53,Other,2015,2,2,1,0
D53,Other,2015,2,2,1,0
D53,Other,2015,1,1,1,0
D53,Other,2015,4,5,0,1
D53,Other,2015,3,3,1,0
D53,Other,2015,2,5,0,3
D53,Other,2015,1,1,1,0
D53,Other,2015,3,3,1,0
D53,Other,2015,17,17,1,0
D53,Other,2015,9,9,1,0
D53,Other,2015,16,16,1,0
D53,Other,2015,8,8,1,0
D53,Other,2015,3,3,1,0
D53,Auto Theft,2015,2,9,0,7
D53,Auto Theft,2015,2,5,0,3
D52,Fraud,2015,17,80,0,63
D53,Auto Theft,2015,0,6,0,6
D53,Auto Theft,2015,0,1,0,1
D53,Auto Theft,2015,1,7,0,6
D53,Auto Theft,2015,2,5,0,3
D53,Auto Theft,2015,13,28,0,15
D53,Auto Theft,2015,2,14,0,12
D53,Auto Theft,2015,1,5,0,4
D53,Auto Theft,2015,0,1,0,1
D53,Auto Theft,2015,0,1,0,1
D53,Auto Theft,2015,0,1,0,1
D53,Auto Theft,2015,11,27,0,16
D52,Other,2015,4,5,0,1
D53,Break & Enter-Other,2015,0,3,0,3
D53,Auto Theft,2015,1,4,0,3
D53,Theft Over $5000,2015,0,3,0,3
D51,Robbery-Other,2015,31,69,0,38
D52,Other,2015,15,19,0,4
D52,Other,2015,11,21,0,10
D53,Break & Enter-Other,2015,0,1,0,1
D53,Auto Theft,2015,0,12,0,12
D53,Theft Over $5000,2015,2,6,0,4
D51,Robbery-Other,2015,41,128,0,87
D52,Other,2015,12,14,0,2
D52,Other,2015,22,42,0,20
D53,Break & Enter-Other,2015,1,4,0,3
D52,Fraud,2015,103,295,0,192
D53,Auto Theft,2015,4,10,0,6
D53,Theft Over $5000,2015,0,1,0,1
D51,Robbery-Other,2015,0,2,0,2
D52,Other,2015,12,17,0,5
D52,Other,2015,2,4,0,2
D53,Fraud,2015,33,104,0,71
D52,Other,2015,47,86,0,39
D53,Auto Theft,2015,2,3,0,1
D53,Theft Over $5000,2015,1,5,0,4
D51,Robbery-Other,2015,9,29,0,20
D52,Other,2015,41,42,0,1
D52,Other,2015,10,19,0,9
D53,Fraud,2015,1,1,1,0
D52,Other,2015,2,7,0,5
D53,Break & Enter-Apartment,2015,8,29,0,21
D53,Theft Over $5000,2015,1,5,0,4
D51,Robbery-Other,2015,6,16,0,10
D52,Other,2015,1,1,1,0
D52,Other,2015,9,19,0,10
D53,Fraud,2015,2,9,0,7
D52,Other,2015,14,19,0,5
D53,Break & Enter-Apartment,2015,1,2,0,1
D53,Theft Under $5000,2015,132,559,0,427
D51,Robbery-Other,2015,0,2,0,2
D52,Other,2015,21,22,0,1
D52,Other,2015,21,42,0,21
D53,Fraud,2015,1,6,0,5
D53,Fraud,2015,2,12,0,10
D53,Fraud,2015,1,7,0,6
D53,Fraud,2015,1,7,0,6
D53,Fraud,2015,1,14,0,13
D53,Fraud,2015,3,17,0,14
D53,Fraud,2015,2,23,0,21
D53,Fraud,2015,0,2,0,2
D53,Fraud,2015,4,23,0,19
D53,Fraud,2015,19,77,0,58
D53,Fraud,2015,9,39,0,30
D53,Fraud,2015,0,1,0,1
D53,Fraud,2015,17,49,0,32
D53,Fraud,2015,15,58,0,43
D53,Fraud,2015,7,28,0,21
D53,Other,2015,38,116,0,78
D53,Other,2015,0,1,0,1
D53,Other,2015,1,10,0,9
D53,Other,2015,1,15,0,14
D53,Other,2015,3,17,0,14
D53,Other,2015,2,2,1,0
D53,Other,2015,1,8,0,7
D53,Other,2015,1,9,0,8
D53,Other,2015,8,34,0,26
D53,Other,2015,6,31,0,25
D53,Other,2015,2,29,0,27
D53,Other,2015,1,7,0,6
D53,Other,2015,1,1,1,0
D53,Other,2015,16,35,0,19
D53,Other,2015,39,90,0,51
D53,Other,2015,17,56,0,39
D53,Other,2015,16,56,0,40
D53,Other,2015,1,5,0,4
D53,Other,2015,22,57,0,35
D53,Other,2015,7,29,0,22
D53,Theft Over $5000,2015,3,17,0,14
D53,Theft Over $5000,2015,0,1,0,1
D53,Theft Over $5000,2015,0,2,0,2
D53,Theft Over $5000,2015,0,3,0,3
D53,Theft Over $5000,2015,0,5,0,5
D53,Theft Over $5000,2015,1,3,0,2
D53,Theft Over $5000,2015,0,1,0,1
D53,Theft Over $5000,2015,2,3,0,1
D53,Theft Over $5000,2015,2,9,0,7
D52,Other,2015,49,98,0,49
D52,Other,2015,42,85,0,43
D52,Other,2015,8,8,1,0
D53,Theft Under $5000,2015,1,11,0,10
D51,Robbery-Other,2015,0,7,0,7
D53,Break & Enter-Apartment,2015,1,3,0,2
D52,Other,2015,53,56,0,3
D53,Theft Under $5000,2015,4,16,0,12
D52,Other,2015,48,141,0,93
D52,Robbery-Financial,2015,1,1,1,0
D52,Other,2015,63,67,0,4
D53,Theft Under $5000,2015,3,34,0,31
D52,Other,2015,0,5,0,5
D51,Sexual Violation,2015,4,14,0,10
D53,Break & Enter-Apartment,2015,0,4,0,4
D52,Auto Theft,2015,1,5,0,4
D53,Theft Under $5000,2015,1,1,1,0
D52,Other,2015,19,58,0,39
D51,Sexual Violation,2015,11,23,0,12
D52,Robbery-Financial,2015,1,1,1,0
D53,Break & Enter-Apartment,2015,0,3,0,3
D52,Auto Theft,2015,0,1,0,1
D53,Theft Under $5000,2015,0,31,0,31
D52,Other,2015,13,79,0,66
D51,Sexual Violation,2015,26,41,0,15
D52,Robbery-Financial,2015,7,7,1,0
D53,Break & Enter-Apartment,2015,3,7,0,4
D52,Auto Theft,2015,0,3,0,3
D53,Theft Under $5000,2015,2,6,0,4
D52,Other,2015,70,160,0,90
D51,Sexual Violation,2015,25,55,0,30
D52,Robbery-Other,2015,2,14,0,12
D53,Break & Enter-Apartment,2015,1,1,1,0
D52,Auto Theft,2015,0,6,0,6
D53,Theft Under $5000,2015,1,21,0,20
D52,Other,2015,0,1,0,1
D51,Sexual Violation,2015,1,3,0,2
D52,Robbery-Other,2015,8,12,0,4
D53,Break & Enter-Apartment,2015,0,3,0,3
D52,Auto Theft,2015,2,13,0,11
D53,Theft Under $5000,2015,0,15,0,15
D52,Other,2015,156,278,0,122
D51,Sexual Violation,2015,8,18,0,10
D52,Robbery-Other,2015,4,6,0,2
D53,Break & Enter-Apartment,2015,1,30,0,29
D52,Auto Theft,2015,0,6,0,6
D53,Theft Under $5000,2015,19,83,0,64
D52,Theft Over $5000,2015,2,13,0,11
D51,Sexual Violation,2015,4,8,0,4
D53,Break & Enter-Apartment,2015,2,8,0,6
D52,Robbery-Other,2015,8,17,0,9
D52,Auto Theft,2015,1,2,0,1
D53,Theft Under $5000,2015,22,106,0,84
D51,Sexual Violation,2015,4,11,0,7
D52,Theft Over $5000,2015,2,11,0,9
D52,Auto Theft,2015,4,22,0,18
D53,Theft Under $5000,2015,26,124,0,98
D53,Break & Enter-Apartment,2015,4,19,0,15
D51,Other,2015,4,4,1,0
D52,Theft Over $5000,2015,2,29,0,27
D52,Robbery-Other,2015,1,2,0,1
D52,Auto Theft,2015,1,34,0,33
D53,Theft Under $5000,2015,0,10,0,10
D53,Break & Enter-Apartment,2015,3,10,0,7
D51,Other,2015,10,10,1,0
D52,Theft Over $5000,2015,0,1,0,1
D52,Robbery-Other,2015,1,5,0,4
D52,Break & Enter-Apartment,2015,5,12,0,7
D53,Theft Under $5000,2015,0,2,0,2
D53,Break & Enter-Apartment,2015,1,6,0,5
D51,Other,2015,5,5,1,0
D52,Theft Over $5000,2015,2,7,0,5
D52,Robbery-Other,2015,1,4,0,3
D52,Break & Enter-Apartment,2015,4,8,0,4
D53,Theft Under $5000,2015,9,72,0,63
D53,Break & Enter-Apartment,2015,1,9,0,8
D51,Other,2015,19,20,0,1
D52,Theft Over $5000,2015,1,6,0,5
D52,Robbery-Other,2015,11,20,0,9
D52,Break & Enter-Apartment,2015,9,29,0,20
D53,Theft Under $5000,2015,286,556,0,270
D53,Break & Enter-Commercial,2015,3,25,0,22
D51,Other,2015,2,2,1,0
D52,Theft Over $5000,2015,3,9,0,6
D52,Robbery-Other,2015,20,39,0,19
D52,Break & Enter-Apartment,2015,2,3,0,1
D53,Theft Under $5000,2015,26,118,0,92
D53,Break & Enter-Commercial,2015,0,1,0,1
D51,Other,2015,1,1,1,0
D52,Theft Over $5000,2015,6,30,0,24
D52,Sexual Violation,2015,4,11,0,7
D52,Break & Enter-Apartment,2015,0,5,0,5
D51,Other,2015,7,7,1,0
D53,Theft Under $5000,2015,168,277,0,109
D51,Other,2015,6,6,1,0
D53,Break & Enter-Commercial,2015,0,3,0,3
D52,Break & Enter-Apartment,2015,6,12,0,6
D51,Other,2015,10,10,1,0
D53,Theft Under $5000,2015,1,5,0,4
D52,Theft Under $5000,2015,89,370,0,281
D52,Sexual Violation,2015,1,1,1,0
D51,Other,2015,2,2,1,0
D52,Break & Enter-Apartment,2015,3,5,0,2
D53,Theft Under $5000,2015,57,204,0,147
D53,Break & Enter-Commercial,2015,0,2,0,2
D52,Sexual Violation,2015,2,6,0,4
D52,Theft Under $5000,2015,2,13,0,11
D51,Other,2015,78,83,0,5
D52,Break & Enter-Commercial,2015,8,30,0,22
D53,Theft Under $5000,2015,10,79,0,69
D53,Break & Enter-Commercial,2015,1,6,0,5
D52,Sexual Violation,2015,3,4,0,1
D52,Theft Under $5000,2015,11,56,0,45
D51,Other,2015,76,84,0,8
D52,Break & Enter-Commercial,2015,6,18,0,12
D53,Assault,2015,78,147,0,69
D53,Break & Enter-Commercial,2015,0,8,0,8
D52,Sexual Violation,2015,15,26,0,11
D52,Theft Under $5000,2015,32,244,0,212
D51,Other,2015,123,135,0,12
D52,Break & Enter-Commercial,2015,4,22,0,18
D53,Assault,2015,1,2,0,1
D53,Break & Enter-Commercial,2015,0,10,0,10
D52,Sexual Violation,2015,0,2,0,2
D52,Theft Under $5000,2015,280,904,0,624
D51,Other,2015,1,1,1,0
D52,Break & Enter-Commercial,2015,5,12,0,7
D53,Assault,2015,2,3,0,1
D53,Break & Enter-Commercial,2015,0,2,0,2
D52,Sexual Violation,2015,6,8,0,2
D52,Theft Under $5000,2015,0,1,0,1
D51,Other,2015,290,302,0,12
D52,Break & Enter-Commercial,2015,1,1,1,0
D53,Assault,2015,7,13,0,6
D53,Break & Enter-Commercial,2015,5,10,0,5
D53,Break & Enter-Commercial,2015,2,3,0,1
D53,Break & Enter-Commercial,2015,2,6,0,4
D53,Break & Enter-Commercial,2015,8,15,0,7
D53,Break & Enter-Commercial,2015,3,10,0,7
D53,Break & Enter-Commercial,2015,5,8,0,3
D53,Break & Enter-House,2015,3,6,0,3
D53,Break & Enter-House,2015,0,7,0,7
D53,Break & Enter-House,2015,0,10,0,10
D53,Break & Enter-House,2015,1,3,0,2
D53,Break & Enter-House,2015,0,5,0,5
D53,Break & Enter-House,2015,0,3,0,3
D53,Break & Enter-House,2015,2,33,0,31
D53,Break & Enter-House,2015,1,21,0,20
D53,Break & Enter-House,2015,1,4,0,3
D53,Break & Enter-House,2015,0,3,0,3
D53,Break & Enter-House,2015,1,16,0,15
D53,Break & Enter-House,2015,0,4,0,4
D53,Break & Enter-House,2015,0,1,0,1
D53,Break & Enter-House,2015,0,5,0,5
D53,Break & Enter-House,2015,1,3,0,2
D53,Break & Enter-Other,2015,0,2,0,2
D53,Break & Enter-Other,2015,0,1,0,1
D53,Break & Enter-Other,2015,0,1,0,1
D51,Other,2015,4,4,1,0
D52,Break & Enter-Commercial,2015,9,29,0,20
D53,Assault,2015,6,9,0,3
D52,Theft Under $5000,2015,3,25,0,22
D51,Other,2015,74,77,0,3
D52,Sexual Violation,2015,3,4,0,1
D52,Break & Enter-Commercial,2015,66,95,0,29
D53,Assault,2015,4,8,0,4
D52,Theft Under $5000,2015,0,1,0,1
D51,Other,2015,44,46,0,2
D52,Sexual Violation,2015,15,29,0,14
D52,Break & Enter-House,2015,1,1,1,0
D53,Assault,2015,9,14,0,5
D52,Theft Under $5000,2015,33,208,0,175
D51,Other,2015,1,1,1,0
D52,Sexual Violation,2015,26,39,0,13
D52,Break & Enter-House,2015,3,4,0,1
D53,Assault,2015,2,5,0,3
D52,Theft Under $5000,2015,13,276,0,263
D52,Theft Under $5000,2015,127,641,0,514
D52,Theft Under $5000,2015,1292,2348,0,1056
D52,Assault,2015,56,91,0,35
D52,Assault,2015,8,11,0,3
D52,Assault,2015,39,60,0,21
D52,Assault,2015,62,85,0,23
D52,Assault,2015,101,153,0,52
D52,Assault,2015,0,2,0,2
D52,Assault,2015,5,6,0,1
D52,Assault,2015,58,86,0,28
D52,Assault,2015,0,1,0,1
D52,Assault,2015,25,37,0,12
D52,Assault,2015,166,289,0,123
D52,Assault,2015,0,1,0,1
D52,Assault,2015,343,470,0,127
D52,Attempt Murder,2015,1,1,1,0
D52,Attempt Murder,2015,3,5,0,2
D52,Attempt Murder,2015,2,2,1,0
D52,Other,2015,23,56,0,33
D51,Other,2015,28,34,0,6
D52,Break & Enter-House,2015,1,2,0,1
D53,Assault,2015,18,22,0,4
D52,Sexual Violation,2015,1,2,0,1
D51,Other,2015,50,50,1,0
D52,Break & Enter-House,2015,1,1,1,0
D53,Assault,2015,17,25,0,8
D52,Other,2015,3,3,1,0
D51,Other Criminal Violations - Offensive Weapons,2015,11,11,1,0
D52,Break & Enter-Other,2015,1,3,0,2
D53,Assault,2015,18,23,0,5
D52,Other,2015,3,3,1,0
D51,Other Criminal Violations - Offensive Weapons,2015,9,10,0,1
D52,Break & Enter-Other,2015,1,4,0,3
D53,Assault,2015,1,6,0,5
D52,Other,2015,9,9,1,0
D51,Other Criminal Violations - Offensive Weapons,2015,31,32,0,1
D52,Break & Enter-Other,2015,0,2,0,2
D53,Assault,2015,2,3,0,1
D52,Other,2015,5,5,1,0
D51,Other Criminal Violations - Offensive Weapons,2015,1,1,1,0
D52,Break & Enter-Other,2015,2,8,0,6
D51,Other Criminal Violations - Offensive Weapons,2015,36,36,1,0
D52,Other,2015,2,2,1,0
D53,Assault,2015,33,42,0,9
D52,Break & Enter-Other,2015,3,4,0,1
D53,Assault,2015,61,92,0,31
D51,Other Criminal Violations - Offensive Weapons,2015,11,14,0,3
D52,Break & Enter-Other,2015,12,14,0,2
D53,Assault,2015,38,55,0,17
D51,Other Criminal Violations - Offensive Weapons,2015,13,13,1,0
D52,Fraud,2015,36,97,0,61
D53,Assault,2015,70,94,0,24
D51,Other Criminal Violations - Offensive Weapons,2015,6,6,1,0
D52,Fraud,2015,1,2,0,1
D53,Assault,2015,3,7,0,4
D51,Other,2015,1,1,1,0
D52,Fraud,2015,3,10,0,7
D53,Assault,2015,39,55,0,16
D51,Other,2015,5,5,1,0
D52,Fraud,2015,7,48,0,41
D53,Assault,2015,18,24,0,6
D51,Other,2015,6,6,1,0
D52,Fraud,2015,14,70,0,56
D53,Other,2015,25,50,0,25
D51,Other,2015,8,9,0,1
D52,Fraud,2015,4,9,0,5
D53,Other,2015,1,1,1,0
D51,Other,2015,1,1,1,0
D52,Fraud,2015,16,69,0,53
D53,Other,2015,4,6,0,2
D51,Other,2015,1,1,1,0
D52,Fraud,2015,0,9,0,9
D53,Other,2015,5,11,0,6
D52,Other,2015,10,10,1,0
D52,Other,2015,6,6,1,0
D52,Other,2015,17,19,0,2
D52,Other,2015,20,21,0,1
D52,Other,2015,96,107,0,11
D52,Other,2015,1,1,1,0
D52,Other,2015,7,7,1,0
D52,Other,2015,1,1,1,0
D52,Other,2015,45,45,1,0
D52,Other,2015,38,39,0,1
D52,Other,2015,1,1,1,0
D52,Other,2015,111,122,0,11
D52,Other,2015,6,7,0,1
D52,Other,2015,36,39,0,3
D55,Other,2015,15,28,0,13
D55,Other,2015,2,2,1,0
D55,Other,2015,6,20,0,14
D55,Other,2015,11,17,0,6
D55,Other,2015,38,72,0,34
D55,Other,2015,27,53,0,26
D55,Other,2015,30,44,0,14
D55,Other,2015,2,3,0,1
D55,Other,2015,12,20,0,8
D55,Other,2015,24,45,0,21
D55,Other,2015,6,12,0,6
D55,Other,2015,10,15,0,5
D55,Other,2015,38,65,0,27
D55,Other,2015,13,23,0,10
D55,Other,2015,26,41,0,15
D55,Other,2015,8,14,0,6
D55,Other,2015,12,24,0,12
D55,Other,2015,10,17,0,7
D55,Other,2015,1,1,1,0
D55,Robbery-Financial,2015,1,1,1,0
D55,Robbery-Financial,2015,3,3,1,0
D55,Robbery-Financial,2015,1,1,1,0
D55,Robbery-Financial,2015,1,1,1,0
D55,Robbery-Financial,2015,2,2,1,0
D55,Robbery-Financial,2015,2,2,1,0
D55,Robbery-Other,2015,2,11,0,9
D55,Robbery-Other,2015,0,3,0,3
D55,Robbery-Other,2015,1,2,0,1
D55,Robbery-Other,2015,5,13,0,8
D55,Robbery-Other,2015,6,11,0,5
D55,Robbery-Other,2015,13,27,0,14
D55,Robbery-Other,2015,9,19,0,10
D55,Robbery-Other,2015,7,17,0,10
D55,Robbery-Other,2015,1,3,0,2
D55,Robbery-Other,2015,9,32,0,23
D55,Robbery-Other,2015,8,12,0,4
D55,Robbery-Other,2015,0,1,0,1
D55,Robbery-Other,2015,1,3,0,2
D55,Robbery-Other,2015,5,9,0,4
D55,Robbery-Other,2015,14,35,0,21
D55,Robbery-Other,2015,12,36,0,24
D55,Robbery-Other,2015,8,14,0,6
D53,Other,2015,2,5,0,3
D55,Robbery-Other,2015,2,6,0,4
D55,Sexual Violation,2015,17,20,0,3
D55,Fraud,2015,9,45,0,36
D55,Break & Enter-Commercial,2015,12,16,0,4
D55,Robbery-Other,2015,4,16,0,12
D55,Robbery-Other,2015,3,6,0,3
D55,Sexual Violation,2015,5,6,0,1
D55,Sexual Violation,2015,2,4,0,2
D55,Sexual Violation,2015,5,8,0,3
D55,Sexual Violation,2015,1,6,0,5
D55,Sexual Violation,2015,10,16,0,6
D53,Other,2015,1,1,1,0
D55,Theft Over $5000,2015,1,3,0,2
D53,Other,2015,2,4,0,2
D55,Fraud,2015,10,38,0,28
D55,Break & Enter-Commercial,2015,2,5,0,3
D55,Theft Over $5000,2015,2,3,0,1
D55,Sexual Violation,2015,7,15,0,8
D53,Other,2015,1,1,1,0
D53,Other,2015,2,2,1,0
D55,Fraud,2015,0,3,0,3
D55,Break & Enter-Commercial,2015,6,23,0,17
D55,Theft Under $5000,2015,1,2,0,1
D55,Sexual Violation,2015,0,1,0,1
D53,Other,2015,4,4,1,0
D53,Other,2015,12,21,0,9
D55,Fraud,2015,3,15,0,12
D55,Break & Enter-Commercial,2015,0,1,0,1
D55,Theft Under $5000,2015,28,133,0,105
D55,Sexual Violation,2015,1,4,0,3
D53,Other,2015,5,6,0,1
D53,Other,2015,7,19,0,12
D55,Fraud,2015,7,42,0,35
D55,Break & Enter-Commercial,2015,1,5,0,4
D55,Theft Under $5000,2015,34,92,0,58
D55,Sexual Violation,2015,3,7,0,4
D53,Other,2015,2,2,1,0
D53,Other,2015,9,17,0,8
D55,Fraud,2015,2,13,0,11
D55,Break & Enter-Commercial,2015,2,11,0,9
D55,Theft Under $5000,2015,33,146,0,113
D55,Sexual Violation,2015,11,20,0,9
D53,Other,2015,5,6,0,1
D53,Other,2015,2,3,0,1
D55,Fraud,2015,9,35,0,26
D55,Break & Enter-Commercial,2015,2,6,0,4
D55,Theft Under $5000,2015,9,102,0,93
D55,Sexual Violation,2015,2,8,0,6
D53,Other,2015,1,1,1,0
D53,Other,2015,15,21,0,6
D55,Fraud,2015,22,91,0,69
D55,Break & Enter-Commercial,2015,1,5,0,4
D53,Other,2015,1,1,1,0
D55,Theft Under $5000,2015,121,393,0,272
D53,Other,2015,10,10,1,0
D55,Fraud,2015,8,45,0,37
D55,Theft Under $5000,2015,16,91,0,75
D53,Other,2015,8,8,1,0
D55,Sexual Violation,2015,4,6,0,2
D55,Break & Enter-Commercial,2015,5,18,0,13
D53,Other,2015,26,41,0,15
D55,Theft Under $5000,2015,22,153,0,131
D55,Sexual Violation,2015,15,24,0,9
D55,Break & Enter-Commercial,2015,2,25,0,23
D55,Fraud,2015,5,44,0,39
D53,Other,2015,11,22,0,11
D53,Other,2015,6,6,1,0
D55,Theft Under $5000,2015,0,14,0,14
D55,Sexual Violation,2015,9,14,0,5
D55,Break & Enter-Commercial,2015,8,19,0,11
D55,Fraud,2015,1,12,0,11
D53,Other,2015,18,28,0,10
D53,Other,2015,4,4,1,0
D55,Theft Under $5000,2015,24,152,0,128
D55,Sexual Violation,2015,8,11,0,3
D55,Break & Enter-Commercial,2015,1,5,0,4
D55,Fraud,2015,6,34,0,28
D53,Other,2015,26,36,0,10
D53,Other,2015,3,3,1,0
D55,Theft Under $5000,2015,19,153,0,134
D55,Sexual Violation,2015,3,5,0,2
D55,Break & Enter-Commercial,2015,1,2,0,1
D55,Fraud,2015,4,11,0,7
D53,Other,2015,3,12,0,9
D53,Other,2015,67,72,0,5
D55,Theft Under $5000,2015,1,5,0,4
D55,Sexual Violation,2015,4,7,0,3
D55,Break & Enter-House,2015,3,20,0,17
D55,Other,2015,1,2,0,1
D53,Robbery-Financial,2015,1,1,1,0
D53,Other,2015,1,1,1,0
D55,Theft Under $5000,2015,15,83,0,68
D55,Sexual Violation,2015,8,9,0,1
D55,Break & Enter-House,2015,2,10,0,8
D55,Other,2015,20,82,0,62
D53,Robbery-Financial,2015,1,1,1,0
D53,Other,2015,8,9,0,1
D55,Theft Under $5000,2015,74,168,0,94
D55,Other,2015,8,8,1,0
D55,Other,2015,4,4,1,0
D55,Other,2015,2,2,1,0
D55,Other,2015,2,2,1,0
D55,Other,2015,13,14,0,1
D55,Other,2015,3,3,1,0
D55,Other,2015,11,12,0,1
D55,Other,2015,1,1,1,0
D55,Other,2015,3,3,1,0
D55,Other,2015,8,8,1,0
D55,Other,2015,15,15,1,0
D55,Other,2015,1,1,1,0
D55,Other,2015,17,17,1,0
D55,Other,2015,30,30,1,0
D55,Other,2015,3,3,1,0
D55,Other,2015,9,9,1,0
D55,Other,2015,1,1,1,0
D55,Other,2015,6,6,1,0
D55,Other,2015,2,2,1,0
D55,Other,2015,1,1,1,0
D55,Other,2015,52,54,0,2
D55,Other,2015,17,19,0,2
D55,Other,2015,2,2,1,0
D55,Other,2015,37,40,0,3
D55,Other,2015,18,20,0,2
D55,Other,2015,95,99,0,4
D55,Other,2015,63,68,0,5
D55,Other,2015,60,69,0,9
D55,Other,2015,6,6,1,0
D55,Other,2015,33,37,0,4
D55,Other,2015,69,76,0,7
D55,Other,2015,1,1,1,0
D55,Other,2015,12,14,0,2
D55,Other,2015,29,31,0,2
D55,Other,2015,125,144,0,19
D55,Other,2015,47,55,0,8
D55,Other,2015,41,41,1,0
D55,Break & Enter-House,2015,3,16,0,13
D53,Robbery-Financial,2015,3,3,1,0
D55,Other,2015,14,52,0,38
D55,Theft Under $5000,2015,271,663,0,392
D55,Other,2015,35,35,1,0
D53,Other,2015,4,4,1,0
D55,Break & Enter-House,2015,3,14,0,11
D53,Robbery-Financial,2015,1,1,1,0
D55,Other,2015,2,3,0,1
D55,Theft Under $5000,2015,101,236,0,135
D53,Other,2015,4,5,0,1
D55,Other,2015,10,11,0,1
D55,Break & Enter-House,2015,6,28,0,22
D53,Other,2015,4,4,1,0
D55,Theft Under $5000,2015,30,224,0,194
D53,Robbery-Other,2015,10,21,0,11
D53,Other,2015,2,2,1,0
D55,Break & Enter-House,2015,1,3,0,2
D55,Other,2015,26,77,0,51
D55,Other,2015,12,13,0,1
D53,Robbery-Other,2015,0,3,0,3
D55,Break & Enter-House,2015,2,21,0,19
D55,Other,2015,19,47,0,28
D55,Theft Under $5000,2015,8,45,0,37
D53,Other,2015,2,2,1,0
D55,Other,2015,16,17,0,1
D53,Robbery-Other,2015,0,3,0,3
D55,Break & Enter-House,2015,3,29,0,26
D55,Other,2015,52,158,0,106
D55,Theft Under $5000,2015,31,147,0,116
D53,Other,2015,10,15,0,5
D55,Other,2015,13,13,1,0
D53,Robbery-Other,2015,4,10,0,6
D55,Break & Enter-House,2015,2,9,0,7
D55,Other,2015,19,73,0,54
D53,Other,2015,10,13,0,3
D55,Theft Under $5000,2015,7,54,0,47
D55,Break & Enter-House,2015,0,9,0,9
D53,Robbery-Other,2015,1,5,0,4
D55,Other,2015,29,79,0,50
D55,Other,2015,23,23,1,0
D55,Assault,2015,0,1,0,1
D53,Robbery-Other,2015,6,9,0,3
D53,Other,2015,4,4,1,0
D55,Break & Enter-House,2015,1,13,0,12
D55,Other,2015,1,7,0,6
D55,Other,2015,47,49,0,2
D55,Assault,2015,41,62,0,21
D53,Robbery-Other,2015,8,14,0,6
D53,Other,2015,12,13,0,1
D55,Break & Enter-House,2015,14,47,0,33
D55,Other,2015,8,56,0,48
D55,Other,2015,28,28,1,0
D55,Assault,2015,41,52,0,11
D53,Robbery-Other,2015,0,1,0,1
D53,Other,2015,80,86,0,6
D55,Break & Enter-House,2015,2,19,0,17
D55,Other,2015,20,83,0,63
D55,Other,2015,11,11,1,0
D55,Assault,2015,2,5,0,3
D53,Robbery-Other,2015,3,8,0,5
D53,Other,2015,23,23,1,0
D55,Break & Enter-House,2015,6,17,0,11
D55,Other,2015,6,37,0,31
D55,Other,2015,15,15,1,0
D55,Assault,2015,57,81,0,24
D53,Robbery-Other,2015,5,8,0,3
D53,Other,2015,23,27,0,4
D55,Break & Enter-House,2015,1,3,0,2
D55,Other,2015,12,53,0,41
D55,Other,2015,17,18,0,1
D55,Assault,2015,36,51,0,15
D53,Robbery-Other,2015,1,4,0,3
D53,Other,2015,1,1,1,0
D55,Break & Enter-House,2015,3,15,0,12
D55,Other,2015,0,2,0,2
D55,Other,2015,20,21,0,1
D55,Assault,2015,106,168,0,62
D53,Robbery-Other,2015,3,5,0,2
D53,Other,2015,10,10,1,0
D55,Break & Enter-House,2015,5,17,0,12
D55,Other,2015,57,201,0,144
D55,Other,2015,17,62,0,45
D55,Other,2015,33,114,0,81
D55,Other,2015,6,24,0,18
D55,Other,2015,23,71,0,48
D55,Other,2015,11,37,0,26
D55,Theft Over $5000,2015,0,2,0,2
D55,Theft Over $5000,2015,0,2,0,2
D55,Theft Over $5000,2015,0,4,0,4
D55,Theft Over $5000,2015,2,4,0,2
D55,Theft Over $5000,2015,2,9,0,7
D55,Theft Over $5000,2015,1,3,0,2
D55,Theft Over $5000,2015,1,7,0,6
D55,Theft Over $5000,2015,0,1,0,1
D55,Theft Over $5000,2015,0,2,0,2
D55,Theft Over $5000,2015,1,6,0,5
D55,Theft Over $5000,2015,0,3,0,3
D55,Theft Over $5000,2015,1,2,0,1
D55,Theft Over $5000,2015,7,15,0,8
D55,Theft Over $5000,2015,1,3,0,2
D55,Theft Over $5000,2015,0,5,0,5
D55,Theft Over $5000,2015,0,5,0,5
D55,Break & Enter-Other,2015,0,1,0,1
D55,Auto Theft,2015,2,6,0,4
D55,Assault,2015,88,134,0,46
D53,Other,2015,34,36,0,2
D53,Sexual Violation,2015,11,19,0,8
D55,Break & Enter-Other,2015,0,2,0,2
D55,Auto Theft,2015,0,5,0,5
D55,Assault,2015,78,119,0,41
D53,Other,2015,8,8,1,0
D53,Sexual Violation,2015,0,1,0,1
D55,Break & Enter-Other,2015,0,3,0,3
D55,Auto Theft,2015,0,1,0,1
D55,Assault,2015,7,10,0,3
D53,Other Criminal Violations - Offensive Weapons,2015,7,7,1,0
D53,Sexual Violation,2015,2,3,0,1
D55,Break & Enter-Other,2015,2,7,0,5
D55,Auto Theft,2015,0,7,0,7
D55,Assault,2015,27,62,0,35
D53,Other Criminal Violations - Offensive Weapons,2015,1,1,1,0
D53,Sexual Violation,2015,1,2,0,1
D55,Break & Enter-Other,2015,1,3,0,2
D55,Auto Theft,2015,1,12,0,11
D55,Assault,2015,99,144,0,45
D53,Other Criminal Violations - Offensive Weapons,2015,2,2,1,0
D53,Other Criminal Violations - Offensive Weapons,2015,3,3,1,0
D53,Other Criminal Violations - Offensive Weapons,2015,3,3,1,0
D53,Other Criminal Violations - Offensive Weapons,2015,4,4,1,0
D53,Other Criminal Violations - Offensive Weapons,2015,5,5,1,0
D53,Other Criminal Violations - Offensive Weapons,2015,3,4,0,1
D53,Other Criminal Violations - Offensive Weapons,2015,7,9,0,2
D53,Other Criminal Violations - Offensive Weapons,2015,5,5,1,0
D53,Other,2015,1,1,1,0
D53,Other,2015,1,1,1,0
D53,Other,2015,1,1,1,0
D55,Other,2015,26,26,1,0
D55,Other,2015,7,7,1,0
D55,Other,2015,33,33,1,0
D55,Other,2015,5,5,1,0
D55,Other,2015,34,34,1,0
D55,Break & Enter-Other,2015,1,1,1,0
D55,Assault,2015,0,3,0,3
D53,Sexual Violation,2015,1,1,1,0
D55,Auto Theft,2015,1,15,0,14
D55,Break & Enter-Other,2015,0,2,0,2
D55,Assault,2015,30,47,0,17
D53,Sexual Violation,2015,0,2,0,2
D55,Auto Theft,2015,0,7,0,7
D55,Break & Enter-Other,2015,0,2,0,2
D55,Assault,2015,22,34,0,12
D53,Sexual Violation,2015,0,1,0,1
D55,Auto Theft,2015,2,20,0,18
D55,Break & Enter-Other,2015,0,2,0,2
D55,Assault,2015,122,169,0,47
D53,Sexual Violation,2015,3,4,0,1
D55,Auto Theft,2015,0,13,0,13
D55,Break & Enter-Other,2015,3,10,0,7
D55,Assault,2015,58,90,0,32
D53,Sexual Violation,2015,3,4,0,1
D55,Auto Theft,2015,2,12,0,10
D55,Break & Enter-Other,2015,0,5,0,5
D55,Assault,2015,55,92,0,37
D53,Sexual Violation,2015,1,3,0,2
D55,Auto Theft,2015,0,7,0,7
D55,Break & Enter-Other,2015,0,1,0,1
D55,Assault,2015,41,63,0,22
D53,Sexual Violation,2015,3,4,0,1
D55,Break & Enter-Other,2015,0,1,0,1
D55,Auto Theft,2015,0,9,0,9
D55,Break & Enter-Other,2015,0,2,0,2
D53,Sexual Violation,2015,2,3,0,1
D55,Assault,2015,49,67,0,18
D55,Auto Theft,2015,2,24,0,22
D55,Fraud,2015,0,1,0,1
D53,Sexual Violation,2015,6,12,0,6
D55,Assault,2015,29,36,0,7
D55,Auto Theft,2015,0,11,0,11
D55,Fraud,2015,3,22,0,19
D53,Sexual Violation,2015,4,6,0,2
D55,Attempt Murder,2015,1,1,1,0
D55,Auto Theft,2015,1,26,0,25
D55,Fraud,2015,2,17,0,15
D53,Sexual Violation,2015,12,14,0,2
D55,Attempt Murder,2015,1,1,1,0
D55,Auto Theft,2015,0,3,0,3
D55,Fraud,2015,8,30,0,22
D53,Sexual Violation,2015,1,1,1,0
D55,Attempt Murder,2015,2,2,1,0
D55,Auto Theft,2015,2,10,0,8
D55,Fraud,2015,4,21,0,17
D53,Sexual Violation,2015,9,15,0,6
D55,Attempt Murder,2015,1,1,1,0
D55,Auto Theft,2015,1,6,0,5
D55,Fraud,2015,10,61,0,51
D53,Sexual Violation,2015,2,4,0,2
D55,Attempt Murder,2015,2,2,1,0
D55,Break & Enter-Apartment,2015,2,4,0,2
D53,Other,2015,8,8,1,0
D55,Attempt Murder,2015,3,3,1,0
D55,Break & Enter-Apartment,2015,2,11,0,9
D53,Other,2015,3,3,1,0
D55,Other,2015,19,25,0,6
D55,Break & Enter-Apartment,2015,2,6,0,4
D53,Other,2015,3,3,1,0
D55,Break & Enter-Apartment,2015,2,3,0,1
D55,Break & Enter-Apartment,2015,5,32,0,27
D55,Break & Enter-Apartment,2015,2,13,0,11
D55,Break & Enter-Apartment,2015,3,7,0,4
D55,Break & Enter-Apartment,2015,1,9,0,8
D55,Break & Enter-Apartment,2015,6,13,0,7
D55,Break & Enter-Apartment,2015,0,2,0,2
D55,Break & Enter-Apartment,2015,14,20,0,6
D55,Break & Enter-Apartment,2015,13,23,0,10
D55,Break & Enter-Apartment,2015,4,22,0,18
D55,Break & Enter-Apartment,2015,1,5,0,4
D55,Break & Enter-Apartment,2015,1,4,0,3
D55,Break & Enter-Apartment,2015,3,6,0,3
D55,Break & Enter-Apartment,2015,0,1,0,1
D55,Break & Enter-Commercial,2015,1,3,0,2
D55,Break & Enter-Commercial,2015,0,1,0,1
D11,Other,2016,28,29,0,1
D11,Other,2016,1,1,1,0
D11,Other,2016,52,55,0,3
D11,Other,2016,9,9,1,0
D11,Other Criminal Violations - Offensive Weapons,2016,7,7,1,0
D11,Theft Over $5000,2016,0,1,0,1
D11,Other Criminal Violations - Offensive Weapons,2016,9,9,1,0
D11,Other Criminal Violations - Offensive Weapons,2016,9,9,1,0
D11,Other Criminal Violations - Offensive Weapons,2016,4,4,1,0
D11,Other Criminal Violations - Offensive Weapons,2016,15,16,0,1
D11,Other Criminal Violations - Offensive Weapons,2016,1,1,1,0
D11,Theft Over $5000,2016,0,3,0,3
D11,Other Criminal Violations - Offensive Weapons,2016,1,1,1,0
D11,Theft Over $5000,2016,0,1,0,1
D11,Other Criminal Violations - Offensive Weapons,2016,8,8,1,0
D12,Break & Enter-Apartment,2016,2,3,0,1
D11,Theft Over $5000,2016,0,1,0,1
D11,Other Criminal Violations - Offensive Weapons,2016,2,2,1,0
D11,Theft Under $5000,2016,0,1,0,1
D11,Robbery-Financial,2016,1,1,1,0
D12,Break & Enter-Apartment,2016,2,7,0,5
D11,Other Criminal Violations - Offensive Weapons,2016,2,2,1,0
D55,Other,2015,50,59,0,9
D11,Theft Under $5000,2016,247,382,0,135
D11,Robbery-Financial,2016,1,1,1,0
D11,Break & Enter-Commercial,2016,0,2,0,2
D12,Break & Enter-Apartment,2016,7,19,0,12
D11,Other Criminal Violations - Offensive Weapons,2016,14,14,1,0
NSA,Other Criminal Violations - Offensive Weapons,2015,0,1,0,1
D11,Theft Under $5000,2016,69,238,0,169
D55,Other,2015,15,20,0,5
D11,Robbery-Financial,2016,2,2,1,0
NSA,Fraud,2015,1,1,1,0
D11,Break & Enter-Commercial,2016,0,1,0,1
D11,Break & Enter-House,2016,2,4,0,2
D11,Break & Enter-House,2016,0,9,0,9
D11,Break & Enter-House,2016,1,20,0,19
D11,Break & Enter-House,2016,0,8,0,8
D11,Break & Enter-House,2016,4,18,0,14
D11,Break & Enter-House,2016,0,6,0,6
D11,Break & Enter-House,2016,0,5,0,5
D11,Break & Enter-House,2016,9,17,0,8
D11,Break & Enter-House,2016,4,10,0,6
D11,Break & Enter-House,2016,1,2,0,1
D11,Break & Enter-Other,2016,1,1,1,0
D11,Break & Enter-Other,2016,1,2,0,1
D11,Break & Enter-Other,2016,0,1,0,1
D11,Break & Enter-Other,2016,0,2,0,2
D11,Break & Enter-Other,2016,2,3,0,1
D11,Break & Enter-Other,2016,0,2,0,2
D11,Break & Enter-Other,2016,1,2,0,1
D11,Fraud,2016,12,41,0,29
D11,Fraud,2016,5,38,0,33
D11,Fraud,2016,9,53,0,44
D11,Fraud,2016,14,54,0,40
D11,Fraud,2016,18,50,0,32
D11,Fraud,2016,0,10,0,10
D11,Fraud,2016,4,14,0,10
D11,Fraud,2016,1,1,1,0
D11,Fraud,2016,6,10,0,4
D11,Fraud,2016,10,47,0,37
D11,Fraud,2016,9,24,0,15
D11,Fraud,2016,5,11,0,6
D11,Fraud,2016,6,20,0,14
D11,Other,2016,18,70,0,52
D11,Other,2016,25,88,0,63
D11,Other,2016,32,101,0,69
D11,Other,2016,16,63,0,47
D11,Other,2016,37,106,0,69
D11,Other,2016,7,33,0,26
D11,Other,2016,5,22,0,17
D11,Other,2016,2,3,0,1
D11,Other,2016,28,87,0,59
D11,Other,2016,12,54,0,42
D11,Other,2016,2,11,0,9
D11,Other,2016,18,39,0,21
D11,Theft Over $5000,2016,1,2,0,1
D11,Theft Over $5000,2016,0,2,0,2
D11,Theft Over $5000,2016,0,6,0,6
D11,Theft Over $5000,2016,2,3,0,1
D11,Theft Over $5000,2016,4,6,0,2
D11,Theft Over $5000,2016,1,2,0,1
D11,Theft Under $5000,2016,78,231,0,153
D11,Other,2016,1,1,1,0
D12,Break & Enter-Apartment,2016,1,1,1,0
D55,Other,2015,55,57,0,2
D11,Robbery-Other,2016,4,12,0,8
NSA,Fraud,2015,1,1,1,0
D11,Theft Under $5000,2016,154,310,0,156
D11,Other,2016,2,3,0,1
D12,Break & Enter-Apartment,2016,3,8,0,5
D55,Other,2015,21,26,0,5
NSA,Other Criminal Violations - Offensive Weapons,2015,18,20,0,2
D55,Other,2015,23,23,1,0
D11,Other,2016,3,3,1,0
D11,Theft Under $5000,2016,57,238,0,181
D11,Robbery-Other,2016,10,25,0,15
D12,Break & Enter-Apartment,2016,3,8,0,5
NSA,Other,2015,2,2,1,0
D55,Other Criminal Violations - Offensive Weapons,2015,6,6,1,0
NSA,Fraud,2015,0,1,0,1
D11,Other,2016,5,5,1,0
D11,Theft Under $5000,2016,6,34,0,28
D11,Robbery-Other,2016,3,16,0,13
D12,Break & Enter-Apartment,2016,10,13,0,3
NSA,Other,2015,16,17,0,1
D55,Other Criminal Violations - Offensive Weapons,2015,3,3,1,0
NSA,Other,2015,1,1,1,0
D11,Other,2016,1,1,1,0
D11,Theft Under $5000,2016,27,54,0,27
D11,Robbery-Other,2016,1,7,0,6
D12,Break & Enter-Commercial,2016,0,3,0,3
D11,Other,2016,22,22,1,0
D55,Other Criminal Violations - Offensive Weapons,2015,7,7,1,0
NSA,Other,2015,0,1,0,1
D11,Other,2016,1,2,0,1
D11,Theft Under $5000,2016,1,6,0,5
D11,Robbery-Other,2016,8,19,0,11
D12,Break & Enter-Commercial,2016,5,10,0,5
D11,Other,2016,11,11,1,0
D55,Other Criminal Violations - Offensive Weapons,2015,1,1,1,0
NSA,Other,2015,37,66,0,29
D11,Other,2016,1,1,1,0
D11,Theft Under $5000,2016,66,95,0,29
D11,Robbery-Other,2016,0,5,0,5
D12,Break & Enter-Commercial,2016,0,3,0,3
D11,Other,2016,18,19,0,1
D55,Other Criminal Violations - Offensive Weapons,2015,13,15,0,2
NSA,Other,2015,0,1,0,1
NSA,Other,2015,0,1,0,1
NSA,Other,2015,1,1,1,0
NSA,Theft Over $5000,2015,1,1,1,0
NSA,Theft Over $5000,2015,0,2,0,2
NSA,Theft Under $5000,2015,0,1,0,1
NSA,Theft Under $5000,2015,0,1,0,1
NSA,Theft Under $5000,2015,14,88,0,74
NSA,Theft Under $5000,2015,0,1,0,1
NSA,Assault,2015,0,1,0,1
NSA,Assault,2015,1,1,1,0
NSA,Assault,2015,1,1,1,0
NSA,Assault,2015,0,1,0,1
NSA,Assault,2015,37,81,0,44
NSA,Assault,2015,1,1,1,0
NSA,Assault,2015,0,1,0,1
NSA,Assault,2015,0,1,0,1
NSA,Other,2015,0,1,0,1
NSA,Other,2015,14,31,0,17
NSA,Other,2015,0,1,0,1
NSA,Other,2015,0,1,0,1
NSA,Robbery-Other,2015,0,1,0,1
NSA,Robbery-Other,2015,0,1,0,1
NSA,Robbery-Other,2015,12,29,0,17
NSA,Sexual Violation,2015,0,1,0,1
NSA,Sexual Violation,2015,0,1,0,1
NSA,Sexual Violation,2015,0,1,0,1
NSA,Sexual Violation,2015,0,1,0,1
NSA,Sexual Violation,2015,0,1,0,1
NSA,Sexual Violation,2015,14,73,0,59
NSA,Sexual Violation,2015,0,1,0,1
NSA,Sexual Violation,2015,1,1,1,0
NSA,Sexual Violation,2015,0,1,0,1
NSA,Sexual Violation,2015,0,1,0,1
NSA,Sexual Violation,2015,0,1,0,1
NSA,Sexual Violation,2015,0,3,0,3
NSA,Other,2015,1,1,1,0
NSA,Other,2015,56,58,0,2
NSA,Other,2015,2,2,1,0
NSA,Other,2015,3,3,1,0
NSA,Other,2015,0,1,0,1
NSA,Other,2015,104,111,0,7
NSA,Other,2015,2,2,1,0
NSA,Other,2015,1,1,1,0
D11,Theft Under $5000,2016,107,290,0,183
D11,Robbery-Other,2016,3,5,0,2
D11,Other,2016,3,3,1,0
D11,Other,2016,15,16,0,1
D55,Other Criminal Violations - Offensive Weapons,2015,10,10,1,0
D11,Theft Under $5000,2016,47,122,0,75
D12,Other,2016,20,20,1,0
D11,Robbery-Other,2016,0,1,0,1
D55,Other Criminal Violations - Offensive Weapons,2015,11,11,1,0
D11,Theft Under $5000,2016,6,34,0,28
D11,Other,2016,25,28,0,3
D12,Break & Enter-Commercial,2016,3,5,0,2
D11,Theft Under $5000,2016,8,28,0,20
D11,Robbery-Other,2016,17,25,0,8
D12,Other,2016,39,40,0,1
D11,Other,2016,2,2,1,0
D12,Break & Enter-Commercial,2016,1,3,0,2
D11,Assault,2016,0,1,0,1
D11,Robbery-Other,2016,7,12,0,5
D12,Other,2016,6,6,1,0
D11,Other,2016,7,7,1,0
D12,Break & Enter-Commercial,2016,6,8,0,2
D11,Assault,2016,37,53,0,16
D11,Robbery-Other,2016,1,5,0,4
D12,Other,2016,24,25,0,1
D11,Other,2016,1,1,1,0
D11,Assault,2016,54,76,0,22
D12,Break & Enter-Commercial,2016,4,6,0,2
D11,Assault,2016,63,84,0,21
D11,Robbery-Other,2016,6,11,0,5
D12,Other,2016,5,5,1,0
D55,Other Criminal Violations - Offensive Weapons,2015,1,1,1,0
D11,Sexual Violation,2016,5,9,0,4
D12,Break & Enter-Commercial,2016,4,11,0,7
D11,Assault,2016,50,75,0,25
D11,Other,2016,1,1,1,0
D11,Sexual Violation,2016,8,14,0,6
D11,Assault,2016,83,120,0,37
D12,Break & Enter-Commercial,2016,11,17,0,6
D55,Other Criminal Violations - Offensive Weapons,2015,7,7,1,0
D12,Other,2016,23,23,1,0
D11,Other,2016,40,41,0,1
D11,Sexual Violation,2016,14,25,0,11
D11,Assault,2016,17,20,0,3
D12,Break & Enter-Commercial,2016,2,3,0,1
D55,Other Criminal Violations - Offensive Weapons,2015,10,10,1,0
D12,Other,2016,3,3,1,0
D11,Other,2016,9,9,1,0
D11,Sexual Violation,2016,5,9,0,4
D11,Assault,2016,13,21,0,8
D12,Break & Enter-House,2016,1,2,0,1
D55,Other Criminal Violations - Offensive Weapons,2015,3,3,1,0
D12,Other,2016,7,7,1,0
D11,Other,2016,13,14,0,1
D11,Sexual Violation,2016,14,17,0,3
D11,Assault,2016,0,1,0,1
D12,Break & Enter-House,2016,2,7,0,5
D55,Other Criminal Violations - Offensive Weapons,2015,9,9,1,0
D12,Other,2016,48,48,1,0
D11,Other,2016,18,18,1,0
D11,Sexual Violation,2016,1,3,0,2
D11,Assault,2016,0,2,0,2
D12,Break & Enter-House,2016,0,5,0,5
D55,Other Criminal Violations - Offensive Weapons,2015,19,20,0,1
D12,Other,2016,17,18,0,1
D11,Auto Theft,2016,1,1,1,0
D11,Sexual Violation,2016,2,2,1,0
D11,Assault,2016,1,2,0,1
D12,Break & Enter-House,2016,2,3,0,1
D55,Other Criminal Violations - Offensive Weapons,2015,4,4,1,0
D55,Other Criminal Violations - Offensive Weapons,2015,10,10,1,0
D55,Other Criminal Violations - Offensive Weapons,2015,9,9,1,0
D55,Other Criminal Violations - Offensive Weapons,2015,4,4,1,0
D55,Other,2015,2,2,1,0
D55,Other,2015,1,1,1,0
D55,Other,2015,1,1,1,0
D55,Other,2015,2,2,1,0
D55,Other,2015,1,1,1,0
D55,Other,2015,2,2,1,0
D55,Other,2015,1,1,1,0
D55,Other,2015,1,1,1,0
D55,Other,2015,4,4,1,0
NSA,Other,2015,82,95,0,13
NSA,Other,2015,1,1,1,0
NSA,Other,2015,1,1,1,0
NSA,Auto Theft,2015,1,7,0,6
NSA,Break & Enter-Apartment,2015,1,1,1,0
NSA,Break & Enter-Apartment,2015,0,2,0,2
NSA,Break & Enter-Commercial,2015,0,1,0,1
NSA,Break & Enter-Commercial,2015,0,2,0,2
NSA,Break & Enter-House,2015,7,7,1,0
NSA,Break & Enter-Other,2015,1,2,0,1
NSA,Fraud,2015,11,11,1,0
NSA,Fraud,2015,0,1,0,1
NSA,Fraud,2015,0,1,0,1
NSA,Fraud,2015,1,1,1,0
NSA,Fraud,2015,0,1,0,1
NSA,Fraud,2015,0,1,0,1
NSA,Fraud,2015,1,1,1,0
NSA,Fraud,2015,60,107,0,47
NSA,Fraud,2015,0,1,0,1
D11,Assault,2016,77,107,0,30
D12,Other,2016,68,69,0,1
D12,Break & Enter-House,2016,4,5,0,1
D11,Sexual Violation,2016,0,1,0,1
D11,Assault,2016,19,36,0,17
D12,Other,2016,7,7,1,0
D12,Break & Enter-House,2016,1,2,0,1
D11,Sexual Violation,2016,11,18,0,7
D11,Assault,2016,13,21,0,8
D12,Auto Theft,2016,1,9,0,8
D12,Break & Enter-House,2016,4,6,0,2
D11,Sexual Violation,2016,2,3,0,1
D12,Auto Theft,2016,6,30,0,24
D11,Assault,2016,1,1,1,0
D12,Break & Enter-House,2016,3,17,0,14
D11,Sexual Violation,2016,2,2,1,0
D11,Assault,2016,30,50,0,20
D12,Auto Theft,2016,1,4,0,3
D12,Break & Enter-House,2016,4,7,0,3
D11,Sexual Violation,2016,2,2,1,0
D11,Attempt Murder,2016,0,1,0,1
D12,Auto Theft,2016,0,18,0,18
D12,Break & Enter-House,2016,8,13,0,5
D11,Other,2016,5,5,1,0
D11,Attempt Murder,2016,0,1,0,1
D12,Auto Theft,2016,0,15,0,15
D12,Break & Enter-House,2016,3,6,0,3
D11,Other,2016,4,4,1,0
D11,Attempt Murder,2016,0,1,0,1
D12,Auto Theft,2016,4,18,0,14
D12,Break & Enter-Other,2016,1,3,0,2
D11,Other,2016,15,18,0,3
D11,Other,2016,6,13,0,7
D12,Auto Theft,2016,1,1,1,0
D12,Break & Enter-Other,2016,2,8,0,6
D11,Other,2016,9,9,1,0
D11,Other,2016,15,25,0,10
D12,Auto Theft,2016,0,12,0,12
D12,Break & Enter-Other,2016,0,3,0,3
D11,Other,2016,12,13,0,1
D11,Other,2016,23,35,0,12
D12,Auto Theft,2016,4,33,0,29
D12,Break & Enter-Other,2016,1,3,0,2
D11,Other,2016,4,4,1,0
D11,Other,2016,14,18,0,4
D12,Auto Theft,2016,3,10,0,7
D12,Break & Enter-Other,2016,1,2,0,1
D11,Other,2016,4,4,1,0
D11,Other,2016,19,40,0,21
D12,Auto Theft,2016,0,1,0,1
D12,Break & Enter-Other,2016,1,1,1,0
D11,Other,2016,1,1,1,0
D11,Other,2016,5,7,0,2
D12,Auto Theft,2016,4,42,0,38
D12,Break & Enter-Other,2016,0,2,0,2
D11,Other,2016,14,14,1,0
D11,Other,2016,4,6,0,2
D12,Auto Theft,2016,0,11,0,11
D12,Break & Enter-Other,2016,2,2,1,0
D11,Other,2016,8,9,0,1
D11,Other,2016,14,14,1,0
D11,Other,2016,4,4,1,0
D11,Other,2016,50,58,0,8
D11,Other,2016,68,74,0,6
D11,Other,2016,62,68,0,6
D11,Other,2016,69,71,0,2
D11,Other,2016,62,65,0,3
D11,Other,2016,7,9,0,2
D11,Other,2016,11,14,0,3
D11,Other,2016,1,1,1,0
D11,Other,2016,5,5,1,0
D11,Other,2016,107,116,0,9
D11,Other,2016,20,23,0,3
D11,Other,2016,3,4,0,1
D12,Break & Enter-Other,2016,1,1,1,0
D12,Break & Enter-Apartment,2016,1,3,0,2
D11,Other,2016,12,18,0,6
D12,Fraud,2016,4,20,0,16
D12,Break & Enter-Apartment,2016,1,6,0,5
D11,Other,2016,5,7,0,2
D12,Fraud,2016,17,64,0,47
D11,Other,2016,11,14,0,3
D12,Fraud,2016,6,11,0,5
D11,Other,2016,13,19,0,6
D12,Fraud,2016,4,16,0,12
D11,Robbery-Financial,2016,1,1,1,0
D12,Fraud,2016,5,27,0,22
D12,Fraud,2016,4,20,0,16
D12,Fraud,2016,0,1,0,1
D12,Fraud,2016,10,18,0,8
D12,Fraud,2016,9,45,0,36
D12,Fraud,2016,2,12,0,10
D12,Fraud,2016,15,70,0,55
D12,Fraud,2016,2,12,0,10
D12,Other,2016,6,22,0,16
D11,Auto Theft,2016,0,5,0,5
D11,Auto Theft,2016,1,9,0,8
D11,Auto Theft,2016,1,14,0,13
D11,Auto Theft,2016,3,16,0,13
D11,Auto Theft,2016,2,10,0,8
D11,Auto Theft,2016,0,1,0,1
D11,Auto Theft,2016,0,3,0,3
D11,Auto Theft,2016,0,1,0,1
D11,Auto Theft,2016,3,13,0,10
D11,Auto Theft,2016,1,9,0,8
D11,Auto Theft,2016,0,2,0,2
D11,Auto Theft,2016,0,7,0,7
D11,Break & Enter-Apartment,2016,4,6,0,2
D11,Break & Enter-Apartment,2016,3,15,0,12
D11,Break & Enter-Apartment,2016,3,8,0,5
D11,Break & Enter-Apartment,2016,6,8,0,2
D11,Break & Enter-Apartment,2016,4,9,0,5
D11,Break & Enter-Apartment,2016,0,1,0,1
D11,Break & Enter-Apartment,2016,1,3,0,2
D11,Break & Enter-Apartment,2016,0,1,0,1
D11,Break & Enter-Apartment,2016,3,5,0,2
D11,Break & Enter-Apartment,2016,0,1,0,1
D11,Break & Enter-Apartment,2016,1,3,0,2
D11,Break & Enter-Commercial,2016,1,7,0,6
D11,Break & Enter-Commercial,2016,0,4,0,4
D11,Break & Enter-Commercial,2016,0,2,0,2
D11,Break & Enter-Commercial,2016,1,8,0,7
D11,Break & Enter-Commercial,2016,2,6,0,4
D11,Break & Enter-Commercial,2016,1,2,0,1
D11,Break & Enter-Commercial,2016,0,5,0,5
D11,Break & Enter-Commercial,2016,2,17,0,15
D11,Break & Enter-Commercial,2016,1,9,0,8
D12,Other,2016,35,39,0,4
D12,Other,2016,30,64,0,34
D13,Break & Enter-Other,2016,0,1,0,1
D12,Other,2016,62,66,0,4
D12,Other,2016,2,2,1,0
D13,Break & Enter-Other,2016,1,1,1,0
D12,Other,2016,1,1,1,0
D12,Other,2016,6,17,0,11
D13,Break & Enter-Other,2016,0,1,0,1
D12,Other,2016,1,1,1,0
D12,Other,2016,13,42,0,29
D13,Break & Enter-Other,2016,0,3,0,3
D12,Other,2016,12,12,1,0
D12,Other,2016,8,25,0,17
D13,Break & Enter-Other,2016,1,1,1,0
D12,Other,2016,9,12,0,3
D12,Other,2016,24,61,0,37
D13,Fraud,2016,10,30,0,20
D12,Other,2016,23,26,0,3
D12,Other,2016,0,1,0,1
D13,Fraud,2016,3,16,0,13
D12,Other,2016,22,26,0,4
D12,Other,2016,5,16,0,11
D13,Robbery-Other,2016,0,2,0,2
D13,Fraud,2016,6,17,0,11
D13,Fraud,2016,11,40,0,29
D13,Fraud,2016,4,11,0,7
D13,Auto Theft,2016,1,11,0,10
D13,Fraud,2016,8,17,0,9
D13,Fraud,2016,4,19,0,15
D13,Fraud,2016,0,1,0,1
D13,Fraud,2016,14,43,0,29
D13,Fraud,2016,4,12,0,8
D13,Fraud,2016,0,1,0,1
D13,Fraud,2016,18,49,0,31
D13,Fraud,2016,19,50,0,31
D13,Fraud,2016,10,27,0,17
D13,Other,2016,0,1,0,1
D13,Other,2016,26,56,0,30
D13,Other,2016,14,33,0,19
D13,Other,2016,5,18,0,13
D13,Other,2016,25,76,0,51
D13,Other,2016,5,16,0,11
D13,Other,2016,4,19,0,15
D13,Other,2016,7,14,0,7
D13,Other,2016,1,1,1,0
D13,Other,2016,21,51,0,30
D13,Other,2016,5,21,0,16
D13,Other,2016,1,1,1,0
D13,Other,2016,2,2,1,0
D13,Other,2016,41,86,0,45
D13,Other,2016,26,60,0,34
D13,Other,2016,20,47,0,27
D13,Theft Over $5000,2016,4,4,1,0
D13,Theft Over $5000,2016,0,1,0,1
D13,Theft Over $5000,2016,2,4,0,2
D13,Theft Over $5000,2016,0,2,0,2
D13,Theft Over $5000,2016,2,2,1,0
D13,Theft Over $5000,2016,0,2,0,2
D13,Theft Over $5000,2016,1,5,0,4
D13,Theft Over $5000,2016,0,5,0,5
D13,Theft Over $5000,2016,0,2,0,2
D13,Theft Over $5000,2016,0,6,0,6
D13,Theft Over $5000,2016,2,4,0,2
D13,Theft Under $5000,2016,38,116,0,78
D13,Theft Under $5000,2016,11,55,0,44
D13,Theft Under $5000,2016,105,219,0,114
D13,Theft Under $5000,2016,15,81,0,66
D13,Theft Under $5000,2016,0,1,0,1
D13,Other Criminal Violations - Offensive Weapons,2016,2,2,1,0
D12,Attempt Murder,2016,0,4,0,4
D13,Auto Theft,2016,0,3,0,3
D12,Other,2016,45,46,0,1
D13,Robbery-Other,2016,1,1,1,0
D13,Auto Theft,2016,3,8,0,5
D13,Other Criminal Violations - Offensive Weapons,2016,4,4,1,0
D13,Auto Theft,2016,3,14,0,11
D12,Other,2016,29,32,0,3
D13,Robbery-Other,2016,5,28,0,23
D13,Auto Theft,2016,1,5,0,4
D13,Other Criminal Violations - Offensive Weapons,2016,4,5,0,1
D12,Attempt Murder,2016,1,3,0,2
D13,Theft Under $5000,2016,1,21,0,20
D12,Attempt Murder,2016,3,3,1,0
D12,Other,2016,28,80,0,52
D13,Auto Theft,2016,0,7,0,7
D12,Other,2016,76,80,0,4
D13,Robbery-Other,2016,1,5,0,4
D12,Other,2016,21,28,0,7
D12,Other,2016,13,30,0,17
D13,Auto Theft,2016,3,17,0,14
D12,Other,2016,43,46,0,3
D13,Robbery-Other,2016,1,8,0,7
D12,Other,2016,7,15,0,8
D12,Other,2016,48,132,0,84
D13,Auto Theft,2016,2,2,1,0
D12,Other,2016,99,105,0,6
D13,Sexual Violation,2016,5,5,1,0
D12,Other,2016,2,5,0,3
D12,Other,2016,6,20,0,14
D13,Auto Theft,2016,1,2,0,1
D12,Other,2016,6,6,1,0
D13,Theft Under $5000,2016,3,22,0,19
D13,Other Criminal Violations - Offensive Weapons,2016,23,23,1,0
D13,Sexual Violation,2016,4,7,0,3
D12,Other,2016,7,12,0,5
D12,Theft Over $5000,2016,0,4,0,4
D13,Auto Theft,2016,3,29,0,26
D12,Other,2016,4,4,1,0
D13,Theft Under $5000,2016,7,40,0,33
D13,Other Criminal Violations - Offensive Weapons,2016,11,11,1,0
D13,Sexual Violation,2016,3,4,0,1
D12,Other,2016,2,2,1,0
D12,Theft Over $5000,2016,0,3,0,3
D13,Auto Theft,2016,2,19,0,17
D12,Other Criminal Violations - Offensive Weapons,2016,5,5,1,0
D13,Theft Under $5000,2016,21,116,0,95
D13,Other Criminal Violations - Offensive Weapons,2016,7,7,1,0
D13,Sexual Violation,2016,7,9,0,2
D13,Sexual Violation,2016,1,1,1,0
D13,Sexual Violation,2016,3,5,0,2
D13,Sexual Violation,2016,4,6,0,2
D13,Sexual Violation,2016,6,6,1,0
D13,Sexual Violation,2016,2,2,1,0
D13,Sexual Violation,2016,4,13,0,9
D13,Sexual Violation,2016,6,10,0,4
D13,Sexual Violation,2016,3,5,0,2
D13,Other,2016,11,11,1,0
D13,Other,2016,4,5,0,1
D13,Other,2016,3,3,1,0
D13,Other,2016,15,15,1,0
D13,Other,2016,1,1,1,0
D13,Other,2016,7,7,1,0
D13,Other,2016,3,3,1,0
D13,Other,2016,8,8,1,0
D13,Other,2016,22,24,0,2
D13,Other,2016,8,8,1,0
D13,Other,2016,10,10,1,0
D13,Other,2016,53,59,0,6
D13,Other,2016,29,30,0,1
D13,Other,2016,38,44,0,6
D13,Other,2016,49,57,0,8
D13,Other,2016,6,6,1,0
D13,Other,2016,7,7,1,0
D13,Other,2016,14,14,1,0
D13,Other,2016,2,2,1,0
D13,Other,2016,32,37,0,5
D13,Other,2016,1,1,1,0
D13,Other,2016,7,8,0,1
D13,Other,2016,106,115,0,9
D13,Other,2016,1,1,1,0
D13,Other,2016,35,38,0,3
D13,Other,2016,3,3,1,0
D13,Other,2016,10,10,1,0
D13,Other,2016,14,21,0,7
D13,Other Criminal Violations - Offensive Weapons,2016,6,6,1,0
D13,Other Criminal Violations - Offensive Weapons,2016,8,8,1,0
D13,Other Criminal Violations - Offensive Weapons,2016,1,1,1,0
D13,Other Criminal Violations - Offensive Weapons,2016,11,12,0,1
D13,Other Criminal Violations - Offensive Weapons,2016,1,1,1,0
D12,Other,2016,13,24,0,11
D13,Auto Theft,2016,2,14,0,12
D12,Other Criminal Violations - Offensive Weapons,2016,14,15,0,1
D13,Break & Enter-Apartment,2016,2,17,0,15
D12,Theft Over $5000,2016,0,1,0,1
D13,Other,2016,2,2,1,0
D12,Other,2016,1,6,0,5
D13,Theft Under $5000,2016,7,33,0,26
D13,Break & Enter-Apartment,2016,0,4,0,4
D13,Theft Under $5000,2016,0,4,0,4
D12,Other,2016,6,16,0,10
D12,Other Criminal Violations - Offensive Weapons,2016,0,1,0,1
D12,Theft Over $5000,2016,1,1,1,0
D13,Theft Under $5000,2016,42,143,0,101
D12,Other,2016,1,4,0,3
D13,Break & Enter-Apartment,2016,3,5,0,2
D13,Other,2016,1,1,1,0
D12,Other,2016,27,48,0,21
D12,Theft Over $5000,2016,0,4,0,4
D13,Break & Enter-Apartment,2016,1,8,0,7
D12,Other Criminal Violations - Offensive Weapons,2016,4,4,1,0
D13,Other,2016,4,4,1,0
D13,Theft Under $5000,2016,43,155,0,112
D12,Other,2016,5,10,0,5
D12,Theft Over $5000,2016,1,3,0,2
D13,Break & Enter-Apartment,2016,1,1,1,0
D12,Other Criminal Violations - Offensive Weapons,2016,7,8,0,1
D13,Other,2016,1,1,1,0
D13,Theft Under $5000,2016,26,82,0,56
D12,Robbery-Financial,2016,3,3,1,0
D12,Robbery-Financial,2016,3,6,0,3
D12,Robbery-Other,2016,5,11,0,6
D12,Robbery-Other,2016,11,31,0,20
D12,Robbery-Other,2016,1,1,1,0
D12,Robbery-Other,2016,1,3,0,2
D12,Robbery-Other,2016,7,24,0,17
D12,Robbery-Other,2016,5,5,1,0
D12,Robbery-Other,2016,13,30,0,17
D12,Robbery-Other,2016,1,4,0,3
D12,Robbery-Other,2016,27,51,0,24
D12,Robbery-Other,2016,5,6,0,1
D12,Robbery-Other,2016,22,32,0,10
D12,Robbery-Other,2016,0,3,0,3
D12,Sexual Violation,2016,8,15,0,7
D12,Sexual Violation,2016,15,16,0,1
D12,Sexual Violation,2016,3,5,0,2
D12,Sexual Violation,2016,3,8,0,5
D12,Sexual Violation,2016,2,3,0,1
D12,Sexual Violation,2016,6,11,0,5
D12,Sexual Violation,2016,1,2,0,1
D12,Sexual Violation,2016,10,16,0,6
D12,Sexual Violation,2016,3,7,0,4
D12,Sexual Violation,2016,10,16,0,6
D12,Sexual Violation,2016,4,5,0,1
D12,Other,2016,1,1,1,0
D12,Other,2016,11,11,1,0
D12,Other,2016,4,4,1,0
D12,Other,2016,12,12,1,0
D12,Other,2016,4,4,1,0
D12,Other,2016,6,6,1,0
D12,Other,2016,7,7,1,0
D12,Other,2016,18,18,1,0
D12,Other,2016,5,7,0,2
D12,Other,2016,11,11,1,0
D12,Other,2016,6,6,1,0
D13,Assault,2016,2,2,1,0
D13,Break & Enter-Apartment,2016,5,13,0,8
D12,Other Criminal Violations - Offensive Weapons,2016,4,4,1,0
D13,Assault,2016,47,56,0,9
D13,Other,2016,1,1,1,0
D13,Break & Enter-Apartment,2016,3,10,0,7
D12,Other Criminal Violations - Offensive Weapons,2016,1,1,1,0
D13,Assault,2016,34,53,0,19
D13,Other,2016,6,7,0,1
D13,Break & Enter-Apartment,2016,0,2,0,2
D12,Other Criminal Violations - Offensive Weapons,2016,12,12,1,0
D13,Other,2016,1,1,1,0
D13,Assault,2016,20,29,0,9
D12,Other Criminal Violations - Offensive Weapons,2016,2,7,0,5
D13,Break & Enter-Apartment,2016,1,12,0,11
D13,Assault,2016,48,64,0,16
D13,Other,2016,1,2,0,1
D12,Other Criminal Violations - Offensive Weapons,2016,21,22,0,1
D13,Break & Enter-Apartment,2016,1,4,0,3
D13,Assault,2016,9,11,0,2
D14,Other,2016,9,9,1,0
D12,Other Criminal Violations - Offensive Weapons,2016,4,4,1,0
D13,Break & Enter-Apartment,2016,0,7,0,7
D13,Assault,2016,6,18,0,12
D14,Other,2016,5,5,1,0
D12,Other,2016,4,6,0,2
D13,Break & Enter-Commercial,2016,4,8,0,4
D13,Assault,2016,7,9,0,2
D14,Other,2016,4,4,1,0
D12,Other,2016,7,8,0,1
D13,Break & Enter-Commercial,2016,0,1,0,1
D13,Assault,2016,33,47,0,14
D14,Other,2016,27,35,0,8
D12,Other,2016,10,10,1,0
D13,Break & Enter-Commercial,2016,1,2,0,1
D13,Assault,2016,17,24,0,7
D14,Other,2016,13,16,0,3
D12,Other,2016,1,1,1,0
D13,Break & Enter-Commercial,2016,0,2,0,2
D13,Assault,2016,1,2,0,1
D14,Other,2016,112,118,0,6
D12,Other,2016,3,3,1,0
D13,Break & Enter-Commercial,2016,3,4,0,1
D13,Assault,2016,86,128,0,42
D14,Other,2016,8,8,1,0
D12,Other,2016,1,1,1,0
D13,Break & Enter-Commercial,2016,1,1,1,0
D13,Assault,2016,56,71,0,15
D14,Other,2016,1,2,0,1
D12,Other,2016,2,2,1,0
D13,Break & Enter-Commercial,2016,0,1,0,1
D13,Assault,2016,24,46,0,22
D14,Other,2016,1,1,1,0
D12,Other,2016,1,1,1,0
D14,Other,2016,19,20,0,1
D13,Break & Enter-Commercial,2016,2,4,0,2
D13,Attempt Murder,2016,1,1,1,0
D12,Other,2016,4,5,0,1
D14,Other,2016,53,55,0,2
D13,Break & Enter-Commercial,2016,2,2,1,0
D13,Other,2016,11,15,0,4
D12,Other,2016,1,1,1,0
D14,Other,2016,49,52,0,3
D13,Break & Enter-Commercial,2016,1,1,1,0
D13,Other,2016,14,16,0,2
D13,Other,2016,28,28,1,0
D14,Other,2016,24,24,1,0
D13,Break & Enter-Commercial,2016,1,3,0,2
D13,Other,2016,3,7,0,4
D13,Other,2016,9,9,1,0
D14,Other,2016,46,50,0,4
D13,Break & Enter-Commercial,2016,3,11,0,8
D13,Other,2016,17,26,0,9
D13,Other,2016,6,7,0,1
D14,Other,2016,34,35,0,1
D13,Break & Enter-Commercial,2016,8,16,0,8
D13,Other,2016,3,5,0,2
D13,Other,2016,28,30,0,2
D14,Auto Theft,2016,0,12,0,12
D13,Break & Enter-House,2016,0,5,0,5
D13,Other,2016,13,25,0,12
D13,Other,2016,1,1,1,0
D14,Auto Theft,2016,2,17,0,15
D13,Break & Enter-House,2016,1,11,0,10
D13,Other,2016,6,8,0,2
D13,Other,2016,2,2,1,0
D14,Auto Theft,2016,0,3,0,3
D13,Break & Enter-House,2016,0,6,0,6
D13,Other,2016,15,28,0,13
D13,Other,2016,17,17,1,0
D14,Auto Theft,2016,3,15,0,12
D13,Break & Enter-House,2016,4,7,0,3
D13,Other,2016,13,18,0,5
D13,Other,2016,4,5,0,1
D14,Auto Theft,2016,2,5,0,3
D13,Break & Enter-House,2016,2,17,0,15
D13,Other,2016,1,1,1,0
D14,Auto Theft,2016,6,17,0,11
D13,Break & Enter-House,2016,2,9,0,7
D13,Other,2016,6,12,0,6
D13,Other,2016,8,8,1,0
D13,Break & Enter-House,2016,1,6,0,5
D13,Robbery-Financial,2016,1,1,1,0
D14,Auto Theft,2016,0,10,0,10
D13,Other,2016,71,74,0,3
D13,Break & Enter-House,2016,1,12,0,11
D13,Robbery-Financial,2016,2,2,1,0
D14,Auto Theft,2016,2,14,0,12
D13,Other,2016,2,2,1,0
D13,Break & Enter-House,2016,0,2,0,2
D13,Robbery-Financial,2016,1,1,1,0
D14,Auto Theft,2016,4,23,0,19
D13,Other,2016,18,18,1,0
D13,Break & Enter-House,2016,2,8,0,6
D13,Robbery-Financial,2016,2,2,1,0
D14,Auto Theft,2016,7,27,0,20
D13,Other,2016,15,15,1,0
D13,Break & Enter-House,2016,4,11,0,7
D13,Robbery-Financial,2016,1,1,1,0
D14,Auto Theft,2016,2,15,0,13
D13,Auto Theft,2016,5,17,0,12
D13,Break & Enter-House,2016,3,9,0,6
D13,Robbery-Other,2016,1,1,1,0
D14,Auto Theft,2016,3,12,0,9
D13,Break & Enter-Other,2016,0,1,0,1
D13,Robbery-Other,2016,8,18,0,10
D14,Auto Theft,2016,3,12,0,9
D13,Break & Enter-Other,2016,1,1,1,0
D13,Robbery-Other,2016,7,13,0,6
D14,Break & Enter-Apartment,2016,5,14,0,9
D13,Robbery-Other,2016,0,2,0,2
D14,Break & Enter-Apartment,2016,1,7,0,6
D13,Robbery-Other,2016,8,25,0,17
D14,Break & Enter-Apartment,2016,0,3,0,3
D13,Robbery-Other,2016,1,5,0,4
D14,Break & Enter-Apartment,2016,4,17,0,13
D13,Robbery-Other,2016,1,4,0,3
D14,Break & Enter-Apartment,2016,1,14,0,13
D14,Break & Enter-Apartment,2016,6,12,0,6
D14,Break & Enter-Apartment,2016,1,11,0,10
D14,Break & Enter-Apartment,2016,1,10,0,9
D13,Robbery-Other,2016,1,2,0,1
D13,Robbery-Other,2016,3,7,0,4
D12,Theft Over $5000,2016,2,4,0,2
D12,Theft Over $5000,2016,6,8,0,2
D12,Theft Under $5000,2016,18,59,0,41
D12,Theft Under $5000,2016,86,217,0,131
D12,Theft Under $5000,2016,0,1,0,1
D12,Theft Under $5000,2016,0,1,0,1
D12,Theft Under $5000,2016,0,1,0,1
D12,Theft Under $5000,2016,8,38,0,30
D12,Theft Under $5000,2016,21,75,0,54
D12,Theft Under $5000,2016,0,1,0,1
D12,Theft Under $5000,2016,3,37,0,34
D12,Theft Under $5000,2016,15,62,0,47
D12,Theft Under $5000,2016,0,1,0,1
D12,Theft Under $5000,2016,211,350,0,139
D12,Theft Under $5000,2016,16,120,0,104
D12,Theft Under $5000,2016,4,19,0,15
D12,Theft Under $5000,2016,35,200,0,165
D12,Theft Under $5000,2016,3,31,0,28
D12,Assault,2016,39,51,0,12
D12,Assault,2016,80,107,0,27
D12,Assault,2016,0,1,0,1
D12,Assault,2016,1,1,1,0
D12,Assault,2016,15,23,0,8
D12,Assault,2016,33,51,0,18
D12,Assault,2016,30,36,0,6
D12,Assault,2016,71,97,0,26
D12,Assault,2016,4,7,0,3
D12,Assault,2016,15,20,0,5
D12,Assault,2016,90,125,0,35
D12,Assault,2016,40,65,0,25
D12,Assault,2016,104,149,0,45
D12,Assault,2016,9,14,0,5
D22,Break & Enter-Apartment,2016,2,12,0,10
D22,Break & Enter-Apartment,2016,2,6,0,4
D22,Break & Enter-Apartment,2016,1,3,0,2
D22,Break & Enter-Apartment,2016,1,6,0,5
D22,Break & Enter-Apartment,2016,1,3,0,2
D14,Assault,2016,23,32,0,9
D22,Break & Enter-Apartment,2016,4,7,0,3
D22,Fraud,2016,5,33,0,28
D14,Robbery-Other,2016,5,9,0,4
D14,Other Criminal Violations - Offensive Weapons,2016,1,1,1,0
D14,Fraud,2016,11,65,0,54
D22,Break & Enter-Apartment,2016,1,1,1,0
D22,Break & Enter-Apartment,2016,6,14,0,8
D22,Break & Enter-Apartment,2016,1,5,0,4
D22,Break & Enter-Apartment,2016,1,8,0,7
D22,Break & Enter-Commercial,2016,6,13,0,7
D22,Break & Enter-Commercial,2016,0,1,0,1
D22,Break & Enter-Commercial,2016,1,3,0,2
D22,Break & Enter-Commercial,2016,14,47,0,33
D22,Break & Enter-Commercial,2016,2,4,0,2
D22,Break & Enter-Commercial,2016,1,3,0,2
D22,Break & Enter-Commercial,2016,2,11,0,9
D22,Break & Enter-Commercial,2016,1,4,0,3
D22,Break & Enter-Commercial,2016,2,7,0,5
D22,Break & Enter-Commercial,2016,1,6,0,5
D22,Break & Enter-Commercial,2016,5,12,0,7
D22,Break & Enter-Commercial,2016,0,1,0,1
D22,Break & Enter-Commercial,2016,9,15,0,6
D22,Break & Enter-Commercial,2016,0,3,0,3
D22,Break & Enter-Commercial,2016,4,14,0,10
D22,Break & Enter-House,2016,5,11,0,6
D22,Break & Enter-House,2016,6,38,0,32
D22,Break & Enter-House,2016,5,20,0,15
D22,Break & Enter-House,2016,0,1,0,1
D22,Break & Enter-House,2016,1,21,0,20
D22,Break & Enter-House,2016,4,17,0,13
D22,Break & Enter-House,2016,2,14,0,12
D22,Break & Enter-House,2016,1,9,0,8
D22,Break & Enter-House,2016,8,14,0,6
D22,Break & Enter-House,2016,2,9,0,7
D22,Break & Enter-House,2016,6,22,0,16
D22,Break & Enter-House,2016,5,24,0,19
D22,Break & Enter-Other,2016,1,1,1,0
D22,Break & Enter-Other,2016,0,2,0,2
D22,Break & Enter-Other,2016,0,3,0,3
D22,Break & Enter-Other,2016,2,4,0,2
D22,Theft Under $5000,2016,16,104,0,88
D22,Break & Enter-Other,2016,1,1,1,0
D22,Break & Enter-Other,2016,0,1,0,1
D22,Break & Enter-Other,2016,0,2,0,2
D22,Break & Enter-Other,2016,2,3,0,1
D22,Break & Enter-Other,2016,1,1,1,0
D22,Break & Enter-Other,2016,0,1,0,1
D22,Break & Enter-Other,2016,1,4,0,3
D14,Assault,2016,63,82,0,19
D22,Break & Enter-Other,2016,2,3,0,1
D22,Break & Enter-Other,2016,0,3,0,3
D14,Other Criminal Violations - Offensive Weapons,2016,23,23,1,0
D14,Other Criminal Violations - Offensive Weapons,2016,3,3,1,0
D14,Other Criminal Violations - Offensive Weapons,2016,1,1,1,0
D14,Other Criminal Violations - Offensive Weapons,2016,16,16,1,0
D14,Other Criminal Violations - Offensive Weapons,2016,7,8,0,1
D14,Other Criminal Violations - Offensive Weapons,2016,4,4,1,0
D14,Other Criminal Violations - Offensive Weapons,2016,5,6,0,1
D14,Other Criminal Violations - Offensive Weapons,2016,5,5,1,0
D14,Other,2016,1,2,0,1
D14,Other,2016,2,2,1,0
D14,Other,2016,2,2,1,0
D14,Other,2016,2,3,0,1
D14,Other,2016,1,2,0,1
D14,Other,2016,1,1,1,0
D22,Other,2016,6,6,1,0
D14,Sexual Violation,2016,7,13,0,6
D22,Other,2016,2,2,1,0
D22,Other,2016,6,7,0,1
D22,Other,2016,21,21,1,0
D14,Sexual Violation,2016,0,1,0,1
D22,Other,2016,4,4,1,0
D14,Sexual Violation,2016,2,2,1,0
D22,Other,2016,19,19,1,0
D14,Sexual Violation,2016,2,3,0,1
D22,Other,2016,12,13,0,1
D14,Sexual Violation,2016,9,16,0,7
D22,Other,2016,5,5,1,0
D14,Sexual Violation,2016,5,15,0,10
D22,Other,2016,13,14,0,1
D14,Sexual Violation,2016,5,12,0,7
D22,Other,2016,2,2,1,0
D22,Other,2016,28,33,0,5
D14,Sexual Violation,2016,7,11,0,4
D22,Other,2016,4,4,1,0
D14,Sexual Violation,2016,0,1,0,1
D22,Other,2016,26,27,0,1
D14,Sexual Violation,2016,6,14,0,8
D22,Other,2016,5,5,1,0
D14,Sexual Violation,2016,5,9,0,4
D22,Other,2016,8,9,0,1
D22,Fraud,2016,1,1,1,0
D22,Theft Under $5000,2016,12,85,0,73
D14,Fraud,2016,4,28,0,24
D14,Sexual Violation,2016,7,12,0,5
D14,Sexual Violation,2016,4,8,0,4
D14,Sexual Violation,2016,6,13,0,7
D14,Sexual Violation,2016,6,15,0,9
D14,Other,2016,3,3,1,0
D14,Other,2016,1,1,1,0
D14,Other,2016,19,19,1,0
D14,Other,2016,17,17,1,0
D14,Other,2016,13,13,1,0
D14,Other,2016,4,4,1,0
D14,Other,2016,1,1,1,0
D14,Other,2016,7,7,1,0
D14,Other,2016,23,23,1,0
D14,Other,2016,13,13,1,0
D14,Other,2016,3,3,1,0
D14,Other,2016,19,20,0,1
D14,Other,2016,10,10,1,0
D14,Other,2016,32,40,0,8
D14,Other,2016,0,1,0,1
D14,Other,2016,32,37,0,5
D14,Other,2016,2,4,0,2
D14,Other,2016,56,65,0,9
D14,Other,2016,26,27,0,1
D14,Other,2016,145,146,0,1
D14,Other,2016,39,44,0,5
D14,Other,2016,1,1,1,0
D14,Other,2016,5,5,1,0
D14,Other,2016,35,41,0,6
D14,Other,2016,137,140,0,3
D14,Other,2016,59,67,0,8
D14,Other,2016,40,45,0,5
D14,Other,2016,124,127,0,3
D14,Other,2016,75,79,0,4
D14,Other,2016,20,20,1,0
D14,Other Criminal Violations - Offensive Weapons,2016,4,4,1,0
D14,Other Criminal Violations - Offensive Weapons,2016,6,6,1,0
D14,Other Criminal Violations - Offensive Weapons,2016,2,2,1,0
D14,Other Criminal Violations - Offensive Weapons,2016,2,3,0,1
D14,Assault,2016,37,47,0,10
D22,Auto Theft,2016,2,17,0,15
D22,Auto Theft,2016,3,25,0,22
D22,Auto Theft,2016,2,32,0,30
D22,Auto Theft,2016,14,103,0,89
D22,Auto Theft,2016,2,16,0,14
D22,Auto Theft,2016,1,8,0,7
D22,Auto Theft,2016,3,34,0,31
D22,Auto Theft,2016,1,10,0,9
D22,Auto Theft,2016,3,13,0,10
D22,Auto Theft,2016,1,13,0,12
D22,Auto Theft,2016,7,29,0,22
D22,Auto Theft,2016,0,1,0,1
D22,Auto Theft,2016,2,11,0,9
D22,Auto Theft,2016,3,24,0,21
D22,Auto Theft,2016,3,15,0,12
D22,Break & Enter-Apartment,2016,0,1,0,1
D22,Break & Enter-Apartment,2016,1,3,0,2
D22,Break & Enter-Apartment,2016,1,2,0,1
D22,Break & Enter-Apartment,2016,3,14,0,11
D22,Break & Enter-Apartment,2016,3,8,0,5
D22,Theft Under $5000,2016,302,672,0,370
D22,Theft Under $5000,2016,5,28,0,23
D14,Fraud,2016,22,104,0,82
D22,Theft Under $5000,2016,19,115,0,96
D22,Theft Under $5000,2016,89,230,0,141
D14,Assault,2016,97,166,0,69
D22,Fraud,2016,4,25,0,21
D14,Fraud,2016,17,57,0,40
D22,Theft Under $5000,2016,47,153,0,106
D14,Assault,2016,41,77,0,36
D22,Fraud,2016,6,41,0,35
D14,Fraud,2016,0,1,0,1
D22,Theft Under $5000,2016,16,81,0,65
D14,Assault,2016,3,8,0,5
D22,Fraud,2016,57,188,0,131
D14,Other,2016,28,77,0,49
D22,Theft Under $5000,2016,17,100,0,83
D14,Assault,2016,41,62,0,21
D22,Fraud,2016,6,26,0,20
D14,Other,2016,28,76,0,48
D22,Theft Under $5000,2016,28,106,0,78
D14,Assault,2016,139,184,0,45
D22,Fraud,2016,7,55,0,48
D14,Other,2016,9,26,0,17
D22,Theft Under $5000,2016,1,13,0,12
D14,Assault,2016,62,124,0,62
D22,Fraud,2016,9,71,0,62
D14,Other,2016,35,87,0,52
D22,Theft Under $5000,2016,25,116,0,91
D14,Assault,2016,36,68,0,32
D22,Fraud,2016,3,25,0,22
D14,Other,2016,15,45,0,30
D22,Theft Under $5000,2016,20,105,0,85
D14,Assault,2016,120,222,0,102
D22,Fraud,2016,1,22,0,21
D14,Other,2016,56,131,0,75
D22,Theft Under $5000,2016,0,1,0,1
D14,Assault,2016,64,111,0,47
D14,Other,2016,19,61,0,42
D14,Attempt Murder,2016,1,1,1,0
D22,Theft Under $5000,2016,38,183,0,145
D22,Fraud,2016,4,25,0,21
D14,Attempt Murder,2016,1,1,1,0
D22,Fraud,2016,9,64,0,55
D22,Theft Under $5000,2016,0,1,0,1
D14,Attempt Murder,2016,1,2,0,1
D14,Other,2016,4,6,0,2
D22,Fraud,2016,1,5,0,4
D22,Assault,2016,25,36,0,11
D14,Attempt Murder,2016,1,2,0,1
D14,Other,2016,15,70,0,55
D22,Fraud,2016,7,39,0,32
D22,Assault,2016,20,24,0,4
D14,Attempt Murder,2016,0,2,0,2
D14,Other,2016,53,111,0,58
D22,Fraud,2016,5,24,0,19
D22,Assault,2016,33,54,0,21
D14,Attempt Murder,2016,1,1,1,0
D14,Other,2016,32,97,0,65
D22,Fraud,2016,1,1,1,0
D22,Assault,2016,73,115,0,42
D14,Attempt Murder,2016,1,2,0,1
D14,Other,2016,15,58,0,43
D22,Fraud,2016,3,63,0,60
D22,Assault,2016,27,40,0,13
D14,Other,2016,10,21,0,11
D14,Other,2016,43,87,0,44
D22,Fraud,2016,0,1,0,1
D22,Assault,2016,47,64,0,17
D14,Other,2016,22,26,0,4
D14,Other,2016,39,92,0,53
D22,Other,2016,9,38,0,29
D22,Assault,2016,1,1,1,0
D14,Other,2016,9,12,0,3
D14,Theft Over $5000,2016,0,1,0,1
D22,Other,2016,9,52,0,43
D22,Assault,2016,53,69,0,16
D14,Other,2016,28,34,0,6
D14,Theft Over $5000,2016,1,5,0,4
D22,Other,2016,15,64,0,49
D22,Assault,2016,18,26,0,8
D14,Other,2016,10,14,0,4
D14,Theft Over $5000,2016,1,1,1,0
D22,Other,2016,61,174,0,113
D22,Assault,2016,41,56,0,15
D14,Other,2016,23,37,0,14
D14,Theft Over $5000,2016,2,11,0,9
D22,Assault,2016,15,25,0,10
D14,Other,2016,20,25,0,5
D22,Other,2016,9,30,0,21
D14,Other,2016,1,2,0,1
D22,Other,2016,0,1,0,1
D14,Other,2016,10,16,0,6
D22,Other,2016,22,56,0,34
D14,Other,2016,33,44,0,11
D22,Other,2016,13,52,0,39
D14,Other,2016,15,24,0,9
D22,Other,2016,5,38,0,33
D22,Assault,2016,86,154,0,68
D14,Other,2016,16,17,0,1
D14,Theft Over $5000,2016,3,5,0,2
D22,Other,2016,15,47,0,32
D22,Assault,2016,6,9,0,3
D14,Other,2016,24,29,0,5
D14,Theft Over $5000,2016,3,7,0,4
D22,Other,2016,6,29,0,23
D22,Assault,2016,58,83,0,25
D14,Other,2016,23,30,0,7
D14,Theft Over $5000,2016,2,3,0,1
D22,Other,2016,33,92,0,59
D22,Assault,2016,21,27,0,6
D14,Robbery-Financial,2016,1,1,1,0
D14,Theft Over $5000,2016,0,6,0,6
D22,Other,2016,2,12,0,10
D22,Assault,2016,50,73,0,23
D14,Robbery-Financial,2016,1,1,1,0
D14,Theft Over $5000,2016,2,8,0,6
D22,Other,2016,16,69,0,53
D22,Attempt Murder,2016,0,2,0,2
D14,Robbery-Financial,2016,4,4,1,0
D14,Theft Over $5000,2016,0,2,0,2
D22,Other,2016,5,39,0,34
D22,Attempt Murder,2016,0,1,0,1
D14,Robbery-Financial,2016,0,1,0,1
D14,Theft Over $5000,2016,0,3,0,3
D22,Other,2016,0,1,0,1
D22,Attempt Murder,2016,1,1,1,0
D14,Robbery-Other,2016,2,13,0,11
D14,Theft Over $5000,2016,3,13,0,10
D22,Other,2016,11,91,0,80
D22,Attempt Murder,2016,1,1,1,0
D14,Robbery-Other,2016,8,12,0,4
D14,Theft Over $5000,2016,1,6,0,5
D14,Theft Under $5000,2016,68,263,0,195
D14,Theft Under $5000,2016,0,1,0,1
D14,Theft Under $5000,2016,31,184,0,153
D14,Theft Under $5000,2016,10,50,0,40
D14,Theft Under $5000,2016,33,213,0,180
D14,Theft Under $5000,2016,18,108,0,90
D14,Theft Under $5000,2016,102,449,0,347
D14,Theft Under $5000,2016,21,122,0,101
D14,Theft Under $5000,2016,6,22,0,16
D14,Theft Under $5000,2016,1,1,1,0
D14,Theft Under $5000,2016,60,287,0,227
D14,Theft Under $5000,2016,126,294,0,168
D14,Theft Under $5000,2016,80,370,0,290
D14,Theft Under $5000,2016,27,169,0,142
D14,Theft Under $5000,2016,120,422,0,302
D14,Theft Under $5000,2016,78,244,0,166
D14,Assault,2016,44,81,0,37
D14,Assault,2016,48,72,0,24
D22,Other,2016,9,20,0,11
D14,Robbery-Other,2016,1,8,0,7
D22,Other,2016,10,16,0,6
D22,Theft Over $5000,2016,0,10,0,10
D14,Robbery-Other,2016,2,4,0,2
D22,Other,2016,16,24,0,8
D22,Theft Over $5000,2016,0,2,0,2
D14,Robbery-Other,2016,8,11,0,3
D22,Other,2016,18,38,0,20
D22,Theft Over $5000,2016,0,4,0,4
D14,Robbery-Other,2016,22,47,0,25
D22,Other,2016,5,9,0,4
D22,Theft Over $5000,2016,12,31,0,19
D14,Robbery-Other,2016,3,4,0,1
D22,Other,2016,9,17,0,8
D22,Theft Over $5000,2016,2,10,0,8
D14,Robbery-Other,2016,2,5,0,3
D22,Other,2016,10,17,0,7
D22,Theft Over $5000,2016,0,6,0,6
D14,Robbery-Other,2016,7,27,0,20
D22,Other,2016,5,9,0,4
D22,Theft Over $5000,2016,0,2,0,2
D14,Robbery-Other,2016,20,31,0,11
D22,Other,2016,10,23,0,13
D22,Theft Over $5000,2016,1,2,0,1
D14,Robbery-Other,2016,4,17,0,13
D14,Robbery-Other,2016,12,25,0,13
D14,Robbery-Other,2016,5,14,0,9
D22,Other,2016,3,5,0,2
D22,Theft Over $5000,2016,1,7,0,6
D22,Theft Over $5000,2016,0,2,0,2
D22,Theft Over $5000,2016,1,5,0,4
D22,Theft Over $5000,2016,1,2,0,1
D22,Theft Over $5000,2016,0,4,0,4
D22,Theft Under $5000,2016,17,99,0,82
D22,Theft Under $5000,2016,0,1,0,1
D22,Other,2016,23,49,0,26
D22,Other,2016,1,3,0,2
D22,Other,2016,17,39,0,22
D22,Other,2016,4,8,0,4
D14,Break & Enter-Apartment,2016,8,38,0,30
D14,Break & Enter-Apartment,2016,7,13,0,6
D14,Break & Enter-Apartment,2016,2,10,0,8
D14,Break & Enter-Apartment,2016,4,7,0,3
D14,Break & Enter-Apartment,2016,5,20,0,15
D14,Break & Enter-Commercial,2016,3,14,0,11
D14,Break & Enter-Commercial,2016,0,4,0,4
D14,Break & Enter-Commercial,2016,0,3,0,3
D14,Break & Enter-Commercial,2016,2,7,0,5
D14,Break & Enter-Commercial,2016,0,2,0,2
D14,Break & Enter-Commercial,2016,4,21,0,17
D14,Break & Enter-Commercial,2016,2,14,0,12
D14,Break & Enter-Commercial,2016,4,16,0,12
D14,Break & Enter-Commercial,2016,6,22,0,16
D14,Break & Enter-Commercial,2016,0,15,0,15
D14,Break & Enter-Commercial,2016,5,12,0,7
D14,Break & Enter-Commercial,2016,16,42,0,26
D14,Break & Enter-Commercial,2016,4,14,0,10
D14,Break & Enter-House,2016,2,9,0,7
D14,Break & Enter-House,2016,7,19,0,12
D14,Break & Enter-House,2016,0,3,0,3
D14,Break & Enter-House,2016,0,1,0,1
D14,Break & Enter-House,2016,1,3,0,2
D14,Break & Enter-House,2016,1,2,0,1
D14,Break & Enter-House,2016,0,14,0,14
D14,Break & Enter-House,2016,1,4,0,3
D14,Break & Enter-House,2016,2,17,0,15
D14,Break & Enter-House,2016,1,7,0,6
D14,Break & Enter-House,2016,2,5,0,3
D14,Break & Enter-Other,2016,0,1,0,1
D14,Break & Enter-Other,2016,3,7,0,4
D14,Break & Enter-Other,2016,0,3,0,3
D14,Break & Enter-Other,2016,0,2,0,2
D14,Break & Enter-Other,2016,1,3,0,2
D14,Break & Enter-Other,2016,0,3,0,3
D14,Break & Enter-Other,2016,0,2,0,2
D14,Break & Enter-Other,2016,1,3,0,2
D14,Break & Enter-Other,2016,1,4,0,3
D14,Break & Enter-Other,2016,2,4,0,2
D14,Fraud,2016,15,48,0,33
D14,Fraud,2016,16,48,0,32
D14,Fraud,2016,1,5,0,4
D14,Fraud,2016,20,74,0,54
D14,Fraud,2016,12,52,0,40
D14,Fraud,2016,11,40,0,29
D14,Fraud,2016,19,57,0,38
D14,Fraud,2016,1,2,0,1
D14,Fraud,2016,6,41,0,35
D14,Fraud,2016,24,75,0,51
D14,Fraud,2016,0,1,0,1
D22,Other,2016,9,30,0,21
D22,Robbery-Financial,2016,3,3,1,0
D22,Robbery-Financial,2016,1,1,1,0
D22,Robbery-Financial,2016,0,2,0,2
D22,Robbery-Financial,2016,1,1,1,0
D22,Robbery-Other,2016,4,10,0,6
D22,Robbery-Other,2016,0,2,0,2
D22,Robbery-Other,2016,5,12,0,7
D22,Robbery-Other,2016,12,18,0,6
D22,Robbery-Other,2016,4,4,1,0
D22,Robbery-Other,2016,3,3,1,0
D22,Robbery-Other,2016,5,20,0,15
D22,Robbery-Other,2016,1,9,0,8
D22,Robbery-Other,2016,1,6,0,5
D22,Robbery-Other,2016,4,7,0,3
D22,Robbery-Other,2016,4,8,0,4
D22,Robbery-Other,2016,0,6,0,6
D22,Robbery-Other,2016,12,17,0,5
D22,Robbery-Other,2016,25,31,0,6
D22,Robbery-Other,2016,3,12,0,9
D22,Sexual Violation,2016,1,2,0,1
D22,Sexual Violation,2016,0,1,0,1
D23,Fraud,2016,10,25,0,15
D23,Other,2016,63,72,0,9
D23,Other,2016,21,21,1,0
D22,Sexual Violation,2016,6,11,0,5
D22,Sexual Violation,2016,3,6,0,3
D22,Sexual Violation,2016,15,24,0,9
D22,Sexual Violation,2016,2,4,0,2
D22,Sexual Violation,2016,5,7,0,2
D22,Sexual Violation,2016,1,1,1,0
D22,Sexual Violation,2016,7,8,0,1
D22,Sexual Violation,2016,1,3,0,2
D22,Sexual Violation,2016,3,4,0,1
D22,Sexual Violation,2016,1,2,0,1
D22,Sexual Violation,2016,4,10,0,6
D22,Sexual Violation,2016,1,3,0,2
D22,Sexual Violation,2016,8,13,0,5
D22,Sexual Violation,2016,3,6,0,3
D22,Sexual Violation,2016,2,6,0,4
D22,Other,2016,6,7,0,1
D22,Other,2016,6,6,1,0
D22,Other,2016,3,3,1,0
D22,Other,2016,20,21,0,1
D22,Other,2016,2,2,1,0
D22,Other,2016,2,2,1,0
D22,Other,2016,17,17,1,0
D22,Other,2016,11,11,1,0
D22,Other,2016,2,2,1,0
D22,Other,2016,5,5,1,0
D22,Other,2016,7,7,1,0
D22,Other,2016,18,19,0,1
D22,Other,2016,1,1,1,0
D22,Other,2016,4,4,1,0
D23,Attempt Murder,2016,2,4,0,2
D31,Break & Enter-Apartment,2016,1,4,0,3
D31,Theft Over $5000,2016,4,24,0,20
D23,Other,2016,142,157,0,15
D23,Attempt Murder,2016,1,1,1,0
D23,Other,2016,43,46,0,3
D31,Theft Under $5000,2016,46,174,0,128
D22,Other,2016,5,6,0,1
D31,Break & Enter-Apartment,2016,0,1,0,1
D23,Fraud,2016,8,24,0,16
D23,Other,2016,3,3,1,0
D23,Attempt Murder,2016,2,2,1,0
D23,Other,2016,17,18,0,1
D31,Theft Under $5000,2016,40,147,0,107
D22,Other,2016,22,22,1,0
D31,Break & Enter-Apartment,2016,4,20,0,16
D23,Fraud,2016,64,184,0,120
D23,Other,2016,18,19,0,1
D23,Other,2016,1,3,0,2
D23,Auto Theft,2016,0,4,0,4
D31,Theft Under $5000,2016,87,296,0,209
D31,Theft Under $5000,2016,22,158,0,136
D31,Theft Under $5000,2016,9,83,0,74
D31,Theft Under $5000,2016,0,9,0,9
D31,Theft Under $5000,2016,156,311,0,155
D31,Theft Under $5000,2016,1,40,0,39
D31,Theft Under $5000,2016,0,1,0,1
D31,Theft Under $5000,2016,75,372,0,297
D31,Assault,2016,163,215,0,52
D31,Assault,2016,54,74,0,20
D31,Assault,2016,164,258,0,94
D31,Assault,2016,50,91,0,41
D31,Assault,2016,70,100,0,30
D31,Assault,2016,0,1,0,1
D31,Assault,2016,3,7,0,4
D31,Assault,2016,132,196,0,64
D31,Assault,2016,16,32,0,16
D31,Assault,2016,158,260,0,102
D31,Attempt Murder,2016,2,7,0,5
D31,Attempt Murder,2016,3,7,0,4
D31,Attempt Murder,2016,0,4,0,4
D31,Attempt Murder,2016,1,1,1,0
D31,Attempt Murder,2016,1,1,1,0
D31,Other,2016,32,46,0,14
D31,Other,2016,10,20,0,10
D31,Other,2016,36,73,0,37
D31,Other,2016,14,27,0,13
D31,Other,2016,18,24,0,6
D31,Other,2016,17,35,0,18
D31,Other,2016,9,13,0,4
D31,Other,2016,36,64,0,28
D31,Robbery-Financial,2016,2,2,1,0
D31,Robbery-Financial,2016,0,2,0,2
D31,Robbery-Other,2016,0,1,0,1
D31,Robbery-Other,2016,20,35,0,15
D31,Robbery-Other,2016,1,7,0,6
D31,Robbery-Other,2016,23,66,0,43
D31,Robbery-Other,2016,10,21,0,11
D31,Robbery-Other,2016,7,22,0,15
D31,Robbery-Other,2016,10,33,0,23
D31,Robbery-Other,2016,1,5,0,4
D31,Robbery-Other,2016,22,62,0,40
D31,Sexual Violation,2016,17,30,0,13
D31,Sexual Violation,2016,4,5,0,1
D31,Sexual Violation,2016,12,31,0,19
D31,Sexual Violation,2016,2,10,0,8
D31,Sexual Violation,2016,10,14,0,4
D23,Fraud,2016,10,32,0,22
D23,Other,2016,25,29,0,4
D23,Auto Theft,2016,4,18,0,14
D31,Break & Enter-Commercial,2016,3,4,0,1
D23,Other,2016,0,4,0,4
D23,Other,2016,2,8,0,6
D23,Auto Theft,2016,1,17,0,16
D31,Break & Enter-Commercial,2016,3,4,0,1
D23,Other,2016,112,124,0,12
D31,Break & Enter-Commercial,2016,1,5,0,4
D22,Other,2016,14,15,0,1
D23,Other,2016,21,29,0,8
D23,Other,2016,5,8,0,3
D23,Auto Theft,2016,3,42,0,39
D31,Break & Enter-Commercial,2016,5,32,0,27
D22,Other,2016,8,9,0,1
D23,Other,2016,1,1,1,0
D23,Other,2016,11,40,0,29
D23,Other,2016,19,36,0,17
D23,Auto Theft,2016,3,44,0,41
D31,Break & Enter-Commercial,2016,2,6,0,4
D22,Other,2016,15,18,0,3
D23,Other Criminal Violations - Offensive Weapons,2016,8,9,0,1
D23,Other,2016,0,1,0,1
D23,Other,2016,37,64,0,27
D23,Auto Theft,2016,0,3,0,3
D31,Break & Enter-Commercial,2016,2,6,0,4
D22,Other,2016,107,119,0,12
D23,Other Criminal Violations - Offensive Weapons,2016,10,10,1,0
D23,Other,2016,9,36,0,27
D23,Other,2016,7,20,0,13
D23,Auto Theft,2016,4,23,0,19
D31,Break & Enter-Commercial,2016,8,22,0,14
D22,Other,2016,20,21,0,1
D23,Other Criminal Violations - Offensive Weapons,2016,9,9,1,0
D23,Other,2016,15,55,0,40
D23,Other,2016,8,15,0,7
D23,Auto Theft,2016,3,15,0,12
D31,Break & Enter-House,2016,1,7,0,6
D22,Other,2016,23,25,0,2
D23,Other Criminal Violations - Offensive Weapons,2016,19,19,1,0
D23,Other,2016,33,120,0,87
D23,Other,2016,37,74,0,37
D23,Auto Theft,2016,24,337,0,313
D31,Break & Enter-House,2016,2,8,0,6
D22,Other,2016,13,13,1,0
D23,Other,2016,1,3,0,2
D23,Other Criminal Violations - Offensive Weapons,2016,1,1,1,0
D23,Other,2016,0,1,0,1
D23,Other,2016,12,21,0,9
D31,Break & Enter-House,2016,3,6,0,3
D23,Auto Theft,2016,2,49,0,47
D23,Robbery-Financial,2016,0,1,0,1
D23,Other,2016,12,36,0,24
D23,Other Criminal Violations - Offensive Weapons,2016,7,9,0,2
D22,Other,2016,25,29,0,4
D23,Robbery-Financial,2016,2,3,0,1
D23,Other Criminal Violations - Offensive Weapons,2016,3,3,1,0
D31,Break & Enter-House,2016,0,3,0,3
D23,Break & Enter-Apartment,2016,0,2,0,2
D22,Other,2016,27,35,0,8
D23,Other,2016,15,48,0,33
D23,Robbery-Financial,2016,3,3,1,0
D23,Other Criminal Violations - Offensive Weapons,2016,16,18,0,2
D31,Break & Enter-House,2016,3,11,0,8
D23,Break & Enter-Apartment,2016,0,2,0,2
D22,Other,2016,20,30,0,10
D23,Other,2016,82,217,0,135
D23,Robbery-Other,2016,8,21,0,13
D23,Other Criminal Violations - Offensive Weapons,2016,10,10,1,0
D31,Break & Enter-House,2016,0,12,0,12
D23,Break & Enter-Apartment,2016,0,6,0,6
D22,Other,2016,18,20,0,2
D23,Other,2016,19,61,0,42
D23,Robbery-Other,2016,3,9,0,6
D23,Other,2016,1,1,1,0
D31,Break & Enter-House,2016,1,10,0,9
D23,Break & Enter-Apartment,2016,1,14,0,13
D22,Other,2016,342,363,0,21
D23,Theft Over $5000,2016,0,4,0,4
D23,Robbery-Other,2016,2,4,0,2
D23,Other,2016,1,1,1,0
D31,Break & Enter-House,2016,3,10,0,7
D23,Break & Enter-Apartment,2016,6,18,0,12
D22,Other,2016,6,7,0,1
D23,Theft Over $5000,2016,0,5,0,5
D22,Other,2016,55,58,0,3
D23,Robbery-Other,2016,6,22,0,16
D22,Other,2016,8,8,1,0
D31,Break & Enter-Other,2016,1,2,0,1
D23,Robbery-Other,2016,37,100,0,63
D22,Other,2016,29,35,0,6
D23,Break & Enter-Apartment,2016,2,7,0,5
D23,Other,2016,1,1,1,0
D23,Theft Over $5000,2016,0,4,0,4
D23,Break & Enter-Apartment,2016,0,4,0,4
D23,Other,2016,1,1,1,0
D31,Break & Enter-Other,2016,0,2,0,2
D23,Robbery-Other,2016,0,3,0,3
D23,Theft Over $5000,2016,0,1,0,1
D22,Other,2016,9,9,1,0
D23,Break & Enter-Apartment,2016,0,7,0,7
D23,Other,2016,3,4,0,1
D31,Break & Enter-Other,2016,0,2,0,2
D23,Robbery-Other,2016,1,4,0,3
D23,Theft Over $5000,2016,0,1,0,1
D22,Other Criminal Violations - Offensive Weapons,2016,1,1,1,0
D23,Break & Enter-Apartment,2016,3,12,0,9
D23,Other,2016,1,1,1,0
D31,Break & Enter-Other,2016,0,2,0,2
D23,Robbery-Other,2016,4,14,0,10
D23,Theft Over $5000,2016,6,41,0,35
D22,Other Criminal Violations - Offensive Weapons,2016,10,10,1,0
D23,Break & Enter-Commercial,2016,0,2,0,2
D23,Other,2016,1,1,1,0
D31,Break & Enter-Other,2016,0,2,0,2
D23,Robbery-Other,2016,8,16,0,8
D23,Theft Over $5000,2016,0,4,0,4
D22,Other Criminal Violations - Offensive Weapons,2016,2,2,1,0
D23,Break & Enter-Commercial,2016,1,7,0,6
D23,Other,2016,2,2,1,0
D31,Break & Enter-Other,2016,0,3,0,3
D23,Robbery-Other,2016,25,83,0,58
D23,Theft Under $5000,2016,0,4,0,4
D22,Other Criminal Violations - Offensive Weapons,2016,4,5,0,1
D23,Break & Enter-Commercial,2016,0,7,0,7
D31,Fraud,2016,14,67,0,53
D23,Robbery-Other,2016,10,46,0,36
D23,Other,2016,1,1,1,0
D23,Break & Enter-Commercial,2016,0,4,0,4
D23,Theft Under $5000,2016,52,118,0,66
D22,Other Criminal Violations - Offensive Weapons,2016,6,7,0,1
D23,Break & Enter-Commercial,2016,1,11,0,10
D31,Other,2016,54,56,0,2
D31,Fraud,2016,12,46,0,34
D23,Sexual Violation,2016,1,1,1,0
D22,Other Criminal Violations - Offensive Weapons,2016,2,2,1,0
D23,Theft Under $5000,2016,4,45,0,41
D23,Break & Enter-Commercial,2016,11,85,0,74
D31,Other,2016,18,18,1,0
D31,Fraud,2016,10,71,0,61
D23,Sexual Violation,2016,2,3,0,1
D22,Other Criminal Violations - Offensive Weapons,2016,5,5,1,0
D23,Theft Under $5000,2016,0,2,0,2
D23,Break & Enter-Commercial,2016,0,5,0,5
D31,Other,2016,135,145,0,10
D31,Fraud,2016,18,67,0,49
D23,Sexual Violation,2016,0,1,0,1
D22,Other Criminal Violations - Offensive Weapons,2016,1,1,1,0
D23,Theft Under $5000,2016,56,170,0,114
D23,Break & Enter-House,2016,0,2,0,2
D31,Other,2016,27,27,1,0
D31,Fraud,2016,10,49,0,39
D23,Sexual Violation,2016,0,1,0,1
D22,Other Criminal Violations - Offensive Weapons,2016,8,8,1,0
D23,Theft Under $5000,2016,99,275,0,176
D23,Break & Enter-House,2016,1,17,0,16
D31,Other,2016,15,16,0,1
D31,Fraud,2016,2,6,0,4
D23,Sexual Violation,2016,4,9,0,5
D22,Other Criminal Violations - Offensive Weapons,2016,1,1,1,0
D23,Theft Under $5000,2016,0,5,0,5
D23,Break & Enter-House,2016,0,11,0,11
D31,Other,2016,4,4,1,0
D31,Fraud,2016,12,68,0,56
D23,Sexual Violation,2016,15,18,0,3
D22,Other Criminal Violations - Offensive Weapons,2016,7,7,1,0
D23,Break & Enter-House,2016,1,8,0,7
D23,Theft Under $5000,2016,0,3,0,3
D31,Other,2016,38,39,0,1
D31,Fraud,2016,6,16,0,10
D22,Other Criminal Violations - Offensive Weapons,2016,2,3,0,1
D23,Sexual Violation,2016,4,8,0,4
D31,Other,2016,8,8,1,0
D31,Fraud,2016,22,160,0,138
D23,Theft Under $5000,2016,9,66,0,57
D23,Break & Enter-House,2016,1,4,0,3
D22,Other Criminal Violations - Offensive Weapons,2016,3,4,0,1
D23,Sexual Violation,2016,3,4,0,1
D31,Other,2016,39,45,0,6
D31,Other,2016,47,115,0,68
D23,Theft Under $5000,2016,11,75,0,64
D23,Break & Enter-House,2016,3,8,0,5
D22,Other,2016,1,1,1,0
D23,Sexual Violation,2016,24,37,0,13
D31,Auto Theft,2016,4,51,0,47
D31,Other,2016,21,59,0,38
D23,Theft Under $5000,2016,182,712,0,530
D23,Break & Enter-House,2016,3,23,0,20
D22,Other,2016,1,1,1,0
D23,Sexual Violation,2016,2,8,0,6
D31,Auto Theft,2016,3,29,0,26
D31,Other,2016,68,203,0,135
D23,Theft Under $5000,2016,27,129,0,102
D23,Break & Enter-House,2016,0,18,0,18
D22,Other,2016,7,10,0,3
D23,Other,2016,9,10,0,1
D31,Auto Theft,2016,8,65,0,57
D31,Other,2016,24,65,0,41
D23,Assault,2016,2,2,1,0
D23,Break & Enter-Other,2016,0,4,0,4
D22,Other,2016,1,2,0,1
D23,Other,2016,2,2,1,0
D31,Auto Theft,2016,2,64,0,62
D31,Other,2016,22,62,0,40
D23,Assault,2016,44,60,0,16
D23,Break & Enter-Other,2016,0,2,0,2
D22,Other,2016,1,1,1,0
D23,Other,2016,6,6,1,0
D31,Auto Theft,2016,1,46,0,45
D31,Other,2016,2,2,1,0
D31,Other,2016,48,116,0,68
D31,Other,2016,7,28,0,21
D31,Other,2016,61,195,0,134
D31,Theft Over $5000,2016,1,8,0,7
D31,Theft Over $5000,2016,1,2,0,1
D31,Theft Over $5000,2016,3,11,0,8
D31,Theft Over $5000,2016,4,18,0,14
D31,Theft Over $5000,2016,0,1,0,1
D31,Theft Over $5000,2016,0,1,0,1
D31,Theft Over $5000,2016,1,8,0,7
D31,Theft Over $5000,2016,0,3,0,3
D22,Other,2016,1,2,0,1
D31,Auto Theft,2016,0,2,0,2
D23,Other,2016,14,14,1,0
D23,Break & Enter-Other,2016,0,1,0,1
D22,Other,2016,2,2,1,0
D23,Assault,2016,12,24,0,12
D31,Auto Theft,2016,5,52,0,47
D23,Other,2016,1,1,1,0
D23,Break & Enter-Other,2016,0,1,0,1
D22,Other,2016,1,1,1,0
D23,Assault,2016,0,1,0,1
D31,Auto Theft,2016,0,14,0,14
D23,Other,2016,16,17,0,1
D23,Break & Enter-Other,2016,2,16,0,14
D22,Other,2016,6,6,1,0
D23,Assault,2016,74,113,0,39
D31,Auto Theft,2016,6,76,0,70
D23,Other,2016,6,6,1,0
D23,Fraud,2016,1,6,0,5
D22,Other,2016,1,2,0,1
D23,Assault,2016,146,233,0,87
D31,Break & Enter-Apartment,2016,6,14,0,8
D23,Other,2016,7,7,1,0
D23,Fraud,2016,7,29,0,22
D23,Other,2016,11,11,1,0
D23,Assault,2016,2,8,0,6
D31,Break & Enter-Apartment,2016,1,2,0,1
D23,Other,2016,53,54,0,1
D23,Fraud,2016,4,21,0,17
D23,Other,2016,8,9,0,1
D23,Assault,2016,1,1,1,0
D31,Break & Enter-Apartment,2016,6,17,0,11
D23,Other,2016,6,7,0,1
D23,Fraud,2016,0,1,0,1
D23,Other,2016,21,22,0,1
D23,Other,2016,43,46,0,3
D23,Other,2016,1,1,1,0
D23,Other,2016,1,1,1,0
D23,Other,2016,10,10,1,0
D23,Other,2016,4,4,1,0
D23,Fraud,2016,21,52,0,31
D31,Break & Enter-Apartment,2016,2,4,0,2
D23,Assault,2016,2,6,0,4
D23,Other,2016,15,19,0,4
D23,Fraud,2016,31,109,0,78
D31,Break & Enter-Apartment,2016,2,5,0,3
D23,Assault,2016,43,62,0,19
D23,Other,2016,12,13,0,1
D23,Fraud,2016,0,1,0,1
D31,Break & Enter-Apartment,2016,1,1,1,0
D23,Assault,2016,31,44,0,13
D23,Other,2016,7,7,1,0
D23,Fraud,2016,0,1,0,1
D23,Assault,2016,165,264,0,99
D23,Assault,2016,53,85,0,32
D23,Attempt Murder,2016,0,1,0,1
D23,Attempt Murder,2016,1,2,0,1
D31,Sexual Violation,2016,0,1,0,1
D31,Sexual Violation,2016,12,21,0,9
D31,Sexual Violation,2016,2,4,0,2
D31,Sexual Violation,2016,27,39,0,12
D31,Other,2016,11,11,1,0
D31,Other,2016,13,13,1,0
D31,Other,2016,29,36,0,7
D31,Other,2016,8,8,1,0
D31,Other,2016,13,15,0,2
D31,Other,2016,2,2,1,0
D31,Other,2016,16,17,0,1
D31,Other,2016,7,7,1,0
D31,Other,2016,19,20,0,1
D31,Other,2016,102,115,0,13
D31,Other,2016,23,27,0,4
D31,Other,2016,1,1,1,0
D31,Other,2016,133,146,0,13
D31,Other,2016,33,44,0,11
D31,Other,2016,244,249,0,5
D32,Break & Enter-Commercial,2016,1,1,1,0
D32,Robbery-Other,2016,1,2,0,1
D32,Theft Over $5000,2016,0,4,0,4
D31,Other,2016,0,1,0,1
D31,Other,2016,4,4,1,0
D31,Other,2016,84,97,0,13
D31,Other,2016,7,9,0,2
D31,Other,2016,2,2,1,0
D31,Other,2016,108,129,0,21
D31,Other Criminal Violations - Offensive Weapons,2016,29,37,0,8
D31,Other Criminal Violations - Offensive Weapons,2016,12,14,0,2
D31,Other Criminal Violations - Offensive Weapons,2016,42,56,0,14
D31,Other Criminal Violations - Offensive Weapons,2016,15,20,0,5
D31,Other Criminal Violations - Offensive Weapons,2016,7,12,0,5
D31,Other Criminal Violations - Offensive Weapons,2016,1,1,1,0
D31,Other Criminal Violations - Offensive Weapons,2016,29,33,0,4
D31,Other Criminal Violations - Offensive Weapons,2016,3,4,0,1
D31,Other Criminal Violations - Offensive Weapons,2016,31,40,0,9
D31,Other,2016,6,7,0,1
D31,Other,2016,2,2,1,0
D31,Other,2016,10,10,1,0
D31,Other,2016,3,3,1,0
D31,Other,2016,4,5,0,1
D31,Other,2016,1,1,1,0
D31,Other,2016,6,6,1,0
D31,Other,2016,1,1,1,0
D31,Other,2016,3,5,0,2
D32,Other,2016,3,4,0,1
D32,Other,2016,1,1,1,0
D32,Other,2016,5,6,0,1
D32,Other,2016,1,1,1,0
D32,Other,2016,12,12,1,0
D32,Other,2016,4,6,0,2
D32,Other,2016,5,6,0,1
D32,Fraud,2016,15,51,0,36
D32,Other,2016,6,6,1,0
D32,Attempt Murder,2016,1,1,1,0
D32,Attempt Murder,2016,1,1,1,0
D32,Theft Over $5000,2016,0,6,0,6
D32,Robbery-Other,2016,3,10,0,7
D32,Fraud,2016,5,19,0,14
D32,Break & Enter-Commercial,2016,0,3,0,3
D32,Attempt Murder,2016,1,2,0,1
D32,Other,2016,6,7,0,1
D32,Theft Over $5000,2016,3,15,0,12
D32,Sexual Violation,2016,4,10,0,6
D32,Fraud,2016,4,42,0,38
D32,Break & Enter-Commercial,2016,1,14,0,13
D32,Break & Enter-Commercial,2016,1,1,1,0
D32,Break & Enter-Commercial,2016,1,7,0,6
D32,Break & Enter-Commercial,2016,2,6,0,4
D32,Break & Enter-Commercial,2016,0,3,0,3
D32,Break & Enter-Commercial,2016,0,4,0,4
D32,Break & Enter-Commercial,2016,0,3,0,3
D32,Break & Enter-Commercial,2016,1,10,0,9
D32,Break & Enter-Commercial,2016,1,1,1,0
D32,Break & Enter-Commercial,2016,0,2,0,2
D32,Break & Enter-Commercial,2016,2,8,0,6
D32,Break & Enter-Commercial,2016,0,3,0,3
D32,Break & Enter-Commercial,2016,0,5,0,5
D32,Break & Enter-Commercial,2016,1,39,0,38
D32,Break & Enter-Commercial,2016,4,24,0,20
D32,Break & Enter-House,2016,1,3,0,2
D32,Break & Enter-House,2016,1,28,0,27
D32,Break & Enter-House,2016,1,54,0,53
D32,Break & Enter-House,2016,1,14,0,13
D32,Break & Enter-House,2016,1,26,0,25
D32,Break & Enter-House,2016,1,6,0,5
D32,Break & Enter-House,2016,1,45,0,44
D32,Break & Enter-House,2016,1,16,0,15
D32,Break & Enter-House,2016,6,35,0,29
D32,Break & Enter-House,2016,1,16,0,15
D32,Break & Enter-House,2016,1,34,0,33
D32,Break & Enter-House,2016,3,31,0,28
D32,Break & Enter-House,2016,1,25,0,24
D32,Break & Enter-House,2016,0,9,0,9
D32,Break & Enter-House,2016,6,27,0,21
D32,Break & Enter-House,2016,1,1,1,0
D32,Break & Enter-House,2016,0,4,0,4
D32,Break & Enter-Other,2016,1,1,1,0
D32,Break & Enter-Other,2016,2,4,0,2
D32,Break & Enter-Other,2016,0,1,0,1
D32,Break & Enter-Other,2016,1,6,0,5
D32,Break & Enter-Other,2016,0,1,0,1
D32,Break & Enter-Other,2016,0,1,0,1
D32,Break & Enter-Other,2016,0,2,0,2
D32,Break & Enter-Other,2016,0,1,0,1
D32,Break & Enter-Other,2016,0,1,0,1
D32,Break & Enter-Other,2016,1,5,0,4
D32,Break & Enter-Other,2016,0,2,0,2
D32,Break & Enter-Other,2016,0,3,0,3
D32,Fraud,2016,6,32,0,26
D32,Fraud,2016,3,50,0,47
D32,Fraud,2016,5,34,0,29
D32,Fraud,2016,1,6,0,5
D32,Other,2016,1,1,1,0
D32,Sexual Violation,2016,1,3,0,2
D32,Theft Over $5000,2016,4,22,0,18
D32,Other,2016,1,2,0,1
D32,Fraud,2016,4,37,0,33
D32,Attempt Murder,2016,1,1,1,0
D32,Sexual Violation,2016,3,5,0,2
D32,Theft Under $5000,2016,32,107,0,75
D32,Attempt Murder,2016,1,1,1,0
D32,Fraud,2016,3,47,0,44
D32,Sexual Violation,2016,8,15,0,7
D32,Other,2016,4,6,0,2
D32,Theft Under $5000,2016,17,76,0,59
D32,Other,2016,9,15,0,6
D32,Fraud,2016,3,29,0,26
D32,Sexual Violation,2016,0,1,0,1
D32,Other,2016,8,8,1,0
D32,Theft Under $5000,2016,0,1,0,1
D32,Other,2016,8,17,0,9
D32,Fraud,2016,0,4,0,4
D32,Sexual Violation,2016,4,7,0,3
D32,Other,2016,1,1,1,0
D32,Theft Under $5000,2016,0,2,0,2
D32,Other,2016,0,1,0,1
D32,Fraud,2016,5,39,0,34
D32,Sexual Violation,2016,1,4,0,3
D32,Other,2016,8,9,0,1
D32,Theft Under $5000,2016,15,121,0,106
D32,Other,2016,4,12,0,8
D32,Fraud,2016,11,56,0,45
D32,Sexual Violation,2016,7,12,0,5
D32,Other,2016,3,6,0,3
D32,Theft Under $5000,2016,2,17,0,15
D32,Other,2016,0,3,0,3
D32,Fraud,2016,3,21,0,18
D32,Sexual Violation,2016,5,7,0,2
D32,Other,2016,6,9,0,3
D32,Theft Under $5000,2016,110,255,0,145
D32,Other,2016,13,25,0,12
D32,Fraud,2016,6,57,0,51
D32,Sexual Violation,2016,4,8,0,4
D32,Other,2016,8,10,0,2
D32,Theft Under $5000,2016,3,60,0,57
D32,Other,2016,4,11,0,7
D32,Fraud,2016,12,71,0,59
D32,Fraud,2016,12,63,0,51
D32,Fraud,2016,11,74,0,63
D32,Fraud,2016,44,110,0,66
D32,Other,2016,8,30,0,22
D32,Other,2016,20,49,0,29
D32,Other,2016,1,1,1,0
D32,Other,2016,1,2,0,1
D32,Other,2016,4,58,0,54
D32,Other,2016,1,9,0,8
D32,Other,2016,14,65,0,51
D32,Other,2016,7,28,0,21
D32,Other,2016,7,45,0,38
D32,Other,2016,15,55,0,40
D32,Other,2016,12,70,0,58
D32,Other,2016,2,29,0,27
D32,Other,2016,2,3,0,1
D32,Other,2016,17,57,0,40
D32,Other,2016,21,80,0,59
D32,Other,2016,7,22,0,15
D32,Other,2016,9,45,0,36
D32,Other,2016,15,51,0,36
D32,Other,2016,22,59,0,37
D32,Other,2016,9,41,0,32
D32,Other,2016,296,369,0,73
D32,Theft Over $5000,2016,1,6,0,5
D32,Theft Over $5000,2016,1,4,0,3
D32,Theft Over $5000,2016,1,9,0,8
D32,Theft Over $5000,2016,0,2,0,2
D32,Theft Over $5000,2016,2,6,0,4
D32,Theft Over $5000,2016,0,1,0,1
D32,Theft Over $5000,2016,0,4,0,4
D32,Theft Over $5000,2016,1,5,0,4
D32,Theft Over $5000,2016,0,4,0,4
D32,Theft Over $5000,2016,0,3,0,3
D32,Theft Over $5000,2016,1,5,0,4
D32,Theft Over $5000,2016,1,6,0,5
D32,Theft Over $5000,2016,0,5,0,5
D32,Theft Over $5000,2016,0,7,0,7
D32,Other,2016,14,23,0,9
D32,Sexual Violation,2016,2,2,1,0
D32,Theft Under $5000,2016,1,64,0,63
D32,Other,2016,7,17,0,10
D32,Other,2016,27,29,0,2
D32,Sexual Violation,2016,2,6,0,4
D32,Theft Under $5000,2016,65,168,0,103
D32,Other,2016,9,21,0,12
D32,Auto Theft,2016,0,7,0,7
D32,Sexual Violation,2016,7,12,0,5
D32,Theft Under $5000,2016,36,187,0,151
D32,Auto Theft,2016,1,25,0,24
D32,Other,2016,6,10,0,4
D32,Sexual Violation,2016,2,3,0,1
D32,Other,2016,0,1,0,1
D32,Auto Theft,2016,0,14,0,14
D32,Sexual Violation,2016,5,13,0,8
D32,Other,2016,7,19,0,12
D32,Theft Under $5000,2016,6,61,0,55
D32,Auto Theft,2016,0,7,0,7
D32,Sexual Violation,2016,4,16,0,12
D32,Other,2016,23,44,0,21
D32,Theft Under $5000,2016,0,4,0,4
D32,Auto Theft,2016,5,54,0,49
D32,Sexual Violation,2016,0,1,0,1
D32,Other,2016,13,16,0,3
D32,Theft Under $5000,2016,28,128,0,100
D32,Auto Theft,2016,1,10,0,9
D32,Sexual Violation,2016,7,10,0,3
D32,Other,2016,20,41,0,21
D32,Theft Under $5000,2016,53,231,0,178
D32,Auto Theft,2016,0,33,0,33
D32,Sexual Violation,2016,1,1,1,0
D32,Other,2016,11,26,0,15
D32,Theft Under $5000,2016,0,1,0,1
D32,Auto Theft,2016,0,12,0,12
D32,Sexual Violation,2016,5,20,0,15
D32,Other,2016,7,17,0,10
D32,Theft Under $5000,2016,0,53,0,53
D32,Auto Theft,2016,4,28,0,24
D32,Other,2016,4,5,0,1
D32,Other,2016,5,19,0,14
D32,Theft Under $5000,2016,4,94,0,90
D32,Auto Theft,2016,0,14,0,14
D32,Other,2016,10,10,1,0
D32,Other,2016,16,41,0,25
D32,Theft Under $5000,2016,14,144,0,130
D32,Auto Theft,2016,0,1,0,1
D32,Other,2016,1,1,1,0
D32,Robbery-Financial,2016,0,1,0,1
D32,Theft Under $5000,2016,159,290,0,131
D32,Auto Theft,2016,0,1,0,1
D32,Other,2016,10,10,1,0
D32,Robbery-Financial,2016,1,1,1,0
D32,Theft Under $5000,2016,178,370,0,192
D32,Theft Under $5000,2016,635,931,0,296
D32,Assault,2016,30,41,0,11
D32,Assault,2016,44,58,0,14
D32,Assault,2016,13,30,0,17
D32,Assault,2016,6,8,0,2
D32,Assault,2016,33,55,0,22
D32,Assault,2016,23,46,0,23
D32,Assault,2016,27,44,0,17
D32,Assault,2016,51,96,0,45
D32,Assault,2016,31,57,0,26
D32,Assault,2016,11,22,0,11
D32,Assault,2016,2,5,0,3
D32,Assault,2016,47,78,0,31
D32,Assault,2016,77,123,0,46
D32,Assault,2016,0,1,0,1
D32,Assault,2016,17,24,0,7
D32,Assault,2016,76,100,0,24
D32,Assault,2016,63,91,0,28
D32,Assault,2016,43,64,0,21
D32,Assault,2016,25,57,0,32
D32,Assault,2016,75,112,0,37
D32,Attempt Murder,2016,0,2,0,2
D32,Attempt Murder,2016,1,4,0,3
D32,Attempt Murder,2016,1,1,1,0
D32,Attempt Murder,2016,2,3,0,1
D32,Robbery-Financial,2016,1,1,1,0
D32,Robbery-Financial,2016,4,4,1,0
D32,Robbery-Financial,2016,1,1,1,0
D32,Robbery-Financial,2016,1,1,1,0
D32,Robbery-Financial,2016,3,3,1,0
D32,Robbery-Financial,2016,1,1,1,0
D32,Robbery-Financial,2016,0,1,0,1
D32,Robbery-Other,2016,2,3,0,1
D32,Robbery-Other,2016,5,11,0,6
D32,Robbery-Other,2016,1,1,1,0
D32,Robbery-Other,2016,1,12,0,11
D32,Robbery-Other,2016,3,5,0,2
D32,Robbery-Other,2016,0,2,0,2
D32,Robbery-Other,2016,3,14,0,11
D32,Robbery-Other,2016,4,30,0,26
D32,Robbery-Other,2016,2,5,0,3
D32,Robbery-Other,2016,1,3,0,2
D32,Robbery-Other,2016,2,9,0,7
D32,Robbery-Other,2016,3,16,0,13
D32,Robbery-Other,2016,0,5,0,5
D32,Robbery-Other,2016,2,9,0,7
D32,Robbery-Other,2016,0,7,0,7
D32,Robbery-Other,2016,10,22,0,12
D32,Other,2016,3,4,0,1
D32,Auto Theft,2016,0,4,0,4
D32,Other,2016,9,11,0,2
D32,Other,2016,5,5,1,0
D32,Other,2016,2,2,1,0
D32,Other,2016,7,7,1,0
D32,Other,2016,5,6,0,1
D32,Other,2016,2,2,1,0
D32,Other,2016,1,1,1,0
D32,Other,2016,14,14,1,0
D32,Other,2016,7,7,1,0
D32,Other,2016,5,5,1,0
D32,Other,2016,4,5,0,1
D32,Other,2016,6,6,1,0
D32,Other,2016,8,9,0,1
D32,Other,2016,5,5,1,0
D32,Other,2016,13,13,1,0
D32,Other,2016,9,12,0,3
D32,Other,2016,10,17,0,7
D32,Other,2016,2,2,1,0
D32,Other,2016,1,1,1,0
D32,Other,2016,7,9,0,2
D32,Other,2016,1,1,1,0
D32,Other,2016,41,49,0,8
D32,Other,2016,11,12,0,1
D32,Auto Theft,2016,0,8,0,8
D32,Auto Theft,2016,3,53,0,50
D32,Auto Theft,2016,1,5,0,4
D32,Auto Theft,2016,3,25,0,22
D32,Auto Theft,2016,1,12,0,11
D32,Auto Theft,2016,0,7,0,7
D32,Auto Theft,2016,2,35,0,33
D32,Auto Theft,2016,0,28,0,28
D32,Break & Enter-Apartment,2016,0,3,0,3
D32,Break & Enter-Apartment,2016,0,1,0,1
D32,Break & Enter-Apartment,2016,1,2,0,1
D32,Break & Enter-Apartment,2016,0,2,0,2
D32,Break & Enter-Apartment,2016,1,1,1,0
D32,Break & Enter-Apartment,2016,0,5,0,5
D32,Break & Enter-Apartment,2016,1,4,0,3
D32,Break & Enter-Apartment,2016,0,2,0,2
D32,Break & Enter-Apartment,2016,0,1,0,1
D32,Break & Enter-Apartment,2016,0,5,0,5
D32,Break & Enter-Apartment,2016,1,15,0,14
D32,Break & Enter-Apartment,2016,0,3,0,3
D32,Break & Enter-Apartment,2016,2,10,0,8
D32,Break & Enter-Apartment,2016,3,6,0,3
D32,Break & Enter-Apartment,2016,4,6,0,2
D32,Break & Enter-Apartment,2016,0,2,0,2
D32,Break & Enter-Apartment,2016,2,5,0,3
D32,Other,2016,11,15,0,4
D32,Other,2016,33,36,0,3
D32,Other,2016,5,5,1,0
D32,Other,2016,13,16,0,3
D32,Other,2016,7,9,0,2
D32,Other,2016,2,3,0,1
D32,Other,2016,20,25,0,5
D32,Other,2016,35,38,0,3
D32,Other,2016,5,5,1,0
D32,Other,2016,27,34,0,7
D32,Other,2016,43,51,0,8
D32,Other,2016,2,2,1,0
D32,Other,2016,36,41,0,5
D32,Other,2016,206,220,0,14
D32,Other,2016,78,87,0,9
D32,Other Criminal Violations - Offensive Weapons,2016,4,4,1,0
D32,Other Criminal Violations - Offensive Weapons,2016,4,5,0,1
D32,Other Criminal Violations - Offensive Weapons,2016,2,2,1,0
D32,Other Criminal Violations - Offensive Weapons,2016,1,3,0,2
D32,Other Criminal Violations - Offensive Weapons,2016,3,5,0,2
D32,Other Criminal Violations - Offensive Weapons,2016,3,4,0,1
D32,Other Criminal Violations - Offensive Weapons,2016,7,7,1,0
D32,Other Criminal Violations - Offensive Weapons,2016,6,6,1,0
D32,Other Criminal Violations - Offensive Weapons,2016,0,1,0,1
D32,Other Criminal Violations - Offensive Weapons,2016,3,8,0,5
D32,Other Criminal Violations - Offensive Weapons,2016,7,11,0,4
D32,Other Criminal Violations - Offensive Weapons,2016,8,9,0,1
D32,Other Criminal Violations - Offensive Weapons,2016,5,5,1,0
D32,Other Criminal Violations - Offensive Weapons,2016,5,6,0,1
D32,Other Criminal Violations - Offensive Weapons,2016,6,8,0,2
D32,Other Criminal Violations - Offensive Weapons,2016,10,10,1,0
D32,Other,2016,1,1,1,0
D32,Other,2016,2,2,1,0
D32,Other,2016,0,1,0,1
D32,Other,2016,1,1,1,0
D32,Other,2016,1,1,1,0
D32,Other,2016,1,1,1,0
D32,Other,2016,3,4,0,1
D32,Other,2016,3,4,0,1
D32,Other,2016,3,3,1,0
D32,Other,2016,2,3,0,1
D33,Other,2016,14,19,0,5
D33,Other,2016,10,11,0,1
D33,Other,2016,9,9,1,0
D33,Other,2016,24,25,0,1
D33,Other,2016,10,10,1,0
D33,Other,2016,2,2,1,0
D33,Other,2016,12,13,0,1
D33,Other,2016,6,7,0,1
D33,Other,2016,2,2,1,0
D33,Theft Over $5000,2016,0,3,0,3
D33,Other,2016,3,3,1,0
D33,Other,2016,3,3,1,0
D33,Other,2016,61,68,0,7
D33,Other,2016,30,40,0,10
D33,Other,2016,14,17,0,3
D33,Other,2016,1,1,1,0
D33,Other,2016,55,62,0,7
D33,Other,2016,41,47,0,6
D33,Other,2016,4,4,1,0
D33,Other,2016,20,21,0,1
D33,Other,2016,17,20,0,3
D33,Other,2016,3,3,1,0
D33,Other,2016,4,5,0,1
D33,Other,2016,17,20,0,3
D33,Other,2016,12,16,0,4
D33,Other,2016,22,22,1,0
D33,Other,2016,28,29,0,1
D33,Other,2016,2,2,1,0
D33,Other,2016,7,7,1,0
D33,Other,2016,11,12,0,1
D33,Other Criminal Violations - Offensive Weapons,2016,10,10,1,0
D33,Other Criminal Violations - Offensive Weapons,2016,5,5,1,0
D33,Other Criminal Violations - Offensive Weapons,2016,2,2,1,0
D33,Other Criminal Violations - Offensive Weapons,2016,7,7,1,0
D33,Other Criminal Violations - Offensive Weapons,2016,5,7,0,2
D33,Other,2016,6,9,0,3
D33,Other Criminal Violations - Offensive Weapons,2016,2,2,1,0
D33,Other Criminal Violations - Offensive Weapons,2016,10,10,1,0
D33,Other Criminal Violations - Offensive Weapons,2016,3,3,1,0
D33,Other Criminal Violations - Offensive Weapons,2016,0,1,0,1
D33,Other Criminal Violations - Offensive Weapons,2016,2,2,1,0
D33,Other Criminal Violations - Offensive Weapons,2016,2,2,1,0
D33,Other Criminal Violations - Offensive Weapons,2016,4,4,1,0
D33,Other,2016,2,2,1,0
D41,Other,2016,5,5,1,0
D41,Other,2016,16,16,1,0
D41,Other,2016,30,33,0,3
D41,Other,2016,53,56,0,3
D41,Other,2016,10,10,1,0
D41,Other,2016,58,63,0,5
D41,Other,2016,9,10,0,1
D41,Other,2016,10,12,0,2
D41,Other,2016,36,38,0,2
D41,Other,2016,3,4,0,1
D41,Other,2016,55,60,0,5
D41,Other,2016,21,24,0,3
D41,Auto Theft,2016,0,2,0,2
D41,Auto Theft,2016,3,21,0,18
D41,Auto Theft,2016,3,17,0,14
D41,Auto Theft,2016,4,51,0,47
D41,Auto Theft,2016,1,11,0,10
D33,Break & Enter-House,2016,6,20,0,14
D33,Other,2016,2,3,0,1
D33,Other,2016,13,16,0,3
D41,Fraud,2016,0,10,0,10
D41,Auto Theft,2016,6,45,0,39
D33,Theft Over $5000,2016,1,4,0,3
D33,Other,2016,3,3,1,0
D33,Theft Over $5000,2016,0,2,0,2
D33,Other,2016,4,4,1,0
D41,Fraud,2016,1,23,0,22
D33,Theft Under $5000,2016,152,323,0,171
D33,Break & Enter-House,2016,0,12,0,12
D33,Other,2016,3,3,1,0
D33,Other,2016,11,25,0,14
D41,Auto Theft,2016,0,9,0,9
D41,Fraud,2016,6,62,0,56
D33,Theft Under $5000,2016,136,351,0,215
D33,Break & Enter-House,2016,5,24,0,19
D33,Other,2016,11,11,1,0
D33,Robbery-Financial,2016,1,1,1,0
D41,Auto Theft,2016,0,6,0,6
D41,Fraud,2016,17,98,0,81
D41,Fraud,2016,1,10,0,9
D41,Fraud,2016,8,72,0,64
D41,Fraud,2016,3,17,0,14
D41,Fraud,2016,11,46,0,35
D41,Fraud,2016,8,50,0,42
D41,Fraud,2016,0,1,0,1
D41,Fraud,2016,0,2,0,2
D41,Fraud,2016,6,46,0,40
D41,Fraud,2016,32,127,0,95
D41,Other,2016,2,9,0,7
D41,Other,2016,13,39,0,26
D41,Other,2016,32,111,0,79
D41,Other,2016,69,161,0,92
D41,Other,2016,11,38,0,27
D41,Other,2016,39,106,0,67
D41,Other,2016,15,43,0,28
D41,Other,2016,28,55,0,27
D41,Other,2016,47,116,0,69
D41,Other,2016,1,4,0,3
D41,Other,2016,52,101,0,49
D41,Other,2016,77,193,0,116
D41,Theft Over $5000,2016,1,2,0,1
D41,Theft Over $5000,2016,2,3,0,1
D41,Theft Over $5000,2016,1,6,0,5
D41,Theft Over $5000,2016,4,18,0,14
D41,Theft Over $5000,2016,0,2,0,2
D41,Theft Over $5000,2016,1,12,0,11
D41,Theft Over $5000,2016,3,4,0,1
D41,Theft Over $5000,2016,0,5,0,5
D41,Theft Over $5000,2016,3,10,0,7
D41,Theft Over $5000,2016,3,13,0,10
D41,Theft Under $5000,2016,3,27,0,24
D41,Theft Under $5000,2016,56,92,0,36
D41,Theft Under $5000,2016,70,237,0,167
D41,Theft Under $5000,2016,1,1,1,0
D41,Theft Under $5000,2016,158,411,0,253
D41,Theft Under $5000,2016,4,33,0,29
D41,Theft Under $5000,2016,58,246,0,188
D41,Theft Under $5000,2016,8,37,0,29
D41,Theft Under $5000,2016,40,81,0,41
D41,Theft Under $5000,2016,63,215,0,152
D41,Theft Under $5000,2016,0,1,0,1
D41,Theft Under $5000,2016,14,26,0,12
D41,Theft Under $5000,2016,176,483,0,307
D41,Theft Under $5000,2016,419,819,0,400
D41,Assault,2016,11,23,0,12
D41,Assault,2016,42,55,0,13
D33,Theft Under $5000,2016,16,64,0,48
D33,Theft Under $5000,2016,1,9,0,8
D33,Theft Under $5000,2016,293,486,0,193
D33,Theft Under $5000,2016,24,108,0,84
D33,Theft Under $5000,2016,0,1,0,1
D33,Theft Under $5000,2016,13,82,0,69
D33,Theft Under $5000,2016,53,119,0,66
D33,Theft Under $5000,2016,4,11,0,7
D33,Theft Under $5000,2016,29,95,0,66
D33,Theft Under $5000,2016,27,57,0,30
D33,Theft Under $5000,2016,40,108,0,68
D33,Theft Under $5000,2016,1,1,1,0
D33,Theft Under $5000,2016,23,73,0,50
D33,Theft Under $5000,2016,1,2,0,1
D33,Assault,2016,46,69,0,23
D33,Assault,2016,52,69,0,17
D33,Assault,2016,18,33,0,15
D33,Assault,2016,1,3,0,2
D33,Assault,2016,1,1,1,0
D33,Assault,2016,76,121,0,45
D33,Assault,2016,76,102,0,26
D33,Assault,2016,1,4,0,3
D33,Assault,2016,47,61,0,14
D33,Assault,2016,30,36,0,6
D33,Assault,2016,2,5,0,3
D33,Assault,2016,1,3,0,2
D33,Assault,2016,28,42,0,14
D33,Other,2016,1,1,1,0
D33,Assault,2016,37,45,0,8
D41,Assault,2016,124,180,0,56
D41,Assault,2016,151,223,0,72
D41,Assault,2016,21,29,0,8
D41,Assault,2016,110,164,0,54
D41,Assault,2016,48,72,0,24
D41,Assault,2016,71,86,0,15
D41,Assault,2016,132,183,0,51
D41,Assault,2016,2,3,0,1
D41,Assault,2016,75,121,0,46
D41,Assault,2016,125,169,0,44
D41,Attempt Murder,2016,1,1,1,0
D41,Attempt Murder,2016,1,1,1,0
D41,Attempt Murder,2016,1,1,1,0
D41,Attempt Murder,2016,0,2,0,2
D41,Other,2016,17,26,0,9
D41,Other,2016,10,16,0,6
D41,Other,2016,23,36,0,13
D41,Other,2016,28,49,0,21
D41,Other,2016,5,9,0,4
D41,Other,2016,22,42,0,20
D41,Other,2016,14,24,0,10
D41,Other,2016,26,37,0,11
D41,Other,2016,32,58,0,26
D41,Other,2016,18,33,0,15
D41,Other,2016,37,49,0,12
D41,Robbery-Financial,2016,1,1,1,0
D41,Robbery-Other,2016,5,7,0,2
D41,Robbery-Other,2016,5,16,0,11
D41,Robbery-Other,2016,7,19,0,12
D41,Robbery-Other,2016,20,38,0,18
D41,Robbery-Other,2016,2,7,0,5
D41,Robbery-Other,2016,26,50,0,24
D41,Robbery-Other,2016,3,16,0,13
D41,Robbery-Other,2016,1,9,0,8
D41,Robbery-Other,2016,11,27,0,16
D41,Robbery-Other,2016,7,13,0,6
D41,Robbery-Other,2016,9,25,0,16
D41,Robbery-Other,2016,5,17,0,12
D41,Sexual Violation,2016,3,3,1,0
D41,Sexual Violation,2016,4,6,0,2
D41,Sexual Violation,2016,8,12,0,4
D41,Sexual Violation,2016,11,16,0,5
D41,Sexual Violation,2016,16,19,0,3
D33,Auto Theft,2016,3,11,0,8
D41,Auto Theft,2016,3,14,0,11
D33,Robbery-Financial,2016,2,2,1,0
D33,Break & Enter-House,2016,1,20,0,19
D33,Break & Enter-House,2016,0,2,0,2
D33,Auto Theft,2016,1,14,0,13
D33,Assault,2016,15,23,0,8
D41,Sexual Violation,2016,4,5,0,1
D33,Auto Theft,2016,2,18,0,16
D33,Assault,2016,39,50,0,11
D33,Break & Enter-Other,2016,2,2,1,0
D41,Auto Theft,2016,4,11,0,7
D33,Robbery-Other,2016,18,21,0,3
D33,Auto Theft,2016,4,30,0,26
D33,Assault,2016,3,9,0,6
D41,Sexual Violation,2016,6,11,0,5
D33,Robbery-Other,2016,6,9,0,3
D41,Auto Theft,2016,7,44,0,37
D33,Break & Enter-Other,2016,0,1,0,1
D33,Auto Theft,2016,1,17,0,16
D33,Attempt Murder,2016,1,1,1,0
D41,Sexual Violation,2016,16,22,0,6
D33,Robbery-Other,2016,6,19,0,13
D41,Break & Enter-Apartment,2016,0,2,0,2
D33,Break & Enter-Other,2016,1,2,0,1
D33,Auto Theft,2016,0,1,0,1
D33,Attempt Murder,2016,0,1,0,1
D41,Sexual Violation,2016,8,14,0,6
D33,Robbery-Other,2016,6,20,0,14
D33,Robbery-Other,2016,0,1,0,1
D33,Robbery-Other,2016,1,6,0,5
D33,Robbery-Other,2016,7,14,0,7
D33,Robbery-Other,2016,0,1,0,1
D33,Robbery-Other,2016,0,1,0,1
D33,Robbery-Other,2016,2,11,0,9
D33,Robbery-Other,2016,1,9,0,8
D33,Robbery-Other,2016,5,9,0,4
D33,Robbery-Other,2016,1,1,1,0
D33,Robbery-Other,2016,1,8,0,7
D33,Robbery-Other,2016,1,1,1,0
D33,Sexual Violation,2016,4,7,0,3
D33,Sexual Violation,2016,9,11,0,2
D33,Sexual Violation,2016,1,7,0,6
D33,Sexual Violation,2016,1,2,0,1
D33,Sexual Violation,2016,12,17,0,5
D33,Sexual Violation,2016,6,9,0,3
D33,Sexual Violation,2016,10,13,0,3
D33,Sexual Violation,2016,6,12,0,6
D33,Sexual Violation,2016,0,1,0,1
D33,Sexual Violation,2016,0,2,0,2
D33,Sexual Violation,2016,0,1,0,1
D33,Sexual Violation,2016,2,4,0,2
D33,Sexual Violation,2016,3,5,0,2
D33,Sexual Violation,2016,4,5,0,1
D33,Sexual Violation,2016,3,3,1,0
D33,Sexual Violation,2016,1,1,1,0
D33,Other,2016,17,17,1,0
D33,Other,2016,16,16,1,0
D33,Other,2016,3,3,1,0
D33,Other,2016,2,2,1,0
D33,Other,2016,1,1,1,0
D33,Other,2016,11,11,1,0
D33,Other,2016,4,4,1,0
D33,Other,2016,12,12,1,0
D33,Other,2016,8,8,1,0
D33,Other,2016,2,2,1,0
D33,Other,2016,2,2,1,0
D33,Other,2016,8,8,1,0
D33,Other,2016,5,5,1,0
D33,Other,2016,6,6,1,0
D33,Break & Enter-Other,2016,1,1,1,0
D33,Break & Enter-Other,2016,4,6,0,2
D33,Break & Enter-Other,2016,0,3,0,3
D33,Fraud,2016,23,103,0,80
D33,Fraud,2016,18,71,0,53
D33,Fraud,2016,3,29,0,26
D33,Fraud,2016,19,88,0,69
D33,Fraud,2016,1,30,0,29
D33,Fraud,2016,5,33,0,28
D33,Fraud,2016,9,54,0,45
D33,Fraud,2016,4,32,0,28
D33,Fraud,2016,8,28,0,20
D33,Fraud,2016,3,31,0,28
D33,Fraud,2016,0,1,0,1
D33,Fraud,2016,4,26,0,22
D33,Fraud,2016,1,1,1,0
D33,Fraud,2016,0,1,0,1
D33,Other,2016,26,76,0,50
D33,Other,2016,23,64,0,41
D33,Other,2016,5,20,0,15
D33,Other,2016,1,5,0,4
D33,Other,2016,0,1,0,1
D33,Other,2016,43,103,0,60
D33,Other,2016,29,70,0,41
D33,Other,2016,1,1,1,0
D33,Other,2016,9,44,0,35
D33,Other,2016,16,42,0,26
D33,Other,2016,1,4,0,3
D33,Other,2016,0,1,0,1
D33,Other,2016,15,42,0,27
D33,Other,2016,9,27,0,18
D33,Other,2016,7,29,0,22
D33,Other,2016,10,31,0,21
D33,Other,2016,5,6,0,1
D33,Theft Over $5000,2016,3,11,0,8
D33,Theft Over $5000,2016,1,5,0,4
D33,Theft Over $5000,2016,0,2,0,2
D33,Theft Over $5000,2016,4,8,0,4
D33,Theft Over $5000,2016,2,2,1,0
D33,Theft Over $5000,2016,1,1,1,0
D33,Theft Over $5000,2016,0,2,0,2
D41,Break & Enter-Apartment,2016,2,7,0,5
D41,Break & Enter-Apartment,2016,5,20,0,15
D41,Break & Enter-Apartment,2016,3,14,0,11
D41,Break & Enter-Apartment,2016,0,4,0,4
D41,Break & Enter-Apartment,2016,7,15,0,8
D33,Auto Theft,2016,2,10,0,8
D41,Break & Enter-Apartment,2016,4,16,0,12
D41,Break & Enter-Apartment,2016,5,12,0,7
D33,Auto Theft,2016,2,22,0,20
D33,Attempt Murder,2016,0,1,0,1
D41,Sexual Violation,2016,12,15,0,3
D41,Break & Enter-Apartment,2016,5,14,0,9
D33,Auto Theft,2016,1,1,1,0
D33,Theft Over $5000,2016,0,1,0,1
D33,Attempt Murder,2016,0,1,0,1
D33,Other,2016,22,50,0,28
D33,Other,2016,13,25,0,12
D33,Other,2016,8,10,0,2
D33,Other,2016,1,1,1,0
D41,Sexual Violation,2016,1,1,1,0
D33,Other,2016,21,33,0,12
D41,Break & Enter-Apartment,2016,7,23,0,16
D33,Auto Theft,2016,1,10,0,9
D33,Other,2016,30,38,0,8
D41,Break & Enter-Apartment,2016,2,8,0,6
D33,Auto Theft,2016,0,7,0,7
D33,Other,2016,9,19,0,10
D41,Break & Enter-Commercial,2016,0,3,0,3
D33,Auto Theft,2016,0,5,0,5
D33,Other,2016,16,23,0,7
D41,Break & Enter-Commercial,2016,1,4,0,3
D33,Auto Theft,2016,0,15,0,15
D33,Other,2016,3,5,0,2
D41,Break & Enter-Commercial,2016,5,17,0,12
D33,Other,2016,7,9,0,2
D33,Break & Enter-Apartment,2016,4,16,0,12
D41,Break & Enter-Commercial,2016,10,42,0,32
D33,Break & Enter-Apartment,2016,1,11,0,10
D41,Break & Enter-Commercial,2016,3,7,0,4
D33,Break & Enter-Apartment,2016,2,3,0,1
D33,Break & Enter-Apartment,2016,5,28,0,23
D41,Break & Enter-Commercial,2016,6,36,0,30
D33,Break & Enter-Apartment,2016,3,16,0,13
D41,Break & Enter-Commercial,2016,2,8,0,6
D33,Break & Enter-Apartment,2016,1,4,0,3
D41,Break & Enter-Commercial,2016,1,2,0,1
D33,Break & Enter-Apartment,2016,1,3,0,2
D41,Break & Enter-Commercial,2016,3,8,0,5
D33,Break & Enter-Apartment,2016,0,7,0,7
D41,Break & Enter-Commercial,2016,0,2,0,2
D33,Break & Enter-Apartment,2016,0,3,0,3
D41,Break & Enter-Commercial,2016,1,17,0,16
D33,Break & Enter-Apartment,2016,0,1,0,1
D41,Break & Enter-Commercial,2016,7,29,0,22
D33,Break & Enter-Apartment,2016,1,6,0,5
D41,Break & Enter-House,2016,3,6,0,3
D33,Break & Enter-Commercial,2016,2,7,0,5
D41,Break & Enter-House,2016,6,11,0,5
D33,Break & Enter-Commercial,2016,0,1,0,1
D41,Break & Enter-House,2016,11,36,0,25
D33,Break & Enter-Commercial,2016,0,2,0,2
D41,Break & Enter-House,2016,3,28,0,25
D33,Break & Enter-Commercial,2016,2,5,0,3
D41,Break & Enter-House,2016,1,9,0,8
D33,Break & Enter-Commercial,2016,0,1,0,1
D41,Break & Enter-House,2016,2,19,0,17
D33,Break & Enter-Commercial,2016,1,6,0,5
D41,Break & Enter-House,2016,1,6,0,5
D33,Break & Enter-Commercial,2016,1,5,0,4
D41,Break & Enter-House,2016,1,3,0,2
D33,Break & Enter-Commercial,2016,0,1,0,1
D41,Break & Enter-House,2016,8,23,0,15
D33,Break & Enter-Commercial,2016,0,3,0,3
D41,Break & Enter-House,2016,1,16,0,15
D41,Break & Enter-House,2016,2,35,0,33
D33,Break & Enter-Commercial,2016,0,2,0,2
D41,Break & Enter-Other,2016,0,2,0,2
D33,Break & Enter-Commercial,2016,0,2,0,2
D41,Break & Enter-Other,2016,0,3,0,3
D33,Break & Enter-Commercial,2016,0,2,0,2
D41,Break & Enter-Other,2016,2,3,0,1
D33,Break & Enter-Commercial,2016,0,1,0,1
D41,Break & Enter-Other,2016,1,3,0,2
D33,Break & Enter-House,2016,1,32,0,31
D41,Break & Enter-Other,2016,1,3,0,2
D33,Break & Enter-House,2016,3,20,0,17
D41,Break & Enter-Other,2016,0,1,0,1
D33,Break & Enter-House,2016,8,28,0,20
D41,Break & Enter-Other,2016,1,2,0,1
D33,Break & Enter-House,2016,0,8,0,8
D41,Break & Enter-Other,2016,0,1,0,1
D33,Break & Enter-House,2016,2,31,0,29
D41,Break & Enter-Other,2016,0,3,0,3
D33,Break & Enter-House,2016,0,6,0,6
D41,Break & Enter-Other,2016,0,3,0,3
D33,Break & Enter-House,2016,0,2,0,2
D41,Other,2016,6,6,1,0
D41,Other,2016,3,3,1,0
D41,Other,2016,15,16,0,1
D41,Other,2016,33,34,0,1
D41,Other,2016,5,5,1,0
D41,Other,2016,28,29,0,1
D41,Other,2016,3,3,1,0
D41,Other,2016,6,6,1,0
D41,Other,2016,14,16,0,2
D41,Other,2016,3,3,1,0
D41,Other,2016,12,13,0,1
D41,Other,2016,38,39,0,1
D41,Other,2016,22,23,0,1
D41,Other,2016,21,22,0,1
D41,Other,2016,75,77,0,2
D41,Other,2016,332,345,0,13
D41,Other,2016,18,22,0,4
D41,Other,2016,209,224,0,15
D41,Other,2016,35,38,0,3
D41,Other,2016,104,115,0,11
D41,Other,2016,122,128,0,6
D41,Other,2016,3,3,1,0
D42,Theft Under $5000,2016,11,94,0,83
D42,Other,2016,14,15,0,1
D41,Other,2016,166,175,0,9
D41,Other,2016,130,137,0,7
D41,Other,2016,18,18,1,0
D41,Other,2016,1,1,1,0
D41,Other Criminal Violations - Offensive Weapons,2016,4,4,1,0
D41,Other Criminal Violations - Offensive Weapons,2016,8,8,1,0
D43,Break & Enter-Apartment,2016,1,3,0,2
D41,Other Criminal Violations - Offensive Weapons,2016,13,13,1,0
D41,Other Criminal Violations - Offensive Weapons,2016,29,30,0,1
D41,Other Criminal Violations - Offensive Weapons,2016,5,6,0,1
D41,Other Criminal Violations - Offensive Weapons,2016,23,27,0,4
D41,Other Criminal Violations - Offensive Weapons,2016,7,8,0,1
D41,Other Criminal Violations - Offensive Weapons,2016,4,4,1,0
D41,Other Criminal Violations - Offensive Weapons,2016,7,9,0,2
D41,Other Criminal Violations - Offensive Weapons,2016,1,1,1,0
D41,Other Criminal Violations - Offensive Weapons,2016,9,10,0,1
D41,Other Criminal Violations - Offensive Weapons,2016,7,8,0,1
D41,Other,2016,1,1,1,0
D41,Other,2016,1,1,1,0
D41,Other,2016,6,6,1,0
D41,Other,2016,1,1,1,0
D41,Other,2016,2,3,0,1
D41,Other,2016,1,1,1,0
D41,Other,2016,1,1,1,0
D42,Other,2016,15,17,0,2
D42,Other,2016,20,21,0,1
D42,Other,2016,2,2,1,0
D42,Other,2016,8,8,1,0
D42,Other,2016,6,6,1,0
D42,Robbery-Other,2016,1,5,0,4
D42,Other Criminal Violations - Offensive Weapons,2016,11,11,1,0
D43,Fraud,2016,6,39,0,33
D42,Theft Under $5000,2016,83,169,0,86
D42,Other,2016,15,15,1,0
D43,Break & Enter-Apartment,2016,5,13,0,8
D42,Other Criminal Violations - Offensive Weapons,2016,14,15,0,1
D42,Sexual Violation,2016,7,11,0,4
D42,Theft Under $5000,2016,34,115,0,81
D42,Other,2016,17,18,0,1
D43,Break & Enter-Apartment,2016,9,27,0,18
D42,Other Criminal Violations - Offensive Weapons,2016,4,5,0,1
D42,Sexual Violation,2016,5,10,0,5
D42,Theft Under $5000,2016,113,259,0,146
D42,Other,2016,15,16,0,1
D42,Other,2016,4,4,1,0
D42,Other,2016,13,14,0,1
D42,Other,2016,4,5,0,1
D42,Auto Theft,2016,1,17,0,16
D42,Auto Theft,2016,3,28,0,25
D42,Auto Theft,2016,2,15,0,13
D42,Auto Theft,2016,2,15,0,13
D42,Auto Theft,2016,2,18,0,16
D42,Auto Theft,2016,2,19,0,17
D42,Auto Theft,2016,0,38,0,38
D42,Auto Theft,2016,1,16,0,15
D42,Auto Theft,2016,0,31,0,31
D42,Auto Theft,2016,1,25,0,24
D42,Auto Theft,2016,0,2,0,2
D42,Break & Enter-Apartment,2016,1,2,0,1
D42,Break & Enter-Apartment,2016,1,3,0,2
D42,Break & Enter-Apartment,2016,2,7,0,5
D42,Break & Enter-Apartment,2016,1,5,0,4
D42,Break & Enter-Apartment,2016,1,7,0,6
D42,Break & Enter-Apartment,2016,1,3,0,2
D42,Break & Enter-Apartment,2016,0,1,0,1
D42,Break & Enter-Apartment,2016,0,1,0,1
D42,Break & Enter-Apartment,2016,0,4,0,4
D42,Break & Enter-Apartment,2016,2,12,0,10
D42,Break & Enter-Apartment,2016,1,3,0,2
D42,Break & Enter-Commercial,2016,1,7,0,6
D42,Break & Enter-Commercial,2016,2,31,0,29
D42,Break & Enter-Commercial,2016,0,1,0,1
D42,Break & Enter-Commercial,2016,0,2,0,2
D42,Break & Enter-Commercial,2016,0,5,0,5
D42,Break & Enter-Commercial,2016,1,10,0,9
D42,Break & Enter-Commercial,2016,0,6,0,6
D42,Break & Enter-Commercial,2016,2,27,0,25
D42,Break & Enter-Commercial,2016,3,12,0,9
D42,Break & Enter-Commercial,2016,0,3,0,3
D42,Break & Enter-Commercial,2016,2,13,0,11
D42,Break & Enter-Commercial,2016,0,1,0,1
D42,Break & Enter-House,2016,4,39,0,35
D42,Break & Enter-House,2016,1,25,0,24
D42,Break & Enter-House,2016,0,11,0,11
D42,Break & Enter-House,2016,2,18,0,16
D42,Break & Enter-House,2016,9,19,0,10
D43,Fraud,2016,2,2,1,0
D42,Break & Enter-House,2016,1,14,0,13
D42,Break & Enter-House,2016,1,39,0,38
D42,Break & Enter-House,2016,3,28,0,25
D42,Break & Enter-House,2016,4,38,0,34
D42,Sexual Violation,2016,0,1,0,1
D43,Fraud,2016,10,53,0,43
D43,Break & Enter-Apartment,2016,5,12,0,7
D42,Theft Under $5000,2016,47,202,0,155
D43,Fraud,2016,30,102,0,72
D42,Sexual Violation,2016,2,5,0,3
D43,Fraud,2016,1,16,0,15
D42,Other Criminal Violations - Offensive Weapons,2016,7,7,1,0
D43,Break & Enter-Commercial,2016,2,9,0,7
D42,Theft Under $5000,2016,1,5,0,4
D43,Fraud,2016,20,79,0,59
D42,Other Criminal Violations - Offensive Weapons,2016,6,6,1,0
D42,Sexual Violation,2016,0,4,0,4
D43,Break & Enter-Commercial,2016,0,3,0,3
D42,Theft Under $5000,2016,15,58,0,43
D43,Other,2016,9,15,0,6
D42,Other Criminal Violations - Offensive Weapons,2016,1,1,1,0
D42,Sexual Violation,2016,4,5,0,1
D43,Break & Enter-Commercial,2016,1,4,0,3
D42,Theft Under $5000,2016,150,342,0,192
D43,Other,2016,27,66,0,39
D42,Other Criminal Violations - Offensive Weapons,2016,1,1,1,0
D42,Sexual Violation,2016,10,23,0,13
D43,Break & Enter-Commercial,2016,9,14,0,5
D42,Theft Under $5000,2016,6,69,0,63
D43,Other,2016,14,42,0,28
D42,Other Criminal Violations - Offensive Weapons,2016,9,10,0,1
D42,Sexual Violation,2016,6,8,0,2
D43,Break & Enter-Commercial,2016,6,12,0,6
D42,Assault,2016,43,77,0,34
D43,Other,2016,18,46,0,28
D42,Other Criminal Violations - Offensive Weapons,2016,5,6,0,1
D42,Sexual Violation,2016,0,1,0,1
D43,Break & Enter-Commercial,2016,0,7,0,7
D42,Assault,2016,72,107,0,35
D43,Other,2016,21,67,0,46
D42,Other,2016,3,3,1,0
D42,Sexual Violation,2016,8,10,0,2
D43,Break & Enter-Commercial,2016,1,1,1,0
D42,Assault,2016,49,72,0,23
D43,Other,2016,59,113,0,54
D42,Other,2016,2,2,1,0
D42,Sexual Violation,2016,3,4,0,1
D43,Break & Enter-Commercial,2016,2,2,1,0
D42,Assault,2016,0,1,0,1
D43,Other,2016,11,31,0,20
D43,Break & Enter-Commercial,2016,0,2,0,2
D42,Sexual Violation,2016,7,11,0,4
D42,Other,2016,3,3,1,0
D43,Other,2016,22,60,0,38
D43,Break & Enter-Commercial,2016,1,7,0,6
D42,Assault,2016,56,78,0,22
D42,Other,2016,2,2,1,0
D42,Sexual Violation,2016,4,7,0,3
D43,Other,2016,24,64,0,40
D43,Break & Enter-Commercial,2016,7,19,0,12
D42,Assault,2016,101,146,0,45
D42,Other,2016,1,1,1,0
D42,Other,2016,14,14,1,0
D43,Other,2016,55,114,0,59
D43,Break & Enter-Commercial,2016,0,1,0,1
D42,Assault,2016,57,91,0,34
D42,Other,2016,1,1,1,0
D42,Other,2016,21,22,0,1
D43,Other,2016,102,201,0,99
D43,Break & Enter-Commercial,2016,4,14,0,10
D42,Assault,2016,40,70,0,30
D42,Other,2016,7,7,1,0
D42,Other,2016,1,1,1,0
D43,Other,2016,2,19,0,17
D43,Break & Enter-House,2016,1,4,0,3
D42,Assault,2016,51,78,0,27
D42,Other,2016,2,2,1,0
D42,Other,2016,12,12,1,0
D43,Other,2016,35,96,0,61
D43,Break & Enter-House,2016,0,2,0,2
D42,Assault,2016,0,1,0,1
D42,Other,2016,1,1,1,0
D42,Other,2016,9,9,1,0
D43,Theft Over $5000,2016,1,2,0,1
D43,Break & Enter-House,2016,7,12,0,5
D42,Assault,2016,29,38,0,9
D43,Other,2016,8,8,1,0
D42,Other,2016,12,13,0,1
D43,Theft Over $5000,2016,1,5,0,4
D43,Break & Enter-House,2016,3,14,0,11
D42,Assault,2016,56,96,0,40
D43,Other,2016,29,30,0,1
D42,Other,2016,13,13,1,0
D43,Break & Enter-House,2016,3,9,0,6
D43,Theft Over $5000,2016,0,1,0,1
D42,Assault,2016,31,40,0,9
D43,Other,2016,6,6,1,0
D42,Other,2016,19,19,1,0
D43,Theft Over $5000,2016,1,1,1,0
D43,Break & Enter-House,2016,7,18,0,11
D42,Assault,2016,1,1,1,0
D42,Other,2016,29,29,1,0
D43,Other,2016,23,25,0,2
D43,Theft Over $5000,2016,0,6,0,6
D43,Break & Enter-House,2016,1,13,0,12
D42,Attempt Murder,2016,1,1,1,0
D42,Other,2016,1,1,1,0
D43,Other,2016,38,38,1,0
D43,Theft Over $5000,2016,1,6,0,5
D43,Break & Enter-House,2016,5,30,0,25
D42,Attempt Murder,2016,1,1,1,0
D42,Other,2016,7,7,1,0
D43,Other,2016,39,39,1,0
D43,Theft Over $5000,2016,0,1,0,1
D43,Break & Enter-House,2016,2,13,0,11
D42,Other,2016,18,32,0,14
D42,Other,2016,15,15,1,0
D43,Other,2016,2,2,1,0
D43,Theft Over $5000,2016,1,1,1,0
D43,Break & Enter-House,2016,2,12,0,10
D42,Other,2016,25,40,0,15
D42,Other,2016,11,11,1,0
D43,Other,2016,34,41,0,7
D43,Theft Over $5000,2016,0,1,0,1
D43,Break & Enter-House,2016,7,23,0,16
D42,Other,2016,15,26,0,11
D42,Other,2016,1,1,1,0
D43,Other,2016,20,22,0,2
D43,Theft Over $5000,2016,1,2,0,1
D43,Break & Enter-House,2016,2,13,0,11
D42,Other,2016,8,23,0,15
D42,Other,2016,36,39,0,3
D43,Other,2016,1,2,0,1
D43,Theft Over $5000,2016,6,8,0,2
D43,Break & Enter-House,2016,2,12,0,10
D42,Other,2016,29,52,0,23
D42,Other,2016,59,68,0,9
D43,Other,2016,53,55,0,2
D43,Theft Over $5000,2016,1,3,0,2
D43,Break & Enter-Other,2016,0,1,0,1
D42,Other,2016,8,19,0,11
D42,Other,2016,16,31,0,15
D42,Other,2016,21,45,0,24
D42,Other,2016,4,13,0,9
D42,Other,2016,16,37,0,21
D42,Other,2016,10,17,0,7
D42,Robbery-Financial,2016,2,2,1,0
D42,Robbery-Financial,2016,1,1,1,0
D42,Robbery-Financial,2016,2,2,1,0
D42,Robbery-Financial,2016,1,1,1,0
D42,Robbery-Other,2016,4,11,0,7
D42,Robbery-Other,2016,4,20,0,16
D42,Robbery-Other,2016,6,16,0,10
D42,Robbery-Other,2016,6,17,0,11
D42,Robbery-Other,2016,12,29,0,17
D42,Robbery-Other,2016,11,29,0,18
D42,Robbery-Other,2016,16,37,0,21
D42,Robbery-Other,2016,5,25,0,20
D42,Robbery-Other,2016,3,15,0,12
D42,Robbery-Other,2016,18,24,0,6
D43,Other,2016,61,63,0,2
D43,Break & Enter-Other,2016,1,1,1,0
D43,Other,2016,9,10,0,1
D42,Other,2016,28,29,0,1
D43,Break & Enter-Other,2016,2,4,0,2
D43,Other,2016,31,34,0,3
D42,Other,2016,2,2,1,0
D43,Break & Enter-Other,2016,1,1,1,0
D43,Auto Theft,2016,2,5,0,3
D43,Theft Over $5000,2016,4,9,0,5
D42,Other,2016,34,40,0,6
D43,Break & Enter-Other,2016,0,2,0,2
D43,Auto Theft,2016,11,22,0,11
D43,Theft Under $5000,2016,4,32,0,28
D42,Other,2016,3,3,1,0
D43,Break & Enter-Other,2016,3,3,1,0
D43,Auto Theft,2016,3,5,0,2
D43,Theft Under $5000,2016,367,526,0,159
D42,Other,2016,32,35,0,3
D43,Break & Enter-Other,2016,0,1,0,1
D43,Auto Theft,2016,0,2,0,2
D43,Theft Under $5000,2016,21,75,0,54
D42,Other,2016,69,82,0,13
D43,Break & Enter-Other,2016,0,2,0,2
D43,Auto Theft,2016,3,13,0,10
D43,Theft Under $5000,2016,28,98,0,70
D43,Break & Enter-Other,2016,0,3,0,3
D42,Other,2016,36,40,0,4
D43,Auto Theft,2016,6,10,0,4
D43,Theft Under $5000,2016,55,110,0,55
D43,Break & Enter-Other,2016,0,1,0,1
D43,Auto Theft,2016,2,4,0,2
D42,Other,2016,52,60,0,8
D43,Theft Under $5000,2016,129,260,0,131
D43,Break & Enter-Other,2016,2,4,0,2
D43,Auto Theft,2016,4,8,0,4
D42,Other,2016,53,57,0,4
D43,Theft Under $5000,2016,29,75,0,46
D43,Fraud,2016,2,15,0,13
D43,Auto Theft,2016,4,14,0,10
D42,Other,2016,5,7,0,2
D43,Theft Under $5000,2016,19,120,0,101
D43,Fraud,2016,18,70,0,52
D43,Auto Theft,2016,4,10,0,6
D42,Other,2016,13,14,0,1
D43,Theft Under $5000,2016,21,61,0,40
D43,Fraud,2016,5,23,0,18
D43,Auto Theft,2016,6,15,0,9
D42,Other,2016,31,34,0,3
D43,Theft Under $5000,2016,1,2,0,1
D43,Fraud,2016,7,38,0,31
D43,Auto Theft,2016,0,5,0,5
D42,Other,2016,19,21,0,2
D43,Theft Under $5000,2016,113,224,0,111
D43,Fraud,2016,0,1,0,1
D43,Auto Theft,2016,9,22,0,13
D42,Other,2016,8,8,1,0
D43,Theft Under $5000,2016,104,311,0,207
D43,Fraud,2016,6,32,0,26
D43,Break & Enter-Apartment,2016,0,1,0,1
D42,Other,2016,1,1,1,0
D43,Theft Under $5000,2016,11,48,0,37
D43,Fraud,2016,13,78,0,65
D43,Break & Enter-Apartment,2016,2,4,0,2
D42,Other Criminal Violations - Offensive Weapons,2016,11,11,1,0
D43,Theft Under $5000,2016,43,180,0,137
D43,Fraud,2016,4,24,0,20
D43,Break & Enter-Apartment,2016,1,11,0,10
D42,Other Criminal Violations - Offensive Weapons,2016,13,16,0,3
D43,Assault,2016,36,45,0,9
D43,Fraud,2016,7,38,0,31
D43,Break & Enter-Apartment,2016,4,13,0,9
D42,Other Criminal Violations - Offensive Weapons,2016,1,2,0,1
D43,Assault,2016,69,98,0,29
D42,Other Criminal Violations - Offensive Weapons,2016,1,1,1,0
D43,Break & Enter-Apartment,2016,0,2,0,2
D43,Assault,2016,31,42,0,11
D42,Other Criminal Violations - Offensive Weapons,2016,5,6,0,1
D43,Assault,2016,1,1,1,0
D42,Break & Enter-House,2016,7,36,0,29
D42,Break & Enter-House,2016,3,15,0,12
D42,Break & Enter-Other,2016,0,1,0,1
D42,Break & Enter-Other,2016,0,2,0,2
D42,Break & Enter-Other,2016,0,2,0,2
D42,Break & Enter-Other,2016,2,5,0,3
D42,Break & Enter-Other,2016,0,1,0,1
D42,Break & Enter-Other,2016,0,1,0,1
D42,Break & Enter-Other,2016,2,3,0,1
D42,Break & Enter-Other,2016,1,1,1,0
D42,Fraud,2016,11,57,0,46
D42,Fraud,2016,29,101,0,72
D42,Fraud,2016,11,58,0,47
D42,Fraud,2016,3,51,0,48
D42,Fraud,2016,9,71,0,62
D42,Fraud,2016,3,24,0,21
D42,Fraud,2016,7,62,0,55
D42,Fraud,2016,9,44,0,35
D42,Fraud,2016,3,6,0,3
D42,Fraud,2016,0,33,0,33
D42,Fraud,2016,12,62,0,50
D42,Fraud,2016,3,28,0,25
D42,Other,2016,18,59,0,41
D42,Other,2016,21,78,0,57
D42,Other,2016,0,1,0,1
D42,Other,2016,15,40,0,25
D42,Other,2016,13,46,0,33
D42,Other,2016,24,82,0,58
D42,Other,2016,22,67,0,45
D42,Other,2016,18,71,0,53
D42,Other,2016,30,78,0,48
D42,Other,2016,11,34,0,23
D42,Other,2016,18,69,0,51
D42,Other,2016,8,22,0,14
D42,Theft Over $5000,2016,0,5,0,5
D42,Theft Over $5000,2016,1,12,0,11
D42,Theft Over $5000,2016,0,2,0,2
D42,Theft Over $5000,2016,0,3,0,3
D42,Theft Over $5000,2016,1,2,0,1
D42,Theft Over $5000,2016,2,6,0,4
D42,Theft Over $5000,2016,1,9,0,8
D42,Theft Over $5000,2016,4,11,0,7
D42,Theft Over $5000,2016,0,2,0,2
D42,Theft Over $5000,2016,2,8,0,6
D42,Theft Under $5000,2016,21,115,0,94
D42,Theft Under $5000,2016,88,254,0,166
D42,Theft Under $5000,2016,1,1,1,0
D42,Theft Under $5000,2016,1,2,0,1
D42,Theft Under $5000,2016,6,60,0,54
D42,Theft Under $5000,2016,0,1,0,1
D43,Sexual Violation,2016,13,20,0,7
D51,Break & Enter-House,2016,5,16,0,11
D43,Sexual Violation,2016,10,11,0,1
D43,Sexual Violation,2016,5,13,0,8
D51,Break & Enter-House,2016,0,1,0,1
D51,Sexual Violation,2016,5,7,0,2
D43,Sexual Violation,2016,5,12,0,7
D51,Break & Enter-House,2016,0,2,0,2
D51,Sexual Violation,2016,4,5,0,1
D51,Theft Under $5000,2016,28,186,0,158
D43,Sexual Violation,2016,14,19,0,5
D51,Break & Enter-House,2016,0,1,0,1
D51,Sexual Violation,2016,10,14,0,4
D43,Sexual Violation,2016,20,32,0,12
D43,Other Criminal Violations - Offensive Weapons,2016,48,51,0,3
D51,Theft Under $5000,2016,1,46,0,45
D51,Break & Enter-Other,2016,0,3,0,3
D51,Other,2016,13,14,0,1
D52,Auto Theft,2016,10,24,0,14
D43,Sexual Violation,2016,6,7,0,1
D43,Other Criminal Violations - Offensive Weapons,2016,1,1,1,0
D51,Theft Under $5000,2016,115,434,0,319
D52,Theft Over $5000,2016,4,13,0,9
D51,Break & Enter-Other,2016,1,5,0,4
D51,Other,2016,7,7,1,0
D52,Break & Enter-Apartment,2016,4,25,0,21
D43,Sexual Violation,2016,16,21,0,5
D43,Other Criminal Violations - Offensive Weapons,2016,16,16,1,0
D51,Theft Under $5000,2016,0,1,0,1
D52,Theft Over $5000,2016,2,18,0,16
D51,Break & Enter-Other,2016,4,11,0,7
D51,Other,2016,10,10,1,0
D52,Break & Enter-Apartment,2016,1,1,1,0
D43,Other,2016,14,14,1,0
D43,Other,2016,1,1,1,0
D43,Other,2016,1,1,1,0
D43,Other,2016,1,1,1,0
D43,Other,2016,4,4,1,0
D43,Other,2016,1,1,1,0
D43,Other,2016,2,2,1,0
D43,Other,2016,8,9,0,1
D43,Other,2016,3,3,1,0
D51,Other,2016,2,2,1,0
D51,Other,2016,39,42,0,3
D51,Other,2016,70,73,0,3
D51,Other,2016,84,86,0,2
D51,Other,2016,244,249,0,5
D51,Other,2016,5,10,0,5
D51,Other,2016,37,38,0,1
D51,Other,2016,15,15,1,0
D51,Other,2016,5,5,1,0
D51,Other,2016,16,18,0,2
D51,Auto Theft,2016,0,1,0,1
D51,Auto Theft,2016,0,9,0,9
D51,Auto Theft,2016,2,9,0,7
D51,Auto Theft,2016,3,19,0,16
D51,Auto Theft,2016,1,16,0,15
D51,Auto Theft,2016,0,2,0,2
D51,Auto Theft,2016,3,16,0,13
D51,Auto Theft,2016,0,3,0,3
D51,Auto Theft,2016,0,1,0,1
D51,Auto Theft,2016,1,7,0,6
D51,Break & Enter-Apartment,2016,5,23,0,18
D51,Break & Enter-Apartment,2016,5,37,0,32
D51,Break & Enter-Apartment,2016,2,24,0,22
D51,Break & Enter-Apartment,2016,17,60,0,43
D51,Break & Enter-Apartment,2016,0,1,0,1
D51,Break & Enter-Apartment,2016,10,37,0,27
D51,Break & Enter-Apartment,2016,3,14,0,11
D51,Break & Enter-Apartment,2016,4,18,0,14
D51,Break & Enter-Commercial,2016,8,18,0,10
D51,Break & Enter-Commercial,2016,4,19,0,15
D51,Break & Enter-Commercial,2016,12,49,0,37
D51,Break & Enter-Commercial,2016,9,42,0,33
D51,Break & Enter-Commercial,2016,1,1,1,0
D51,Break & Enter-Commercial,2016,4,13,0,9
D51,Break & Enter-Commercial,2016,1,5,0,4
D51,Break & Enter-Commercial,2016,0,1,0,1
D51,Break & Enter-Commercial,2016,6,26,0,20
D51,Break & Enter-House,2016,1,8,0,7
D51,Break & Enter-House,2016,0,2,0,2
D43,Assault,2016,46,68,0,22
D51,Other,2016,18,18,1,0
D43,Assault,2016,83,105,0,22
D52,Break & Enter-Apartment,2016,2,13,0,11
D51,Assault,2016,69,106,0,37
D43,Other,2016,5,5,1,0
D51,Break & Enter-Other,2016,2,12,0,10
D52,Break & Enter-Apartment,2016,4,19,0,15
D52,Theft Over $5000,2016,4,13,0,9
D43,Other,2016,9,9,1,0
D51,Break & Enter-Other,2016,0,1,0,1
D51,Other,2016,5,5,1,0
D52,Break & Enter-Apartment,2016,1,1,1,0
D43,Assault,2016,134,173,0,39
D52,Theft Over $5000,2016,1,2,0,1
D51,Assault,2016,155,240,0,85
D43,Other,2016,4,4,1,0
D51,Break & Enter-Other,2016,0,1,0,1
D51,Other,2016,4,4,1,0
D52,Break & Enter-Apartment,2016,1,4,0,3
D43,Assault,2016,36,39,0,3
D52,Theft Over $5000,2016,0,5,0,5
D51,Assault,2016,147,267,0,120
D43,Other,2016,13,13,1,0
D51,Break & Enter-Other,2016,0,5,0,5
D51,Other,2016,13,13,1,0
D52,Break & Enter-Apartment,2016,4,7,0,3
D43,Assault,2016,39,58,0,19
D52,Theft Over $5000,2016,1,3,0,2
D51,Assault,2016,0,1,0,1
D43,Other,2016,17,18,0,1
D51,Break & Enter-Other,2016,0,2,0,2
D51,Other,2016,85,89,0,4
D52,Break & Enter-Apartment,2016,4,12,0,8
D43,Assault,2016,112,147,0,35
D52,Theft Over $5000,2016,1,7,0,6
D51,Assault,2016,238,406,0,168
D43,Other,2016,3,4,0,1
D51,Fraud,2016,7,34,0,27
D51,Other,2016,152,160,0,8
D52,Break & Enter-Apartment,2016,1,3,0,2
D43,Assault,2016,4,8,0,4
D52,Theft Over $5000,2016,13,27,0,14
D51,Assault,2016,9,14,0,5
D43,Other,2016,9,9,1,0
D51,Fraud,2016,22,123,0,101
D51,Other,2016,1,1,1,0
D52,Break & Enter-Commercial,2016,5,29,0,24
D52,Break & Enter-Commercial,2016,1,7,0,6
D52,Break & Enter-Commercial,2016,4,15,0,11
D52,Break & Enter-Commercial,2016,4,10,0,6
D52,Break & Enter-Commercial,2016,0,3,0,3
D52,Break & Enter-Commercial,2016,13,45,0,32
D52,Break & Enter-Commercial,2016,24,53,0,29
D52,Break & Enter-House,2016,1,1,1,0
D52,Break & Enter-House,2016,0,1,0,1
D52,Break & Enter-House,2016,1,1,1,0
D52,Break & Enter-Other,2016,1,4,0,3
D52,Break & Enter-Other,2016,1,1,1,0
D52,Break & Enter-Other,2016,2,6,0,4
D52,Break & Enter-Other,2016,0,1,0,1
D52,Break & Enter-Other,2016,3,9,0,6
D52,Break & Enter-Other,2016,2,4,0,2
D52,Break & Enter-Other,2016,1,5,0,4
D52,Fraud,2016,0,1,0,1
D52,Fraud,2016,14,101,0,87
D52,Fraud,2016,1,4,0,3
D52,Fraud,2016,2,6,0,4
D52,Fraud,2016,11,63,0,52
D52,Fraud,2016,25,98,0,73
D52,Fraud,2016,0,5,0,5
D52,Fraud,2016,15,68,0,53
D52,Fraud,2016,1,15,0,14
D52,Fraud,2016,29,148,0,119
D52,Fraud,2016,128,398,0,270
D52,Other,2016,42,99,0,57
D52,Other,2016,7,11,0,4
D52,Other,2016,12,17,0,5
D52,Other,2016,25,73,0,48
D52,Other,2016,59,191,0,132
D52,Other,2016,0,1,0,1
D52,Other,2016,3,9,0,6
D52,Other,2016,0,1,0,1
D52,Other,2016,19,78,0,59
D52,Other,2016,20,99,0,79
D52,Other,2016,72,149,0,77
D52,Other,2016,169,284,0,115
D43,Other,2016,17,17,1,0
D51,Other,2016,148,155,0,7
D52,Theft Under $5000,2016,87,391,0,304
D51,Fraud,2016,55,174,0,119
D51,Assault,2016,82,111,0,29
D43,Other,2016,1,1,1,0
D43,Assault,2016,120,172,0,52
D52,Theft Under $5000,2016,0,1,0,1
D43,Other,2016,12,12,1,0
D51,Assault,2016,68,101,0,33
D43,Assault,2016,290,357,0,67
D51,Fraud,2016,32,124,0,92
D51,Other,2016,349,367,0,18
D52,Theft Under $5000,2016,3,18,0,15
D43,Other,2016,22,24,0,2
D51,Assault,2016,14,26,0,12
D43,Assault,2016,10,15,0,5
D51,Fraud,2016,0,2,0,2
D51,Other,2016,9,9,1,0
D52,Theft Under $5000,2016,12,45,0,33
D43,Other,2016,9,10,0,1
D51,Assault,2016,73,118,0,45
D43,Assault,2016,113,145,0,32
D51,Fraud,2016,15,64,0,49
D51,Other,2016,58,60,0,2
D52,Theft Under $5000,2016,26,247,0,221
D43,Other,2016,20,20,1,0
D51,Assault,2016,2,2,1,0
D43,Attempt Murder,2016,1,1,1,0
D51,Fraud,2016,3,33,0,30
D51,Fraud,2016,1,8,0,7
D51,Fraud,2016,17,77,0,60
D51,Fraud,2016,1,1,1,0
D51,Fraud,2016,0,1,0,1
D51,Other,2016,37,104,0,67
D51,Other,2016,68,168,0,100
D51,Other,2016,105,215,0,110
D51,Other,2016,132,292,0,160
D51,Other,2016,7,11,0,4
D51,Other,2016,43,136,0,93
D51,Other,2016,34,67,0,33
D51,Other,2016,6,8,0,2
D51,Other,2016,21,79,0,58
D51,Theft Over $5000,2016,0,7,0,7
D51,Theft Over $5000,2016,2,12,0,10
D51,Theft Over $5000,2016,6,30,0,24
D51,Theft Over $5000,2016,2,12,0,10
D51,Theft Over $5000,2016,0,1,0,1
D51,Theft Over $5000,2016,2,8,0,6
D51,Theft Over $5000,2016,0,2,0,2
D51,Theft Over $5000,2016,1,2,0,1
D51,Theft Over $5000,2016,4,11,0,7
D51,Theft Under $5000,2016,78,409,0,331
D51,Theft Under $5000,2016,401,959,0,558
D51,Theft Under $5000,2016,162,833,0,671
D51,Theft Under $5000,2016,0,1,0,1
D51,Theft Under $5000,2016,0,1,0,1
D51,Theft Under $5000,2016,176,671,0,495
D51,Theft Under $5000,2016,1,32,0,31
D51,Theft Under $5000,2016,0,1,0,1
D51,Theft Under $5000,2016,32,315,0,283
D43,Other,2016,13,13,1,0
D51,Other,2016,49,51,0,2
D51,Attempt Murder,2016,1,1,1,0
D52,Theft Under $5000,2016,0,1,0,1
D43,Other,2016,71,78,0,7
D51,Other,2016,6,6,1,0
D43,Attempt Murder,2016,2,2,1,0
D51,Attempt Murder,2016,3,5,0,2
D52,Theft Under $5000,2016,231,866,0,635
D43,Other,2016,24,27,0,3
D51,Other,2016,29,29,1,0
D43,Attempt Murder,2016,1,1,1,0
D51,Attempt Murder,2016,3,6,0,3
D52,Theft Under $5000,2016,5,39,0,34
D52,Theft Under $5000,2016,0,1,0,1
D52,Theft Under $5000,2016,0,1,0,1
D52,Theft Under $5000,2016,50,209,0,159
D52,Theft Under $5000,2016,29,273,0,244
D52,Theft Under $5000,2016,125,657,0,532
D52,Theft Under $5000,2016,0,1,0,1
D52,Theft Under $5000,2016,1297,2328,0,1031
D52,Assault,2016,52,104,0,52
D52,Assault,2016,13,19,0,6
D52,Assault,2016,30,57,0,27
D52,Assault,2016,59,84,0,25
D52,Assault,2016,92,156,0,64
D52,Assault,2016,4,7,0,3
D52,Assault,2016,1,1,1,0
D52,Assault,2016,0,1,0,1
D52,Assault,2016,51,84,0,33
D52,Assault,2016,23,40,0,17
D52,Assault,2016,174,271,0,97
D52,Assault,2016,297,450,0,153
D52,Attempt Murder,2016,2,2,1,0
D52,Attempt Murder,2016,1,1,1,0
D52,Attempt Murder,2016,3,3,1,0
D52,Other,2016,27,46,0,19
D52,Other,2016,4,8,0,4
D52,Other,2016,0,1,0,1
D52,Other,2016,11,23,0,12
D52,Other,2016,22,45,0,23
D52,Other,2016,2,2,1,0
D52,Other,2016,6,14,0,8
D52,Other,2016,15,24,0,9
D52,Other,2016,32,51,0,19
D52,Other,2016,102,154,0,52
D52,Robbery-Financial,2016,1,1,1,0
D52,Robbery-Other,2016,8,13,0,5
D51,Other,2016,129,130,0,1
D51,Attempt Murder,2016,1,1,1,0
D43,Other,2016,88,90,0,2
D51,Other Criminal Violations - Offensive Weapons,2016,13,14,0,1
D43,Attempt Murder,2016,3,3,1,0
D51,Attempt Murder,2016,1,1,1,0
D43,Other,2016,52,58,0,6
D51,Other Criminal Violations - Offensive Weapons,2016,12,14,0,2
D43,Other,2016,3,5,0,2
D51,Other,2016,16,27,0,11
D51,Other,2016,25,40,0,15
D51,Other,2016,27,50,0,23
D51,Other,2016,53,81,0,28
D51,Other,2016,1,2,0,1
D51,Other,2016,16,30,0,14
D51,Other,2016,18,27,0,9
D51,Other,2016,3,4,0,1
D51,Other,2016,13,20,0,7
D51,Robbery-Financial,2016,1,1,1,0
D51,Robbery-Financial,2016,1,1,1,0
D51,Robbery-Other,2016,10,20,0,10
D51,Robbery-Other,2016,16,41,0,25
D51,Robbery-Other,2016,23,73,0,50
D51,Robbery-Other,2016,42,111,0,69
D51,Robbery-Other,2016,0,3,0,3
D51,Robbery-Other,2016,5,17,0,12
D51,Robbery-Other,2016,3,15,0,12
D51,Robbery-Other,2016,3,7,0,4
D51,Robbery-Other,2016,1,1,1,0
D51,Robbery-Other,2016,0,1,0,1
D51,Robbery-Other,2016,0,1,0,1
D51,Sexual Violation,2016,1,1,1,0
D51,Sexual Violation,2016,8,13,0,5
D51,Sexual Violation,2016,18,42,0,24
D51,Sexual Violation,2016,24,43,0,19
D51,Sexual Violation,2016,0,1,0,1
D51,Sexual Violation,2016,27,48,0,21
D51,Sexual Violation,2016,1,2,0,1
D51,Sexual Violation,2016,10,15,0,5
D43,Other,2016,60,65,0,5
D51,Other Criminal Violations - Offensive Weapons,2016,29,31,0,2
D43,Other,2016,14,23,0,9
D43,Other,2016,100,112,0,12
D43,Other,2016,7,14,0,7
D51,Other Criminal Violations - Offensive Weapons,2016,55,63,0,8
D43,Other,2016,14,20,0,6
D43,Other,2016,14,22,0,8
D51,Other Criminal Violations - Offensive Weapons,2016,1,1,1,0
D43,Other,2016,27,32,0,5
D43,Other,2016,17,30,0,13
D51,Other Criminal Violations - Offensive Weapons,2016,11,12,0,1
D43,Other,2016,1,1,1,0
D43,Other,2016,47,78,0,31
D51,Other Criminal Violations - Offensive Weapons,2016,7,8,0,1
D43,Other,2016,8,13,0,5
D43,Other,2016,61,63,0,2
D43,Other,2016,22,33,0,11
D51,Other Criminal Violations - Offensive Weapons,2016,1,1,1,0
D43,Other,2016,2,2,1,0
D43,Other,2016,24,36,0,12
D51,Other Criminal Violations - Offensive Weapons,2016,7,7,1,0
D43,Other,2016,133,146,0,13
D43,Other,2016,25,47,0,22
D51,Other,2016,2,3,0,1
D43,Other,2016,295,316,0,21
D43,Other,2016,75,122,0,47
D51,Other,2016,6,6,1,0
D43,Other,2016,3,6,0,3
D43,Other,2016,2,6,0,4
D51,Other,2016,10,10,1,0
D43,Other,2016,65,70,0,5
D43,Other,2016,16,32,0,16
D51,Other,2016,2,2,1,0
D43,Other,2016,10,10,1,0
D43,Robbery-Financial,2016,1,1,1,0
D52,Other,2016,25,30,0,5
D43,Other,2016,1,1,1,0
D43,Robbery-Financial,2016,5,7,0,2
D52,Other,2016,7,7,1,0
D43,Other Criminal Violations - Offensive Weapons,2016,3,3,1,0
D43,Robbery-Financial,2016,1,1,1,0
D52,Other,2016,12,12,1,0
D43,Other Criminal Violations - Offensive Weapons,2016,14,14,1,0
D43,Robbery-Financial,2016,1,1,1,0
D52,Other,2016,10,10,1,0
D43,Other Criminal Violations - Offensive Weapons,2016,6,6,1,0
D43,Robbery-Other,2016,2,9,0,7
D52,Other,2016,30,33,0,3
D43,Other Criminal Violations - Offensive Weapons,2016,5,6,0,1
D43,Robbery-Other,2016,19,29,0,10
D52,Other,2016,1,1,1,0
D43,Other Criminal Violations - Offensive Weapons,2016,15,16,0,1
D43,Robbery-Other,2016,7,10,0,3
D52,Other,2016,13,13,1,0
D43,Other Criminal Violations - Offensive Weapons,2016,17,18,0,1
D43,Robbery-Other,2016,6,12,0,6
D52,Other,2016,3,4,0,1
D43,Other Criminal Violations - Offensive Weapons,2016,4,4,1,0
D52,Other,2016,76,76,1,0
D43,Robbery-Other,2016,8,21,0,13
D43,Other Criminal Violations - Offensive Weapons,2016,7,7,1,0
D52,Other,2016,52,54,0,2
D43,Robbery-Other,2016,16,35,0,19
D43,Other Criminal Violations - Offensive Weapons,2016,10,10,1,0
D52,Auto Theft,2016,2,8,0,6
D43,Robbery-Other,2016,3,7,0,4
D43,Other Criminal Violations - Offensive Weapons,2016,13,14,0,1
D52,Auto Theft,2016,2,7,0,5
D43,Robbery-Other,2016,4,11,0,7
D52,Auto Theft,2016,3,16,0,13
D43,Robbery-Other,2016,3,10,0,7
D52,Auto Theft,2016,1,3,0,2
D43,Robbery-Other,2016,14,21,0,7
D52,Auto Theft,2016,0,3,0,3
D43,Robbery-Other,2016,33,62,0,29
D52,Auto Theft,2016,4,19,0,15
D43,Robbery-Other,2016,2,3,0,1
D43,Robbery-Other,2016,14,32,0,18
D43,Sexual Violation,2016,7,8,0,1
D43,Sexual Violation,2016,12,17,0,5
D43,Sexual Violation,2016,2,2,1,0
D43,Sexual Violation,2016,8,12,0,4
D43,Sexual Violation,2016,11,14,0,3
D53,Fraud,2016,5,45,0,40
D53,Fraud,2016,13,72,0,59
D53,Fraud,2016,0,1,0,1
D53,Fraud,2016,11,60,0,49
D53,Fraud,2016,3,36,0,33
D53,Other,2016,45,136,0,91
D53,Other,2016,1,1,1,0
D53,Other,2016,2,9,0,7
D53,Other,2016,3,11,0,8
D53,Other,2016,3,14,0,11
D53,Other,2016,1,3,0,2
D53,Other,2016,6,14,0,8
D53,Other,2016,6,14,0,8
D53,Other,2016,9,41,0,32
D53,Break & Enter-Apartment,2016,0,3,0,3
D53,Theft Under $5000,2016,0,10,0,10
D55,Other,2016,3,4,0,1
D53,Other,2016,4,4,1,0
D53,Other,2016,17,52,0,35
D53,Other,2016,18,58,0,40
D53,Other,2016,2,6,0,4
D53,Other,2016,0,1,0,1
D53,Other,2016,16,42,0,26
D53,Other,2016,0,1,0,1
D53,Other,2016,37,93,0,56
D53,Other,2016,29,59,0,30
D53,Other,2016,21,72,0,51
D53,Other,2016,1,4,0,3
D53,Other,2016,22,67,0,45
D53,Other,2016,9,28,0,19
D53,Theft Over $5000,2016,5,21,0,16
D53,Theft Over $5000,2016,0,3,0,3
D53,Theft Over $5000,2016,1,3,0,2
D53,Theft Over $5000,2016,0,1,0,1
D53,Theft Over $5000,2016,0,3,0,3
D53,Theft Over $5000,2016,0,1,0,1
D53,Theft Over $5000,2016,0,1,0,1
D53,Theft Over $5000,2016,0,2,0,2
D53,Theft Over $5000,2016,2,9,0,7
D53,Theft Over $5000,2016,0,4,0,4
D53,Theft Over $5000,2016,2,11,0,9
D53,Theft Over $5000,2016,0,2,0,2
D53,Theft Over $5000,2016,1,7,0,6
D53,Theft Under $5000,2016,151,535,0,384
D53,Theft Under $5000,2016,1,7,0,6
D53,Theft Under $5000,2016,4,16,0,12
D53,Theft Under $5000,2016,6,27,0,21
D53,Theft Under $5000,2016,2,21,0,19
D53,Theft Under $5000,2016,2,12,0,10
D53,Theft Under $5000,2016,8,29,0,21
D53,Theft Under $5000,2016,9,22,0,13
D53,Theft Under $5000,2016,15,71,0,56
D53,Theft Under $5000,2016,19,88,0,69
D53,Theft Under $5000,2016,30,104,0,74
D52,Other,2016,9,10,0,1
D53,Break & Enter-Commercial,2016,8,41,0,33
D55,Other,2016,18,19,0,1
D52,Other,2016,1,1,1,0
D53,Theft Under $5000,2016,0,1,0,1
D53,Break & Enter-Commercial,2016,0,1,0,1
D55,Other,2016,22,22,1,0
D52,Other,2016,1,1,1,0
D53,Theft Under $5000,2016,53,115,0,62
D53,Other,2016,5,5,1,0
D53,Break & Enter-Commercial,2016,0,2,0,2
D55,Other,2016,34,35,0,1
D53,Other,2016,1,1,1,0
D52,Other,2016,3,4,0,1
D53,Break & Enter-Commercial,2016,1,4,0,3
D55,Other,2016,6,8,0,2
D53,Theft Under $5000,2016,273,522,0,249
D53,Break & Enter-Commercial,2016,9,16,0,7
D55,Other,2016,9,11,0,2
D53,Other,2016,1,1,1,0
D53,Theft Under $5000,2016,35,117,0,82
D52,Other,2016,5,5,1,0
D53,Break & Enter-Commercial,2016,3,4,0,1
D55,Other,2016,30,32,0,2
D53,Other,2016,87,95,0,8
D53,Theft Under $5000,2016,138,247,0,109
D52,Other,2016,8,9,0,1
D53,Break & Enter-Commercial,2016,4,11,0,7
D55,Other,2016,8,8,1,0
D53,Other,2016,4,4,1,0
D53,Theft Under $5000,2016,0,5,0,5
D53,Other,2016,12,13,0,1
D53,Break & Enter-Commercial,2016,7,15,0,8
D55,Other,2016,8,9,0,1
D53,Theft Under $5000,2016,144,286,0,142
D53,Other,2016,1,1,1,0
D53,Break & Enter-Commercial,2016,4,9,0,5
D55,Other,2016,41,42,0,1
D53,Theft Under $5000,2016,2,52,0,50
D53,Other,2016,0,2,0,2
D53,Break & Enter-Commercial,2016,4,15,0,11
D53,Other,2016,1,1,1,0
D53,Assault,2016,97,150,0,53
D55,Other,2016,13,16,0,3
D53,Other,2016,5,5,1,0
D53,Break & Enter-Commercial,2016,0,2,0,2
D53,Other,2016,2,2,1,0
D53,Assault,2016,5,5,1,0
D55,Other,2016,14,16,0,2
D53,Other,2016,1,1,1,0
D53,Break & Enter-Commercial,2016,0,3,0,3
D53,Other,2016,4,4,1,0
D53,Assault,2016,1,1,1,0
D55,Other,2016,5,5,1,0
D53,Other,2016,6,6,1,0
D53,Break & Enter-House,2016,5,22,0,17
D53,Other,2016,4,4,1,0
D53,Assault,2016,9,9,1,0
D55,Other,2016,23,24,0,1
D53,Other,2016,1,1,1,0
D53,Break & Enter-House,2016,1,21,0,20
D53,Other,2016,3,3,1,0
D53,Assault,2016,1,1,1,0
D55,Other,2016,9,9,1,0
D53,Other,2016,4,7,0,3
D53,Break & Enter-House,2016,1,23,0,22
D53,Other,2016,4,4,1,0
D53,Assault,2016,9,10,0,1
D55,Auto Theft,2016,0,5,0,5
D53,Other,2016,4,4,1,0
D53,Break & Enter-House,2016,1,4,0,3
D53,Other,2016,1,2,0,1
D53,Assault,2016,5,6,0,1
D55,Auto Theft,2016,0,8,0,8
D53,Other,2016,1,1,1,0
D53,Break & Enter-House,2016,0,6,0,6
D53,Other,2016,7,7,1,0
D53,Other,2016,24,24,1,0
D53,Other,2016,7,7,1,0
D53,Other,2016,30,31,0,1
D53,Other,2016,13,15,0,2
D53,Other,2016,1,1,1,0
D53,Auto Theft,2016,0,8,0,8
D53,Auto Theft,2016,6,17,0,11
D53,Auto Theft,2016,0,5,0,5
D53,Auto Theft,2016,0,2,0,2
D53,Auto Theft,2016,0,3,0,3
D53,Auto Theft,2016,0,2,0,2
D53,Auto Theft,2016,3,20,0,17
D53,Auto Theft,2016,1,3,0,2
D53,Auto Theft,2016,2,8,0,6
D53,Auto Theft,2016,0,2,0,2
D53,Auto Theft,2016,5,12,0,7
D53,Auto Theft,2016,0,3,0,3
D53,Auto Theft,2016,0,5,0,5
D53,Auto Theft,2016,0,1,0,1
D53,Auto Theft,2016,2,3,0,1
D53,Auto Theft,2016,3,7,0,4
D53,Break & Enter-Apartment,2016,6,21,0,15
D53,Break & Enter-Apartment,2016,0,2,0,2
D53,Break & Enter-Apartment,2016,0,1,0,1
D53,Break & Enter-Apartment,2016,0,2,0,2
D53,Break & Enter-Apartment,2016,0,6,0,6
D53,Break & Enter-Apartment,2016,0,1,0,1
D53,Break & Enter-Apartment,2016,1,2,0,1
D53,Break & Enter-Apartment,2016,0,1,0,1
D53,Break & Enter-Apartment,2016,1,4,0,3
D53,Break & Enter-Apartment,2016,1,9,0,8
D53,Break & Enter-Apartment,2016,4,13,0,9
D53,Break & Enter-Apartment,2016,0,7,0,7
D53,Break & Enter-Apartment,2016,1,6,0,5
D55,Auto Theft,2016,1,5,0,4
D53,Other,2016,9,9,1,0
D53,Break & Enter-House,2016,0,6,0,6
D55,Auto Theft,2016,1,13,0,12
D53,Other,2016,11,13,0,2
D53,Break & Enter-House,2016,2,33,0,31
D55,Auto Theft,2016,4,24,0,20
D53,Other,2016,17,20,0,3
D53,Break & Enter-House,2016,4,15,0,11
D55,Auto Theft,2016,1,5,0,4
D55,Auto Theft,2016,0,13,0,13
D55,Auto Theft,2016,0,1,0,1
D55,Auto Theft,2016,0,2,0,2
D55,Auto Theft,2016,2,7,0,5
D55,Auto Theft,2016,3,9,0,6
D55,Auto Theft,2016,0,6,0,6
D55,Auto Theft,2016,0,7,0,7
D55,Auto Theft,2016,6,28,0,22
D55,Auto Theft,2016,0,7,0,7
D55,Auto Theft,2016,1,10,0,9
D55,Auto Theft,2016,4,6,0,2
D55,Auto Theft,2016,4,13,0,9
D55,Auto Theft,2016,0,2,0,2
D55,Break & Enter-Apartment,2016,1,6,0,5
D55,Break & Enter-Apartment,2016,2,4,0,2
D55,Break & Enter-Apartment,2016,1,5,0,4
D55,Break & Enter-Apartment,2016,2,6,0,4
D55,Break & Enter-Apartment,2016,9,20,0,11
D55,Break & Enter-Apartment,2016,1,12,0,11
D55,Break & Enter-Apartment,2016,6,17,0,11
D55,Break & Enter-Apartment,2016,0,1,0,1
D55,Break & Enter-Apartment,2016,1,3,0,2
D55,Break & Enter-Apartment,2016,8,14,0,6
D55,Break & Enter-Apartment,2016,2,2,1,0
D55,Break & Enter-Apartment,2016,3,3,1,0
D55,Break & Enter-Apartment,2016,8,32,0,24
D55,Break & Enter-Apartment,2016,9,19,0,10
D55,Break & Enter-Apartment,2016,5,17,0,12
D55,Break & Enter-Apartment,2016,2,5,0,3
D53,Assault,2016,0,1,0,1
D53,Other,2016,1,3,0,2
D53,Break & Enter-House,2016,1,7,0,6
D53,Assault,2016,4,5,0,1
D53,Other,2016,13,14,0,1
D53,Break & Enter-House,2016,1,2,0,1
D53,Assault,2016,3,3,1,0
D53,Other,2016,118,123,0,5
D53,Break & Enter-House,2016,17,34,0,17
D53,Assault,2016,12,19,0,7
D53,Other,2016,31,33,0,2
D53,Break & Enter-House,2016,1,3,0,2
D53,Assault,2016,34,39,0,5
D53,Other,2016,42,48,0,6
D53,Break & Enter-House,2016,0,7,0,7
D53,Assault,2016,16,18,0,2
D53,Other,2016,1,1,1,0
D53,Break & Enter-House,2016,1,6,0,5
D53,Other,2016,42,42,1,0
D53,Assault,2016,1,2,0,1
D53,Break & Enter-Other,2016,1,1,1,0
D53,Other,2016,43,44,0,1
D53,Assault,2016,30,36,0,6
D53,Break & Enter-Other,2016,5,5,1,0
D53,Other,2016,10,11,0,1
D53,Assault,2016,68,99,0,31
D53,Break & Enter-Other,2016,0,1,0,1
D53,Other Criminal Violations - Offensive Weapons,2016,16,17,0,1
D53,Assault,2016,48,65,0,17
D53,Break & Enter-Other,2016,0,1,0,1
D53,Other Criminal Violations - Offensive Weapons,2016,3,3,1,0
D53,Assault,2016,52,77,0,25
D53,Break & Enter-Other,2016,0,1,0,1
D53,Other Criminal Violations - Offensive Weapons,2016,2,2,1,0
D53,Assault,2016,0,4,0,4
D53,Break & Enter-Other,2016,0,2,0,2
D53,Other Criminal Violations - Offensive Weapons,2016,2,2,1,0
D53,Assault,2016,39,61,0,22
D53,Break & Enter-Other,2016,1,2,0,1
D53,Other Criminal Violations - Offensive Weapons,2016,2,2,1,0
D53,Assault,2016,20,27,0,7
D53,Break & Enter-Other,2016,1,3,0,2
D53,Other Criminal Violations - Offensive Weapons,2016,13,14,0,1
D53,Attempt Murder,2016,1,1,1,0
D53,Break & Enter-Other,2016,1,4,0,3
D53,Other Criminal Violations - Offensive Weapons,2016,2,4,0,2
D53,Attempt Murder,2016,4,4,1,0
D53,Robbery-Financial,2016,1,1,1,0
D53,Fraud,2016,44,111,0,67
D53,Other Criminal Violations - Offensive Weapons,2016,8,8,1,0
D53,Attempt Murder,2016,2,2,1,0
D53,Robbery-Financial,2016,0,1,0,1
D53,Fraud,2016,0,1,0,1
D53,Other Criminal Violations - Offensive Weapons,2016,6,9,0,3
D53,Other,2016,16,34,0,18
D53,Robbery-Financial,2016,1,1,1,0
D53,Fraud,2016,2,5,0,3
D53,Other,2016,1,1,1,0
D53,Other,2016,1,1,1,0
D53,Robbery-Financial,2016,0,1,0,1
D53,Fraud,2016,0,10,0,10
D53,Other,2016,1,3,0,2
D53,Other,2016,1,1,1,0
D53,Robbery-Financial,2016,2,2,1,0
D53,Fraud,2016,0,16,0,16
D53,Other,2016,4,5,0,1
D53,Other,2016,1,1,1,0
D53,Robbery-Other,2016,8,17,0,9
D53,Fraud,2016,0,3,0,3
D53,Other,2016,1,1,1,0
D53,Other,2016,1,1,1,0
D53,Robbery-Other,2016,0,1,0,1
D53,Fraud,2016,0,15,0,15
D53,Other,2016,5,8,0,3
D53,Other,2016,0,1,0,1
D53,Robbery-Other,2016,0,2,0,2
D53,Fraud,2016,1,7,0,6
D53,Other,2016,0,1,0,1
D53,Other,2016,1,1,1,0
D53,Robbery-Other,2016,1,1,1,0
D53,Fraud,2016,4,30,0,26
D53,Other,2016,8,9,0,1
D53,Other,2016,1,1,1,0
D53,Robbery-Other,2016,0,1,0,1
D53,Fraud,2016,4,37,0,33
D53,Other,2016,7,14,0,7
D53,Other,2016,1,1,1,0
D53,Robbery-Other,2016,0,1,0,1
D53,Fraud,2016,6,26,0,20
D53,Other,2016,11,12,0,1
D53,Other,2016,1,1,1,0
D53,Robbery-Other,2016,1,2,0,1
D53,Fraud,2016,1,3,0,2
D53,Other,2016,8,16,0,8
D53,Other,2016,4,5,0,1
D53,Robbery-Other,2016,2,6,0,4
D53,Fraud,2016,4,36,0,32
D53,Other,2016,19,34,0,15
D53,Other,2016,1,2,0,1
D53,Robbery-Other,2016,3,3,1,0
D53,Fraud,2016,22,106,0,84
D53,Other,2016,13,30,0,17
D55,Other,2016,20,22,0,2
D53,Robbery-Other,2016,2,7,0,5
D53,Other,2016,16,26,0,10
D55,Other,2016,12,12,1,0
D53,Robbery-Other,2016,6,18,0,12
D55,Other,2016,2,2,1,0
D53,Other,2016,1,1,1,0
D53,Robbery-Other,2016,6,7,0,1
D55,Other,2016,25,25,1,0
D53,Other,2016,10,22,0,12
D53,Robbery-Other,2016,5,15,0,10
D53,Other,2016,11,15,0,4
D53,Robbery-Other,2016,0,1,0,1
D53,Robbery-Other,2016,1,9,0,8
D53,Robbery-Other,2016,2,5,0,3
D53,Sexual Violation,2016,1,1,1,0
D53,Sexual Violation,2016,6,23,0,17
D53,Sexual Violation,2016,1,1,1,0
D53,Sexual Violation,2016,3,5,0,2
D53,Sexual Violation,2016,1,1,1,0
D53,Sexual Violation,2016,1,1,1,0
D53,Sexual Violation,2016,1,2,0,1
D53,Sexual Violation,2016,1,1,1,0
D53,Sexual Violation,2016,3,6,0,3
D53,Sexual Violation,2016,3,5,0,2
D53,Sexual Violation,2016,7,12,0,5
D53,Sexual Violation,2016,3,6,0,3
D53,Sexual Violation,2016,1,5,0,4
D53,Sexual Violation,2016,3,4,0,1
D53,Sexual Violation,2016,7,12,0,5
D53,Sexual Violation,2016,1,2,0,1
D53,Other,2016,2,3,0,1
D53,Other,2016,1,1,1,0
D53,Other,2016,2,2,1,0
D53,Other,2016,2,2,1,0
D53,Other,2016,1,1,1,0
D53,Other,2016,6,6,1,0
D53,Other,2016,3,3,1,0
D53,Other,2016,6,6,1,0
D53,Other,2016,5,5,1,0
D53,Other,2016,0,1,0,1
D53,Other,2016,1,1,1,0
D53,Other,2016,13,13,1,0
D53,Other,2016,2,2,1,0
D52,Robbery-Other,2016,2,2,1,0
D52,Robbery-Other,2016,0,2,0,2
D52,Robbery-Other,2016,10,16,0,6
D52,Robbery-Other,2016,0,4,0,4
D52,Robbery-Other,2016,4,16,0,12
D52,Robbery-Other,2016,0,1,0,1
D52,Robbery-Other,2016,1,8,0,7
D52,Robbery-Other,2016,1,4,0,3
D52,Robbery-Other,2016,12,24,0,12
D52,Robbery-Other,2016,35,66,0,31
D52,Sexual Violation,2016,10,16,0,6
D52,Sexual Violation,2016,3,6,0,3
D52,Sexual Violation,2016,7,16,0,9
D52,Sexual Violation,2016,16,26,0,10
D52,Sexual Violation,2016,0,3,0,3
D52,Sexual Violation,2016,1,5,0,4
D52,Sexual Violation,2016,7,13,0,6
D52,Sexual Violation,2016,6,16,0,10
D52,Sexual Violation,2016,47,72,0,25
D52,Other,2016,4,4,1,0
D52,Other,2016,1,1,1,0
D52,Other,2016,4,5,0,1
D52,Other,2016,20,20,1,0
D52,Other,2016,17,18,0,1
D52,Other,2016,4,4,1,0
D52,Other,2016,1,1,1,0
D52,Other,2016,11,11,1,0
D52,Other,2016,2,2,1,0
D52,Other,2016,8,8,1,0
D52,Other,2016,17,17,1,0
D52,Other,2016,114,126,0,12
D52,Other,2016,12,12,1,0
D52,Other,2016,38,39,0,1
D52,Other,2016,2,2,1,0
D52,Other,2016,30,32,0,2
D52,Other,2016,162,178,0,16
D52,Other,2016,5,5,1,0
D52,Other,2016,0,1,0,1
D52,Other,2016,36,41,0,5
D52,Other,2016,39,46,0,7
D52,Other,2016,115,125,0,10
D52,Other,2016,1169,1208,0,39
D52,Other Criminal Violations - Offensive Weapons,2016,14,15,0,1
D52,Other Criminal Violations - Offensive Weapons,2016,2,2,1,0
D52,Other Criminal Violations - Offensive Weapons,2016,8,8,1,0
D52,Other Criminal Violations - Offensive Weapons,2016,12,13,0,1
D52,Other Criminal Violations - Offensive Weapons,2016,16,19,0,3
D52,Other Criminal Violations - Offensive Weapons,2016,3,3,1,0
D52,Other Criminal Violations - Offensive Weapons,2016,23,23,1,0
D52,Other Criminal Violations - Offensive Weapons,2016,42,43,0,1
D55,Theft Over $5000,2016,0,3,0,3
D55,Theft Over $5000,2016,1,7,0,6
D55,Theft Over $5000,2016,1,6,0,5
D55,Theft Over $5000,2016,0,7,0,7
D55,Theft Over $5000,2016,0,3,0,3
D55,Theft Over $5000,2016,0,4,0,4
D55,Theft Over $5000,2016,6,20,0,14
D55,Theft Over $5000,2016,1,5,0,4
D55,Theft Over $5000,2016,0,3,0,3
D55,Theft Over $5000,2016,1,2,0,1
D55,Theft Over $5000,2016,0,6,0,6
D55,Theft Over $5000,2016,0,7,0,7
D55,Theft Under $5000,2016,77,190,0,113
D55,Theft Under $5000,2016,16,72,0,56
D55,Theft Under $5000,2016,0,1,0,1
D55,Theft Under $5000,2016,48,132,0,84
D55,Theft Under $5000,2016,10,87,0,77
D55,Theft Under $5000,2016,144,392,0,248
D55,Theft Under $5000,2016,27,144,0,117
D55,Theft Under $5000,2016,10,167,0,157
D55,Theft Under $5000,2016,1,1,1,0
D55,Theft Under $5000,2016,2,14,0,12
D55,Theft Under $5000,2016,51,202,0,151
D55,Theft Under $5000,2016,23,163,0,140
D55,Theft Under $5000,2016,1,3,0,2
D55,Theft Under $5000,2016,18,100,0,82
D55,Theft Under $5000,2016,65,221,0,156
D55,Theft Under $5000,2016,241,695,0,454
D55,Theft Under $5000,2016,117,215,0,98
D55,Theft Under $5000,2016,60,275,0,215
D55,Theft Under $5000,2016,6,39,0,33
D55,Theft Under $5000,2016,38,146,0,108
D55,Theft Under $5000,2016,3,56,0,53
D55,Assault,2016,0,1,0,1
D55,Assault,2016,0,1,0,1
D55,Assault,2016,36,54,0,18
D55,Assault,2016,27,36,0,9
D55,Assault,2016,3,5,0,2
D55,Assault,2016,35,71,0,36
D55,Assault,2016,61,88,0,27
D55,Robbery-Other,2016,4,7,0,3
D55,Other,2016,6,6,1,0
D55,Break & Enter-Other,2016,1,2,0,1
D55,Other,2016,2,2,1,0
D55,Break & Enter-Apartment,2016,7,13,0,6
D55,Assault,2016,28,44,0,16
D55,Assault,2016,93,145,0,52
D55,Assault,2016,85,132,0,47
D55,Assault,2016,63,86,0,23
D55,Assault,2016,3,8,0,5
D55,Assault,2016,30,45,0,15
D55,Assault,2016,79,112,0,33
D55,Assault,2016,1,2,0,1
D55,Assault,2016,22,34,0,12
D55,Assault,2016,35,62,0,27
D55,Assault,2016,114,180,0,66
NSA,Sexual Violation,2016,1,2,0,1
D55,Break & Enter-Apartment,2016,2,2,1,0
D55,Other,2016,1,1,1,0
D55,Other,2016,1,1,1,0
NSA,Sexual Violation,2016,1,1,1,0
D55,Robbery-Other,2016,14,44,0,30
D55,Assault,2016,56,77,0,21
D55,Break & Enter-Other,2016,2,4,0,2
D55,Break & Enter-Commercial,2016,2,7,0,5
D55,Other,2016,1,1,1,0
NSA,Other,2016,1,1,1,0
NSA,Sexual Violation,2016,0,1,0,1
D55,Robbery-Other,2016,9,17,0,8
D55,Assault,2016,33,57,0,24
D55,Fraud,2016,0,1,0,1
D55,Break & Enter-Commercial,2016,3,5,0,2
D55,Other,2016,49,57,0,8
NSA,Other,2016,99,108,0,9
NSA,Sexual Violation,2016,26,106,0,80
D55,Robbery-Other,2016,7,14,0,7
D55,Assault,2016,51,74,0,23
D55,Fraud,2016,5,23,0,18
D55,Break & Enter-Commercial,2016,7,12,0,5
D55,Other,2016,16,20,0,4
NSA,Auto Theft,2016,6,23,0,17
NSA,Sexual Violation,2016,0,1,0,1
D55,Robbery-Other,2016,2,3,0,1
D55,Assault,2016,25,30,0,5
D55,Fraud,2016,1,17,0,16
D55,Break & Enter-Commercial,2016,3,6,0,3
D55,Other,2016,5,5,1,0
NSA,Break & Enter-Apartment,2016,1,4,0,3
NSA,Sexual Violation,2016,0,1,0,1
D55,Robbery-Other,2016,4,8,0,4
D55,Attempt Murder,2016,1,1,1,0
D55,Fraud,2016,0,1,0,1
D55,Break & Enter-Commercial,2016,6,22,0,16
D55,Break & Enter-Commercial,2016,0,1,0,1
D55,Break & Enter-Commercial,2016,6,10,0,4
D55,Break & Enter-Commercial,2016,1,1,1,0
D55,Break & Enter-Commercial,2016,11,21,0,10
D55,Break & Enter-Commercial,2016,3,6,0,3
D55,Break & Enter-Commercial,2016,0,1,0,1
D55,Break & Enter-Commercial,2016,3,7,0,4
D55,Break & Enter-Commercial,2016,13,37,0,24
D55,Break & Enter-Commercial,2016,3,6,0,3
D55,Break & Enter-Commercial,2016,6,13,0,7
D55,Break & Enter-Commercial,2016,1,4,0,3
D55,Break & Enter-Commercial,2016,6,15,0,9
D55,Break & Enter-House,2016,1,8,0,7
D55,Break & Enter-House,2016,0,5,0,5
D55,Break & Enter-House,2016,5,23,0,18
D55,Break & Enter-House,2016,12,25,0,13
D55,Break & Enter-House,2016,7,28,0,21
D55,Break & Enter-House,2016,7,31,0,24
D55,Break & Enter-House,2016,1,1,1,0
D55,Break & Enter-House,2016,1,13,0,12
D55,Break & Enter-House,2016,0,12,0,12
D55,Break & Enter-House,2016,11,20,0,9
D55,Break & Enter-House,2016,3,13,0,10
D55,Break & Enter-House,2016,19,63,0,44
D55,Break & Enter-House,2016,5,16,0,11
D55,Break & Enter-House,2016,6,36,0,30
D55,Break & Enter-House,2016,0,1,0,1
D55,Break & Enter-House,2016,3,20,0,17
D55,Break & Enter-House,2016,1,12,0,11
D55,Break & Enter-Other,2016,0,2,0,2
D55,Break & Enter-Other,2016,0,2,0,2
D55,Break & Enter-Other,2016,0,1,0,1
D55,Break & Enter-Other,2016,2,5,0,3
D55,Break & Enter-Other,2016,2,7,0,5
D55,Break & Enter-Other,2016,0,1,0,1
D55,Break & Enter-Other,2016,1,4,0,3
D55,Break & Enter-Other,2016,1,4,0,3
D55,Break & Enter-Other,2016,1,2,0,1
D55,Break & Enter-Other,2016,1,3,0,2
D55,Break & Enter-Other,2016,0,1,0,1
D55,Break & Enter-Other,2016,2,17,0,15
D55,Break & Enter-Other,2016,2,2,1,0
D55,Break & Enter-Other,2016,1,11,0,10
D55,Fraud,2016,4,38,0,34
D55,Attempt Murder,2016,0,1,0,1
NSA,Break & Enter-Commercial,2016,1,3,0,2
D55,Other,2016,33,34,0,1
D55,Attempt Murder,2016,2,2,1,0
D55,Fraud,2016,8,34,0,26
NSA,Other,2016,61,63,0,2
D55,Fraud,2016,13,66,0,53
D55,Robbery-Other,2016,2,3,0,1
NSA,Break & Enter-House,2016,3,7,0,4
D55,Other,2016,14,15,0,1
D55,Fraud,2016,6,63,0,57
D55,Attempt Murder,2016,1,1,1,0
D55,Sexual Violation,2016,3,11,0,8
NSA,Fraud,2016,0,1,0,1
NSA,Other,2016,2,2,1,0
D55,Other,2016,77,87,0,10
D55,Fraud,2016,9,35,0,26
D55,Attempt Murder,2016,2,2,1,0
D55,Sexual Violation,2016,2,7,0,5
NSA,Fraud,2016,0,1,0,1
NSA,Other,2016,1,1,1,0
D55,Other,2016,47,49,0,2
D55,Fraud,2016,0,1,0,1
D55,Attempt Murder,2016,1,1,1,0
D55,Sexual Violation,2016,10,12,0,2
NSA,Fraud,2016,0,1,0,1
NSA,Other,2016,2,2,1,0
D55,Other,2016,53,60,0,7
D55,Fraud,2016,0,2,0,2
D55,Attempt Murder,2016,1,1,1,0
D55,Sexual Violation,2016,2,5,0,3
NSA,Fraud,2016,0,1,0,1
NSA,Other,2016,1,1,1,0
D55,Other,2016,1,1,1,0
D55,Fraud,2016,3,30,0,27
D55,Attempt Murder,2016,1,1,1,0
D55,Sexual Violation,2016,9,14,0,5
NSA,Fraud,2016,0,1,0,1
NSA,Other,2016,206,229,0,23
D55,Other,2016,38,41,0,3
D55,Fraud,2016,23,61,0,38
D55,Attempt Murder,2016,1,1,1,0
D55,Sexual Violation,2016,0,1,0,1
NSA,Fraud,2016,0,1,0,1
NSA,Other,2016,1,1,1,0
D55,Other,2016,53,59,0,6
D55,Fraud,2016,2,20,0,18
D55,Other,2016,4,8,0,4
D55,Sexual Violation,2016,1,1,1,0
NSA,Fraud,2016,1,1,1,0
NSA,Other Criminal Violations - Offensive Weapons,2016,21,28,0,7
D55,Other,2016,1,2,0,1
D55,Other,2016,23,24,0,1
D55,Other,2016,18,24,0,6
D55,Other,2016,114,124,0,10
D55,Other,2016,67,75,0,8
D55,Other,2016,62,66,0,4
D55,Other,2016,22,26,0,4
D55,Other,2016,80,86,0,6
D55,Other,2016,17,18,0,1
D55,Other,2016,84,85,0,1
D55,Other Criminal Violations - Offensive Weapons,2016,17,17,1,0
D55,Other Criminal Violations - Offensive Weapons,2016,5,6,0,1
D55,Other Criminal Violations - Offensive Weapons,2016,4,6,0,2
D55,Other Criminal Violations - Offensive Weapons,2016,2,2,1,0
D55,Other Criminal Violations - Offensive Weapons,2016,11,13,0,2
D55,Other Criminal Violations - Offensive Weapons,2016,12,13,0,1
D55,Other Criminal Violations - Offensive Weapons,2016,15,17,0,2
D55,Other Criminal Violations - Offensive Weapons,2016,7,8,0,1
D55,Other Criminal Violations - Offensive Weapons,2016,9,10,0,1
D55,Other Criminal Violations - Offensive Weapons,2016,2,2,1,0
D55,Other Criminal Violations - Offensive Weapons,2016,1,1,1,0
D55,Other Criminal Violations - Offensive Weapons,2016,5,5,1,0
D55,Other Criminal Violations - Offensive Weapons,2016,17,17,1,0
D55,Other Criminal Violations - Offensive Weapons,2016,8,9,0,1
D55,Other Criminal Violations - Offensive Weapons,2016,2,2,1,0
D55,Other Criminal Violations - Offensive Weapons,2016,5,6,0,1
D55,Other Criminal Violations - Offensive Weapons,2016,8,9,0,1
D55,Other Criminal Violations - Offensive Weapons,2016,4,4,1,0
D55,Other,2016,1,2,0,1
D55,Other,2016,1,1,1,0
D55,Other,2016,2,2,1,0
D55,Other,2016,2,2,1,0
D55,Other,2016,2,2,1,0
D55,Other,2016,1,1,1,0
D55,Other,2016,1,1,1,0
D55,Other,2016,1,1,1,0
NSA,Other,2016,1,1,1,0
D55,Sexual Violation,2016,7,9,0,2
NSA,Fraud,2016,0,1,0,1
D55,Other,2016,16,25,0,9
D55,Fraud,2016,3,23,0,20
NSA,Fraud,2016,40,164,0,124
NSA,Other,2016,7,18,0,11
D55,Fraud,2016,8,87,0,79
NSA,Fraud,2016,0,1,0,1
D55,Sexual Violation,2016,7,15,0,8
NSA,Fraud,2016,1,1,1,0
D55,Other,2016,1,1,1,0
D55,Fraud,2016,8,48,0,40
D11,Other,2017,2,2,1,0
D55,Sexual Violation,2016,2,2,1,0
NSA,Fraud,2016,0,1,0,1
D55,Other,2016,14,21,0,7
D55,Fraud,2016,3,44,0,41
D11,Other,2017,6,6,1,0
D55,Sexual Violation,2016,6,12,0,6
NSA,Fraud,2016,0,2,0,2
D55,Other,2016,13,23,0,10
D55,Fraud,2016,2,12,0,10
D11,Other,2017,2,2,1,0
D55,Sexual Violation,2016,11,15,0,4
NSA,Fraud,2016,0,1,0,1
D55,Other,2016,25,49,0,24
D55,Fraud,2016,9,49,0,40
D11,Other,2017,12,12,1,0
D55,Sexual Violation,2016,2,2,1,0
NSA,Other,2016,0,1,0,1
D55,Other,2016,11,28,0,17
D55,Fraud,2016,2,16,0,14
D11,Other,2017,19,19,1,0
D55,Sexual Violation,2016,0,5,0,5
NSA,Other,2016,0,1,0,1
D55,Other,2016,12,30,0,18
D55,Other,2016,0,1,0,1
D11,Other,2017,21,22,0,1
D55,Sexual Violation,2016,16,28,0,12
NSA,Other,2016,0,1,0,1
D55,Other,2016,12,24,0,12
D55,Other,2016,19,74,0,55
D11,Other,2017,1,1,1,0
D55,Sexual Violation,2016,6,10,0,4
NSA,Other,2016,0,1,0,1
D55,Other,2016,22,46,0,24
D55,Other,2016,6,27,0,21
D11,Other,2017,12,12,1,0
D55,Sexual Violation,2016,4,11,0,7
NSA,Other,2016,50,135,0,85
D55,Other,2016,1,1,1,0
D55,Other,2016,1,2,0,1
D11,Other,2017,1,1,1,0
D55,Sexual Violation,2016,5,5,1,0
NSA,Other,2016,0,2,0,2
D55,Other,2016,20,46,0,26
D11,Other,2017,31,33,0,2
D55,Other,2016,5,15,0,10
D55,Other,2016,24,59,0,35
NSA,Theft Over $5000,2016,2,16,0,14
D11,Other,2017,14,14,1,0
D55,Sexual Violation,2016,2,11,0,9
D55,Other,2016,3,13,0,10
D55,Other,2016,34,145,0,111
NSA,Theft Under $5000,2016,0,1,0,1
D11,Other,2017,12,13,0,1
D55,Sexual Violation,2016,3,12,0,9
D55,Other,2016,24,44,0,20
D55,Other,2016,22,87,0,65
NSA,Theft Under $5000,2016,0,2,0,2
D11,Other,2017,17,19,0,2
D55,Other,2016,2,2,1,0
D55,Other,2016,16,31,0,15
D55,Other,2016,30,100,0,70
NSA,Theft Under $5000,2016,33,171,0,138
D11,Auto Theft,2017,3,9,0,6
D55,Other,2016,4,4,1,0
D55,Other,2016,16,29,0,13
D55,Other,2016,0,1,0,1
NSA,Assault,2016,1,1,1,0
D11,Auto Theft,2017,1,9,0,8
D55,Other,2016,11,11,1,0
D55,Other,2016,6,13,0,7
D55,Other,2016,1,5,0,4
NSA,Assault,2016,0,1,0,1
D11,Auto Theft,2017,0,14,0,14
D55,Other,2016,3,3,1,0
D55,Other,2016,33,39,0,6
D55,Other,2016,17,63,0,46
NSA,Assault,2016,0,2,0,2
D11,Auto Theft,2017,8,22,0,14
D55,Other,2016,7,7,1,0
D55,Other,2016,12,17,0,5
D55,Other,2016,34,91,0,57
NSA,Assault,2016,0,1,0,1
D11,Auto Theft,2017,6,11,0,5
D55,Other,2016,1,1,1,0
D55,Other,2016,0,1,0,1
D55,Other,2016,1,1,1,0
NSA,Assault,2016,0,1,0,1
D55,Other,2016,8,8,1,0
D11,Auto Theft,2017,3,9,0,6
D55,Robbery-Financial,2016,2,2,1,0
NSA,Assault,2016,56,151,0,95
D55,Other,2016,19,38,0,19
D55,Robbery-Financial,2016,1,1,1,0
D55,Other,2016,7,7,1,0
D55,Other,2016,14,41,0,27
NSA,Assault,2016,0,1,0,1
D55,Robbery-Financial,2016,1,1,1,0
D11,Auto Theft,2017,1,5,0,4
D55,Other,2016,12,13,0,1
D55,Other,2016,68,189,0,121
NSA,Assault,2016,0,1,0,1
D55,Robbery-Other,2016,0,3,0,3
D11,Auto Theft,2017,0,1,0,1
D55,Other,2016,1,1,1,0
D55,Other,2016,31,71,0,40
NSA,Attempt Murder,2016,2,2,1,0
D55,Robbery-Other,2016,4,12,0,8
D11,Auto Theft,2017,0,3,0,3
D55,Other,2016,4,4,1,0
D55,Other,2016,35,135,0,100
NSA,Other,2016,0,1,0,1
D55,Robbery-Other,2016,11,11,1,0
D11,Auto Theft,2017,4,20,0,16
D55,Other,2016,6,7,0,1
D55,Other,2016,1,1,1,0
NSA,Other,2016,1,1,1,0
D55,Robbery-Other,2016,9,17,0,8
D11,Auto Theft,2017,2,21,0,19
D55,Other,2016,8,10,0,2
D55,Other,2016,11,24,0,13
NSA,Other,2016,28,55,0,27
D55,Robbery-Other,2016,2,5,0,3
D11,Auto Theft,2017,1,5,0,4
D55,Other,2016,1,1,1,0
D55,Other,2016,29,86,0,57
NSA,Robbery-Financial,2016,17,17,1,0
D55,Robbery-Other,2016,17,38,0,21
D11,Auto Theft,2017,0,4,0,4
D55,Other,2016,14,15,0,1
D55,Other,2016,12,40,0,28
NSA,Robbery-Other,2016,35,57,0,22
D55,Robbery-Other,2016,11,19,0,8
D11,Break & Enter-Apartment,2017,1,2,0,1
D55,Other,2016,4,4,1,0
D55,Theft Over $5000,2016,0,2,0,2
NSA,Sexual Violation,2016,1,1,1,0
D55,Robbery-Other,2016,4,13,0,9
D11,Break & Enter-Apartment,2017,2,21,0,19
D55,Other,2016,1,1,1,0
D55,Theft Over $5000,2016,0,4,0,4
D55,Robbery-Other,2016,1,4,0,3
D55,Other,2016,19,22,0,3
D11,Break & Enter-Apartment,2017,3,9,0,6
NSA,Sexual Violation,2016,0,1,0,1
D55,Robbery-Other,2016,13,28,0,15
D55,Other,2016,6,6,1,0
D55,Theft Over $5000,2016,3,4,0,1
NSA,Sexual Violation,2016,0,1,0,1
D11,Break & Enter-Apartment,2017,2,8,0,6
D55,Robbery-Other,2016,13,26,0,13
D55,Other,2016,12,12,1,0
D55,Theft Over $5000,2016,1,12,0,11
NSA,Sexual Violation,2016,0,1,0,1
D11,Break & Enter-Apartment,2017,3,9,0,6
D55,Robbery-Other,2016,0,1,0,1
D55,Other,2016,1,1,1,0
D11,Break & Enter-Apartment,2017,0,2,0,2
D55,Robbery-Other,2016,0,8,0,8
D55,Other,2016,4,4,1,0
D11,Break & Enter-Apartment,2017,0,1,0,1
D55,Other,2016,8,9,0,1
D11,Break & Enter-Apartment,2017,6,16,0,10
D11,Other,2017,13,23,0,10
D11,Other,2017,5,9,0,4
D11,Other,2017,5,9,0,4
D11,Other,2017,21,31,0,10
D11,Other,2017,10,14,0,4
D11,Other,2017,2,2,1,0
D11,Other,2017,19,29,0,10
D11,Robbery-Financial,2017,1,1,1,0
D11,Robbery-Financial,2017,3,3,1,0
D11,Robbery-Financial,2017,1,1,1,0
D11,Robbery-Financial,2017,4,4,1,0
D11,Robbery-Financial,2017,2,2,1,0
D11,Robbery-Financial,2017,1,1,1,0
D11,Robbery-Other,2017,3,7,0,4
D11,Robbery-Other,2017,15,32,0,17
D11,Robbery-Other,2017,10,23,0,13
D12,Auto Theft,2017,1,9,0,8
D11,Other,2017,32,41,0,9
D11,Break & Enter-Apartment,2017,0,3,0,3
D11,Other,2017,30,103,0,73
D12,Fraud,2017,16,27,0,11
D12,Sexual Violation,2017,0,1,0,1
D11,Robbery-Other,2017,2,10,0,8
D11,Robbery-Other,2017,13,23,0,10
D11,Robbery-Other,2017,1,3,0,2
D11,Robbery-Other,2017,1,2,0,1
D11,Robbery-Other,2017,7,21,0,14
D11,Robbery-Other,2017,4,12,0,8
D11,Robbery-Other,2017,2,9,0,7
D11,Robbery-Other,2017,0,6,0,6
D11,Sexual Violation,2017,0,1,0,1
D11,Sexual Violation,2017,0,1,0,1
D11,Sexual Violation,2017,0,1,0,1
D11,Sexual Violation,2017,1,3,0,2
D11,Sexual Violation,2017,11,16,0,5
D11,Sexual Violation,2017,6,13,0,7
D11,Sexual Violation,2017,10,11,0,1
D11,Sexual Violation,2017,9,20,0,11
D11,Sexual Violation,2017,0,1,0,1
D11,Sexual Violation,2017,1,1,1,0
D11,Sexual Violation,2017,0,2,0,2
D11,Sexual Violation,2017,12,17,0,5
D11,Sexual Violation,2017,4,6,0,2
D11,Sexual Violation,2017,0,2,0,2
D11,Sexual Violation,2017,1,1,1,0
D11,Other,2017,0,1,0,1
D11,Other,2017,10,10,1,0
D11,Other,2017,5,5,1,0
D11,Other,2017,20,21,0,1
D11,Other,2017,19,19,1,0
D11,Other,2017,11,11,1,0
D11,Other,2017,3,3,1,0
D11,Other,2017,5,5,1,0
D11,Other,2017,7,7,1,0
D11,Other,2017,6,6,1,0
D11,Other,2017,3,3,1,0
D12,Assault,2017,5,5,1,0
D12,Other,2017,7,7,1,0
D11,Other,2017,40,45,0,5
D12,Auto Theft,2017,3,18,0,15
D12,Fraud,2017,9,45,0,36
D11,Other,2017,14,56,0,42
D11,Break & Enter-Apartment,2017,0,3,0,3
D12,Assault,2017,14,19,0,5
D12,Other,2017,9,9,1,0
D11,Other,2017,62,66,0,4
D12,Auto Theft,2017,0,1,0,1
D12,Fraud,2017,2,20,0,18
D12,Other,2017,3,3,1,0
D11,Other,2017,5,16,0,11
D12,Other,2017,9,9,1,0
D11,Break & Enter-Commercial,2017,3,7,0,4
D11,Other,2017,1,1,1,0
D12,Assault,2017,74,94,0,20
D12,Auto Theft,2017,6,24,0,18
D12,Assault,2017,40,55,0,15
D11,Other,2017,64,71,0,7
D11,Break & Enter-Commercial,2017,2,5,0,3
D11,Other,2017,9,28,0,19
D12,Other,2017,4,4,1,0
D12,Fraud,2017,21,68,0,47
D12,Assault,2017,125,150,0,25
D12,Other,2017,14,14,1,0
D12,Auto Theft,2017,22,47,0,25
D11,Other,2017,65,74,0,9
D11,Break & Enter-Commercial,2017,3,5,0,2
D11,Theft Over $5000,2017,0,3,0,3
D12,Fraud,2017,3,10,0,7
D12,Assault,2017,9,15,0,6
D12,Other,2017,2,2,1,0
D12,Auto Theft,2017,3,11,0,8
D11,Other,2017,9,9,1,0
D11,Break & Enter-Commercial,2017,9,24,0,15
D11,Theft Over $5000,2017,0,2,0,2
D12,Other,2017,10,35,0,25
D12,Attempt Murder,2017,1,1,1,0
D12,Other,2017,5,5,1,0
D12,Auto Theft,2017,18,43,0,25
D11,Other,2017,17,21,0,4
D11,Break & Enter-Commercial,2017,2,10,0,8
D11,Theft Over $5000,2017,2,10,0,8
D12,Other,2017,33,78,0,45
D12,Attempt Murder,2017,4,4,1,0
D12,Other,2017,8,8,1,0
D12,Auto Theft,2017,0,3,0,3
D11,Other,2017,1,1,1,0
D11,Break & Enter-Commercial,2017,1,2,0,1
D11,Theft Over $5000,2017,1,6,0,5
D12,Other,2017,0,1,0,1
D12,Attempt Murder,2017,0,1,0,1
D12,Other,2017,5,5,1,0
D12,Break & Enter-Apartment,2017,6,7,0,1
D11,Other,2017,9,9,1,0
D11,Break & Enter-Commercial,2017,0,3,0,3
D11,Theft Over $5000,2017,1,3,0,2
D12,Other,2017,11,20,0,9
D12,Other,2017,23,47,0,24
D12,Other,2017,4,22,0,18
D12,Other,2017,22,54,0,32
D12,Other,2017,0,1,0,1
D12,Other,2017,12,30,0,18
D12,Other,2017,40,98,0,58
D12,Other,2017,18,32,0,14
D12,Other,2017,76,136,0,60
D12,Other,2017,6,27,0,21
D12,Other,2017,1,1,1,0
D12,Theft Over $5000,2017,1,2,0,1
D12,Theft Over $5000,2017,1,7,0,6
D12,Theft Over $5000,2017,1,2,0,1
D12,Theft Over $5000,2017,1,4,0,3
D12,Theft Over $5000,2017,2,2,1,0
D12,Theft Over $5000,2017,2,5,0,3
D12,Theft Over $5000,2017,4,5,0,1
D12,Theft Over $5000,2017,3,7,0,4
D12,Theft Over $5000,2017,0,1,0,1
D12,Theft Over $5000,2017,0,2,0,2
D12,Theft Over $5000,2017,0,1,0,1
D12,Theft Under $5000,2017,22,64,0,42
D12,Theft Under $5000,2017,97,240,0,143
D12,Theft Under $5000,2017,28,82,0,54
D12,Theft Under $5000,2017,63,131,0,68
D12,Theft Under $5000,2017,0,13,0,13
D12,Theft Under $5000,2017,13,49,0,36
D12,Theft Under $5000,2017,1,5,0,4
D12,Theft Under $5000,2017,147,305,0,158
D12,Theft Under $5000,2017,30,133,0,103
D12,Theft Under $5000,2017,8,37,0,29
D12,Theft Under $5000,2017,53,226,0,173
D12,Theft Under $5000,2017,2,22,0,20
D12,Assault,2017,0,1,0,1
D12,Assault,2017,42,55,0,13
D12,Assault,2017,77,104,0,27
D12,Assault,2017,1,1,1,0
D12,Assault,2017,7,12,0,5
D12,Assault,2017,32,54,0,22
D12,Assault,2017,13,15,0,2
D12,Assault,2017,69,91,0,22
D11,Other,2017,2,2,1,0
D12,Other,2017,7,7,1,0
D11,Theft Over $5000,2017,0,1,0,1
D12,Attempt Murder,2017,0,1,0,1
D12,Other,2017,5,5,1,0
D12,Break & Enter-Apartment,2017,1,1,1,0
D12,Other,2017,31,31,1,0
D11,Break & Enter-Commercial,2017,1,18,0,17
D11,Other,2017,80,92,0,12
D12,Attempt Murder,2017,1,1,1,0
D11,Theft Over $5000,2017,1,3,0,2
D11,Other,2017,18,25,0,7
D12,Attempt Murder,2017,2,3,0,1
D11,Break & Enter-Commercial,2017,0,5,0,5
D12,Break & Enter-Apartment,2017,1,6,0,5
D11,Theft Over $5000,2017,0,12,0,12
D11,Other,2017,18,20,0,2
D12,Other,2017,14,16,0,2
D11,Break & Enter-House,2017,2,5,0,3
D12,Break & Enter-Apartment,2017,1,2,0,1
D12,Other,2017,73,77,0,4
D11,Theft Over $5000,2017,0,1,0,1
D11,Other,2017,36,38,0,2
D12,Other,2017,22,32,0,10
D11,Break & Enter-House,2017,5,25,0,20
D12,Break & Enter-Apartment,2017,0,2,0,2
D12,Other,2017,38,38,1,0
D11,Theft Under $5000,2017,212,367,0,155
D11,Other,2017,1,1,1,0
D11,Other Criminal Violations - Offensive Weapons,2017,5,6,0,1
D11,Other Criminal Violations - Offensive Weapons,2017,8,8,1,0
D11,Other Criminal Violations - Offensive Weapons,2017,7,8,0,1
D11,Other Criminal Violations - Offensive Weapons,2017,5,6,0,1
D11,Other Criminal Violations - Offensive Weapons,2017,10,12,0,2
D11,Other Criminal Violations - Offensive Weapons,2017,2,2,1,0
D11,Other Criminal Violations - Offensive Weapons,2017,5,7,0,2
D11,Other Criminal Violations - Offensive Weapons,2017,3,3,1,0
D11,Other Criminal Violations - Offensive Weapons,2017,3,3,1,0
D11,Other Criminal Violations - Offensive Weapons,2017,8,8,1,0
D11,Other,2017,3,3,1,0
D11,Other,2017,1,1,1,0
D11,Other,2017,1,1,1,0
D11,Other,2017,1,1,1,0
D11,Other,2017,1,1,1,0
D11,Other,2017,1,1,1,0
D12,Other,2017,13,13,1,0
D12,Other,2017,16,17,0,1
D12,Other,2017,4,4,1,0
D12,Other,2017,18,18,1,0
D12,Other,2017,3,3,1,0
D12,Other,2017,9,9,1,0
D12,Other,2017,2,2,1,0
D12,Other,2017,16,16,1,0
D12,Other,2017,26,27,0,1
D12,Other,2017,1,1,1,0
D12,Other,2017,26,26,1,0
D12,Other,2017,72,74,0,2
D12,Other,2017,2,3,0,1
D12,Other,2017,1,1,1,0
D12,Auto Theft,2017,3,12,0,9
D12,Auto Theft,2017,6,24,0,18
D12,Auto Theft,2017,1,3,0,2
D12,Auto Theft,2017,6,29,0,23
D12,Other,2017,4,6,0,2
D12,Other,2017,20,22,0,2
D11,Theft Under $5000,2017,69,296,0,227
D12,Break & Enter-Apartment,2017,2,3,0,1
D12,Other,2017,6,12,0,6
D11,Break & Enter-House,2017,7,25,0,18
D12,Other,2017,22,23,0,1
D12,Break & Enter-Apartment,2017,3,7,0,4
D11,Theft Under $5000,2017,70,233,0,163
D12,Other,2017,19,21,0,2
D11,Break & Enter-House,2017,4,10,0,6
D12,Other,2017,2,5,0,3
D11,Theft Under $5000,2017,140,332,0,192
D12,Other,2017,37,41,0,4
D12,Break & Enter-Apartment,2017,1,7,0,6
D12,Other,2017,12,14,0,2
D11,Break & Enter-House,2017,1,11,0,10
D11,Theft Under $5000,2017,53,286,0,233
D12,Other,2017,6,6,1,0
D12,Break & Enter-Apartment,2017,0,2,0,2
D12,Other,2017,1,1,1,0
D11,Break & Enter-House,2017,1,8,0,7
D11,Theft Under $5000,2017,1,21,0,20
D12,Other,2017,19,24,0,5
D12,Break & Enter-Apartment,2017,17,23,0,6
D12,Other,2017,1,3,0,2
D11,Break & Enter-House,2017,0,4,0,4
D12,Other,2017,61,62,0,1
D11,Theft Under $5000,2017,30,80,0,50
D12,Break & Enter-Commercial,2017,5,6,0,1
D12,Other,2017,21,24,0,3
D11,Break & Enter-House,2017,4,14,0,10
D11,Theft Under $5000,2017,0,1,0,1
D12,Break & Enter-Commercial,2017,1,12,0,11
D12,Other,2017,31,31,1,0
D11,Break & Enter-House,2017,3,9,0,6
D12,Other,2017,4,9,0,5
D11,Theft Under $5000,2017,1,8,0,7
D12,Break & Enter-Commercial,2017,0,5,0,5
D12,Other,2017,109,116,0,7
D11,Break & Enter-House,2017,2,2,1,0
D12,Other,2017,33,42,0,9
D11,Theft Under $5000,2017,17,40,0,23
D12,Break & Enter-Commercial,2017,1,4,0,3
D12,Other,2017,15,16,0,1
D11,Break & Enter-Other,2017,1,3,0,2
D12,Other,2017,3,6,0,3
D11,Theft Under $5000,2017,110,390,0,280
D12,Break & Enter-Commercial,2017,3,8,0,5
D12,Other,2017,1,1,1,0
D11,Break & Enter-Other,2017,0,1,0,1
D12,Robbery-Financial,2017,1,1,1,0
D11,Theft Under $5000,2017,49,158,0,109
D12,Break & Enter-Commercial,2017,2,4,0,2
D12,Other,2017,1,1,1,0
D11,Break & Enter-Other,2017,1,1,1,0
D12,Robbery-Financial,2017,1,1,1,0
D11,Theft Under $5000,2017,2,30,0,28
D12,Break & Enter-Commercial,2017,13,29,0,16
D12,Other Criminal Violations - Offensive Weapons,2017,5,8,0,3
D11,Break & Enter-Other,2017,1,3,0,2
D12,Robbery-Other,2017,2,8,0,6
D11,Theft Under $5000,2017,0,22,0,22
D12,Break & Enter-Commercial,2017,0,2,0,2
D12,Other Criminal Violations - Offensive Weapons,2017,13,13,1,0
D11,Break & Enter-Other,2017,1,1,1,0
D12,Robbery-Other,2017,5,13,0,8
D11,Theft Under $5000,2017,1,1,1,0
D12,Break & Enter-House,2017,0,2,0,2
D12,Other Criminal Violations - Offensive Weapons,2017,3,4,0,1
D11,Break & Enter-Other,2017,0,2,0,2
D11,Assault,2017,1,3,0,2
D12,Other Criminal Violations - Offensive Weapons,2017,3,3,1,0
D12,Break & Enter-House,2017,2,8,0,6
D11,Fraud,2017,7,37,0,30
D11,Assault,2017,23,47,0,24
D12,Robbery-Other,2017,0,2,0,2
D11,Assault,2017,70,95,0,25
D12,Other Criminal Violations - Offensive Weapons,2017,2,2,1,0
D12,Break & Enter-House,2017,0,1,0,1
D12,Robbery-Other,2017,10,20,0,10
D11,Fraud,2017,4,45,0,41
D11,Assault,2017,59,85,0,26
D12,Other Criminal Violations - Offensive Weapons,2017,6,8,0,2
D12,Break & Enter-House,2017,0,6,0,6
D12,Robbery-Other,2017,2,2,1,0
D11,Fraud,2017,11,83,0,72
D11,Assault,2017,0,1,0,1
D12,Other Criminal Violations - Offensive Weapons,2017,1,1,1,0
D12,Break & Enter-House,2017,3,7,0,4
D12,Robbery-Other,2017,16,29,0,13
D11,Fraud,2017,12,38,0,26
D11,Assault,2017,49,66,0,17
D12,Other Criminal Violations - Offensive Weapons,2017,3,3,1,0
D12,Break & Enter-House,2017,2,4,0,2
D12,Robbery-Other,2017,0,1,0,1
D11,Fraud,2017,11,54,0,43
D11,Assault,2017,79,121,0,42
D12,Other Criminal Violations - Offensive Weapons,2017,3,3,1,0
D12,Break & Enter-House,2017,1,7,0,6
D12,Robbery-Other,2017,2,10,0,8
D11,Fraud,2017,1,14,0,13
D11,Assault,2017,16,21,0,5
D12,Other Criminal Violations - Offensive Weapons,2017,22,25,0,3
D12,Break & Enter-House,2017,7,20,0,13
D12,Robbery-Other,2017,12,40,0,28
D11,Fraud,2017,1,5,0,4
D11,Assault,2017,10,17,0,7
D12,Other,2017,3,3,1,0
D12,Break & Enter-House,2017,2,10,0,8
D12,Robbery-Other,2017,2,4,0,2
D11,Fraud,2017,0,1,0,1
D11,Assault,2017,2,4,0,2
D12,Other,2017,5,5,1,0
D12,Other,2017,4,4,1,0
D12,Other,2017,2,2,1,0
D12,Other,2017,2,2,1,0
D12,Other,2017,2,2,1,0
D12,Other,2017,2,2,1,0
D12,Other,2017,1,1,1,0
D13,Other,2017,37,42,0,5
D13,Other,2017,14,15,0,1
D13,Other,2017,3,3,1,0
D13,Other,2017,13,14,0,1
D12,Break & Enter-House,2017,6,21,0,15
D11,Fraud,2017,0,2,0,2
D11,Assault,2017,6,8,0,2
D12,Robbery-Other,2017,25,41,0,16
D12,Break & Enter-Other,2017,1,1,1,0
D11,Fraud,2017,1,11,0,10
D11,Assault,2017,67,96,0,29
D12,Robbery-Other,2017,0,3,0,3
D12,Break & Enter-Other,2017,6,6,1,0
D11,Fraud,2017,14,43,0,29
D11,Assault,2017,19,27,0,8
D12,Sexual Violation,2017,3,6,0,3
D12,Break & Enter-Other,2017,1,1,1,0
D11,Fraud,2017,4,27,0,23
D11,Assault,2017,13,22,0,9
D12,Sexual Violation,2017,4,9,0,5
D12,Break & Enter-Other,2017,1,2,0,1
D11,Fraud,2017,3,8,0,5
D11,Assault,2017,40,49,0,9
D12,Sexual Violation,2017,0,1,0,1
D12,Break & Enter-Other,2017,0,3,0,3
D11,Fraud,2017,2,14,0,12
D11,Attempt Murder,2017,1,1,1,0
D12,Sexual Violation,2017,2,2,1,0
D12,Break & Enter-Other,2017,2,2,1,0
D11,Other,2017,17,60,0,43
D11,Attempt Murder,2017,0,2,0,2
D12,Sexual Violation,2017,8,11,0,3
D12,Break & Enter-Other,2017,1,1,1,0
D11,Other,2017,26,93,0,67
D11,Other,2017,0,1,0,1
D12,Sexual Violation,2017,2,3,0,1
D12,Fraud,2017,13,41,0,28
D11,Other,2017,29,97,0,68
D11,Other,2017,6,13,0,7
D12,Sexual Violation,2017,18,22,0,4
D12,Fraud,2017,14,68,0,54
D11,Other,2017,19,73,0,54
D11,Other,2017,16,30,0,14
D12,Fraud,2017,9,19,0,10
D11,Other,2017,34,129,0,95
D12,Sexual Violation,2017,0,2,0,2
D11,Other,2017,13,27,0,14
D12,Fraud,2017,13,38,0,25
D11,Other,2017,6,25,0,19
D12,Sexual Violation,2017,5,12,0,7
D11,Other,2017,11,22,0,11
D12,Fraud,2017,2,20,0,18
D11,Other,2017,9,31,0,22
D12,Sexual Violation,2017,2,5,0,3
D12,Fraud,2017,4,29,0,25
D11,Other,2017,1,6,0,5
D12,Sexual Violation,2017,0,1,0,1
D12,Fraud,2017,0,1,0,1
D11,Other,2017,1,4,0,3
D12,Sexual Violation,2017,14,20,0,6
D13,Theft Over $5000,2017,1,3,0,2
D13,Break & Enter-House,2017,0,25,0,25
D13,Other,2017,45,47,0,2
D14,Theft Under $5000,2017,23,122,0,99
D13,Theft Over $5000,2017,0,5,0,5
D13,Other,2017,1,1,1,0
D13,Break & Enter-House,2017,0,10,0,10
D13,Theft Over $5000,2017,0,4,0,4
D13,Other,2017,4,4,1,0
D13,Robbery-Financial,2017,1,1,1,0
D14,Theft Under $5000,2017,73,398,0,325
D13,Other,2017,15,15,1,0
D13,Break & Enter-House,2017,1,14,0,13
D13,Theft Over $5000,2017,4,6,0,2
D13,Other,2017,3,3,1,0
D14,Fraud,2017,18,64,0,46
D13,Robbery-Financial,2017,1,1,1,0
D14,Theft Under $5000,2017,40,174,0,134
D13,Other,2017,22,23,0,1
D13,Break & Enter-House,2017,3,18,0,15
D13,Theft Under $5000,2017,60,156,0,96
D13,Other,2017,4,4,1,0
D13,Robbery-Other,2017,6,19,0,13
D14,Fraud,2017,0,1,0,1
D14,Theft Under $5000,2017,4,19,0,15
D13,Other Criminal Violations - Offensive Weapons,2017,4,5,0,1
D13,Break & Enter-House,2017,12,27,0,15
D13,Theft Under $5000,2017,10,44,0,34
D13,Other,2017,14,15,0,1
D13,Other,2017,5,5,1,0
D13,Other,2017,2,4,0,2
D13,Other,2017,42,44,0,2
D13,Other,2017,10,12,0,2
D13,Other,2017,6,6,1,0
D13,Auto Theft,2017,3,10,0,7
D13,Auto Theft,2017,0,7,0,7
D13,Auto Theft,2017,3,5,0,2
D13,Auto Theft,2017,1,12,0,11
D13,Auto Theft,2017,4,11,0,7
D13,Auto Theft,2017,2,9,0,7
D13,Auto Theft,2017,1,6,0,5
D13,Auto Theft,2017,7,22,0,15
D13,Auto Theft,2017,2,6,0,4
D13,Auto Theft,2017,1,3,0,2
D13,Auto Theft,2017,2,14,0,12
D13,Auto Theft,2017,5,12,0,7
D13,Auto Theft,2017,2,8,0,6
D13,Break & Enter-Apartment,2017,3,14,0,11
D13,Break & Enter-Apartment,2017,2,7,0,5
D13,Break & Enter-Apartment,2017,3,6,0,3
D13,Break & Enter-Apartment,2017,0,3,0,3
D13,Break & Enter-Apartment,2017,0,1,0,1
D13,Break & Enter-Apartment,2017,5,26,0,21
D13,Break & Enter-Apartment,2017,5,18,0,13
D13,Break & Enter-Apartment,2017,6,6,1,0
D13,Break & Enter-Apartment,2017,0,1,0,1
D13,Break & Enter-Apartment,2017,2,6,0,4
D13,Break & Enter-Apartment,2017,2,6,0,4
D13,Break & Enter-Apartment,2017,3,9,0,6
D13,Break & Enter-Commercial,2017,6,11,0,5
D13,Break & Enter-Commercial,2017,1,1,1,0
D13,Break & Enter-Commercial,2017,0,1,0,1
D13,Break & Enter-Commercial,2017,2,5,0,3
D13,Break & Enter-Commercial,2017,0,1,0,1
D13,Break & Enter-Commercial,2017,8,8,1,0
D13,Break & Enter-Commercial,2017,2,3,0,1
D13,Break & Enter-Commercial,2017,3,4,0,1
D13,Break & Enter-Commercial,2017,7,10,0,3
D13,Break & Enter-Commercial,2017,5,6,0,1
D13,Break & Enter-Commercial,2017,4,16,0,12
D13,Break & Enter-Commercial,2017,2,3,0,1
D13,Break & Enter-House,2017,2,5,0,3
D13,Break & Enter-House,2017,1,9,0,8
D13,Break & Enter-House,2017,3,12,0,9
D13,Break & Enter-House,2017,1,16,0,15
D14,Break & Enter-Apartment,2017,0,5,0,5
D13,Other Criminal Violations - Offensive Weapons,2017,4,5,0,1
D14,Theft Under $5000,2017,49,366,0,317
D13,Other Criminal Violations - Offensive Weapons,2017,7,7,1,0
D14,Break & Enter-Apartment,2017,6,30,0,24
D13,Robbery-Other,2017,5,9,0,4
D13,Break & Enter-House,2017,4,14,0,10
D14,Fraud,2017,9,37,0,28
D13,Robbery-Other,2017,3,9,0,6
D13,Theft Under $5000,2017,49,152,0,103
D14,Break & Enter-Apartment,2017,0,11,0,11
D13,Break & Enter-House,2017,2,7,0,5
D14,Fraud,2017,5,13,0,8
D14,Theft Under $5000,2017,0,1,0,1
D13,Other Criminal Violations - Offensive Weapons,2017,3,3,1,0
D13,Robbery-Other,2017,5,25,0,20
D13,Theft Under $5000,2017,17,94,0,77
D14,Break & Enter-Apartment,2017,4,11,0,7
D13,Break & Enter-Other,2017,1,1,1,0
D14,Fraud,2017,1,1,1,0
D14,Theft Under $5000,2017,81,303,0,222
D13,Other Criminal Violations - Offensive Weapons,2017,2,2,1,0
D13,Robbery-Other,2017,1,3,0,2
D13,Theft Under $5000,2017,3,39,0,36
D14,Break & Enter-Apartment,2017,8,22,0,14
D13,Break & Enter-Other,2017,0,1,0,1
D14,Fraud,2017,39,98,0,59
D14,Theft Under $5000,2017,75,388,0,313
D13,Other Criminal Violations - Offensive Weapons,2017,2,2,1,0
D13,Robbery-Other,2017,1,3,0,2
D13,Theft Under $5000,2017,3,43,0,40
D14,Break & Enter-Apartment,2017,3,12,0,9
D13,Break & Enter-Other,2017,0,4,0,4
D14,Fraud,2017,11,37,0,26
D14,Theft Under $5000,2017,27,215,0,188
D13,Other Criminal Violations - Offensive Weapons,2017,2,2,1,0
D13,Robbery-Other,2017,0,2,0,2
D13,Theft Under $5000,2017,11,64,0,53
D14,Break & Enter-Apartment,2017,11,34,0,23
D13,Break & Enter-Other,2017,1,1,1,0
D14,Fraud,2017,28,79,0,51
D14,Theft Under $5000,2017,169,538,0,369
D13,Other Criminal Violations - Offensive Weapons,2017,12,14,0,2
D13,Robbery-Other,2017,1,7,0,6
D13,Robbery-Other,2017,0,1,0,1
D13,Robbery-Other,2017,0,1,0,1
D13,Robbery-Other,2017,9,24,0,15
D13,Robbery-Other,2017,6,16,0,10
D13,Robbery-Other,2017,3,9,0,6
D13,Sexual Violation,2017,3,3,1,0
D13,Sexual Violation,2017,4,6,0,2
D13,Sexual Violation,2017,2,2,1,0
D13,Sexual Violation,2017,6,7,0,1
D13,Sexual Violation,2017,1,2,0,1
D13,Sexual Violation,2017,2,2,1,0
D13,Sexual Violation,2017,5,12,0,7
D13,Sexual Violation,2017,1,3,0,2
D13,Sexual Violation,2017,1,3,0,2
D13,Sexual Violation,2017,6,11,0,5
D13,Sexual Violation,2017,5,6,0,1
D13,Sexual Violation,2017,3,6,0,3
D13,Other,2017,13,13,1,0
D13,Other,2017,13,13,1,0
D13,Other,2017,13,14,0,1
D13,Other,2017,5,5,1,0
D13,Other,2017,7,7,1,0
D13,Other,2017,8,8,1,0
D13,Other,2017,20,20,1,0
D13,Other,2017,6,6,1,0
D13,Other,2017,9,10,0,1
D13,Other,2017,1,1,1,0
D13,Other,2017,62,69,0,7
D13,Other,2017,1,1,1,0
D13,Other,2017,34,37,0,3
D13,Other,2017,31,33,0,2
D13,Other,2017,43,48,0,5
D13,Other,2017,7,7,1,0
D13,Other,2017,9,9,1,0
D13,Other,2017,8,10,0,2
D13,Other,2017,28,30,0,2
D13,Other,2017,6,8,0,2
D13,Other,2017,9,9,1,0
D13,Other,2017,120,129,0,9
D13,Other,2017,0,1,0,1
D14,Break & Enter-Apartment,2017,5,15,0,10
D14,Theft Under $5000,2017,63,263,0,200
D13,Break & Enter-Other,2017,0,2,0,2
D13,Theft Under $5000,2017,12,74,0,62
D14,Fraud,2017,13,34,0,21
D13,Other Criminal Violations - Offensive Weapons,2017,5,5,1,0
D14,Assault,2017,77,104,0,27
D13,Break & Enter-Other,2017,1,2,0,1
D13,Theft Under $5000,2017,2,25,0,23
D14,Assault,2017,0,1,0,1
D14,Fraud,2017,0,4,0,4
D13,Other Criminal Violations - Offensive Weapons,2017,3,3,1,0
D14,Break & Enter-Apartment,2017,1,21,0,20
D13,Other,2017,3,4,0,1
D14,Fraud,2017,0,1,0,1
D13,Break & Enter-Other,2017,1,2,0,1
D14,Assault,2017,53,80,0,27
D13,Theft Under $5000,2017,1,6,0,5
D14,Break & Enter-Apartment,2017,8,18,0,10
D13,Other,2017,2,2,1,0
D14,Fraud,2017,15,40,0,25
D13,Fraud,2017,0,1,0,1
D14,Assault,2017,18,30,0,12
D13,Theft Under $5000,2017,30,154,0,124
D14,Break & Enter-Apartment,2017,2,11,0,9
D13,Other,2017,2,2,1,0
D14,Fraud,2017,21,63,0,42
D13,Fraud,2017,22,44,0,22
D13,Fraud,2017,3,14,0,11
D13,Fraud,2017,2,14,0,12
D13,Fraud,2017,16,41,0,25
D13,Fraud,2017,6,11,0,5
D13,Fraud,2017,7,14,0,7
D13,Fraud,2017,3,14,0,11
D13,Fraud,2017,0,1,0,1
D13,Fraud,2017,4,20,0,16
D13,Fraud,2017,4,11,0,7
D13,Fraud,2017,0,2,0,2
D13,Fraud,2017,10,40,0,30
D13,Fraud,2017,9,37,0,28
D13,Fraud,2017,15,37,0,22
D13,Other,2017,33,63,0,30
D13,Other,2017,16,38,0,22
D13,Other,2017,8,23,0,15
D13,Other,2017,24,76,0,52
D13,Other,2017,6,17,0,11
D13,Other,2017,12,22,0,10
D13,Other,2017,5,15,0,10
D13,Other,2017,14,37,0,23
D13,Other,2017,5,14,0,9
D13,Other,2017,2,4,0,2
D13,Other,2017,44,90,0,46
D13,Other,2017,24,70,0,46
D13,Other,2017,12,28,0,16
D13,Theft Over $5000,2017,2,4,0,2
D13,Theft Over $5000,2017,0,1,0,1
D13,Theft Over $5000,2017,0,4,0,4
D13,Theft Over $5000,2017,2,3,0,1
D13,Theft Over $5000,2017,2,4,0,2
D13,Theft Over $5000,2017,0,2,0,2
D13,Theft Over $5000,2017,3,6,0,3
D13,Theft Over $5000,2017,1,5,0,4
D14,Assault,2017,61,86,0,25
D14,Fraud,2017,15,74,0,59
D13,Other,2017,1,1,1,0
D13,Theft Under $5000,2017,48,190,0,142
D14,Assault,2017,39,57,0,18
D14,Fraud,2017,20,44,0,24
D13,Other,2017,1,2,0,1
D14,Break & Enter-Commercial,2017,1,11,0,10
D13,Theft Under $5000,2017,20,98,0,78
D14,Assault,2017,127,196,0,69
D14,Fraud,2017,34,110,0,76
D13,Other,2017,2,3,0,1
D14,Break & Enter-Commercial,2017,1,11,0,10
D14,Break & Enter-Commercial,2017,0,3,0,3
D14,Break & Enter-Commercial,2017,9,23,0,14
D14,Break & Enter-Commercial,2017,1,3,0,2
D14,Break & Enter-Commercial,2017,3,24,0,21
D14,Break & Enter-Commercial,2017,2,8,0,6
D14,Break & Enter-Commercial,2017,0,5,0,5
D14,Break & Enter-Commercial,2017,2,15,0,13
D14,Break & Enter-Commercial,2017,10,33,0,23
D14,Break & Enter-Commercial,2017,1,15,0,14
D14,Break & Enter-Commercial,2017,17,34,0,17
D14,Break & Enter-Commercial,2017,4,13,0,9
D14,Break & Enter-House,2017,2,15,0,13
D14,Break & Enter-House,2017,3,21,0,18
D14,Break & Enter-House,2017,0,2,0,2
D14,Break & Enter-House,2017,0,1,0,1
D14,Break & Enter-House,2017,0,1,0,1
D14,Break & Enter-House,2017,1,4,0,3
D14,Break & Enter-House,2017,2,2,1,0
D14,Break & Enter-House,2017,4,18,0,14
D14,Break & Enter-House,2017,3,7,0,4
D14,Break & Enter-House,2017,4,15,0,11
D14,Break & Enter-House,2017,1,9,0,8
D14,Break & Enter-House,2017,1,1,1,0
D14,Break & Enter-House,2017,0,4,0,4
D14,Break & Enter-Other,2017,0,4,0,4
D14,Break & Enter-Other,2017,0,3,0,3
D14,Break & Enter-Other,2017,0,1,0,1
D14,Break & Enter-Other,2017,0,4,0,4
D14,Break & Enter-Other,2017,0,3,0,3
D14,Break & Enter-Other,2017,2,5,0,3
D14,Break & Enter-Other,2017,1,1,1,0
D14,Break & Enter-Other,2017,0,2,0,2
D14,Break & Enter-Other,2017,0,2,0,2
D14,Break & Enter-Other,2017,1,6,0,5
D14,Break & Enter-Other,2017,0,2,0,2
D14,Break & Enter-Other,2017,1,1,1,0
D14,Break & Enter-Other,2017,1,3,0,2
D13,Assault,2017,43,58,0,15
D13,Assault,2017,46,56,0,10
D13,Assault,2017,14,20,0,6
D13,Assault,2017,57,78,0,21
D13,Assault,2017,11,12,0,1
D13,Assault,2017,14,18,0,4
D13,Assault,2017,7,15,0,8
D13,Assault,2017,26,34,0,8
D13,Assault,2017,12,16,0,4
D13,Assault,2017,1,2,0,1
D13,Assault,2017,77,109,0,32
D13,Assault,2017,42,49,0,7
D13,Assault,2017,0,1,0,1
D13,Assault,2017,34,43,0,9
D13,Attempt Murder,2017,2,2,1,0
D13,Attempt Murder,2017,1,1,1,0
D13,Attempt Murder,2017,1,1,1,0
D13,Attempt Murder,2017,1,2,0,1
D13,Attempt Murder,2017,0,1,0,1
D13,Other,2017,9,14,0,5
D13,Other,2017,15,15,1,0
D13,Other,2017,7,7,1,0
D13,Other,2017,12,15,0,3
D13,Other,2017,6,10,0,4
D13,Other,2017,3,6,0,3
D13,Other,2017,3,3,1,0
D13,Other,2017,13,17,0,4
D13,Other,2017,4,4,1,0
D13,Other,2017,9,21,0,12
D13,Other,2017,19,22,0,3
D13,Other,2017,8,9,0,1
D13,Robbery-Financial,2017,0,1,0,1
D13,Robbery-Financial,2017,1,1,1,0
D14,Assault,2017,46,64,0,18
D13,Other,2017,1,1,1,0
D14,Fraud,2017,20,65,0,45
D14,Other,2017,11,11,1,0
D14,Assault,2017,2,3,0,1
D14,Other,2017,24,91,0,67
D14,Other,2017,13,14,0,1
D14,Assault,2017,0,1,0,1
D14,Other,2017,0,1,0,1
D14,Other,2017,4,4,1,0
D14,Assault,2017,53,73,0,20
D14,Other,2017,13,86,0,73
D14,Other,2017,24,28,0,4
D14,Assault,2017,134,184,0,50
D14,Other,2017,10,27,0,17
D14,Other,2017,21,21,1,0
D14,Assault,2017,62,112,0,50
D14,Other,2017,0,1,0,1
D14,Other,2017,97,98,0,1
D14,Assault,2017,50,89,0,39
D14,Other,2017,2,2,1,0
D14,Other,2017,11,13,0,2
D14,Other,2017,48,97,0,49
D14,Assault,2017,117,232,0,115
D14,Other,2017,7,7,1,0
D14,Other,2017,11,38,0,27
D14,Assault,2017,83,119,0,36
D14,Other,2017,16,18,0,2
D14,Other,2017,60,153,0,93
D14,Assault,2017,0,1,0,1
D14,Other,2017,70,74,0,4
D14,Other,2017,24,58,0,34
D14,Attempt Murder,2017,1,2,0,1
D14,Other,2017,64,65,0,1
D14,Other,2017,2,8,0,6
D14,Attempt Murder,2017,1,1,1,0
D14,Other,2017,11,11,1,0
D14,Other,2017,24,102,0,78
D14,Attempt Murder,2017,1,5,0,4
D14,Other,2017,63,64,0,1
D14,Other,2017,70,165,0,95
D14,Other,2017,11,20,0,9
D14,Other,2017,28,28,1,0
D14,Other,2017,37,117,0,80
D14,Other,2017,16,22,0,6
D14,Auto Theft,2017,2,12,0,10
D14,Other,2017,31,97,0,66
D14,Other,2017,3,6,0,3
D14,Auto Theft,2017,0,11,0,11
D14,Other,2017,38,96,0,58
D14,Other,2017,13,20,0,7
D14,Auto Theft,2017,1,2,0,1
D14,Other,2017,36,82,0,46
D14,Other,2017,8,10,0,2
D14,Auto Theft,2017,0,10,0,10
D14,Theft Over $5000,2017,1,3,0,2
D14,Other,2017,29,43,0,14
D14,Auto Theft,2017,2,8,0,6
D14,Theft Over $5000,2017,0,3,0,3
D14,Other,2017,12,17,0,5
D14,Auto Theft,2017,6,17,0,11
D14,Theft Over $5000,2017,2,8,0,6
D14,Other,2017,15,22,0,7
D14,Auto Theft,2017,5,13,0,8
D14,Theft Over $5000,2017,1,6,0,5
D14,Other,2017,35,52,0,17
D14,Auto Theft,2017,3,15,0,12
D14,Theft Over $5000,2017,1,7,0,6
D14,Other,2017,13,18,0,5
D14,Theft Over $5000,2017,0,1,0,1
D14,Auto Theft,2017,2,14,0,12
D14,Other,2017,12,22,0,10
D14,Theft Over $5000,2017,0,7,0,7
D14,Auto Theft,2017,4,23,0,19
D14,Other,2017,15,23,0,8
D14,Theft Over $5000,2017,1,9,0,8
D14,Auto Theft,2017,2,6,0,4
D14,Other,2017,23,34,0,11
D14,Theft Over $5000,2017,2,6,0,4
D14,Auto Theft,2017,5,16,0,11
D14,Robbery-Financial,2017,1,1,1,0
D14,Theft Over $5000,2017,1,3,0,2
D14,Auto Theft,2017,1,7,0,6
D14,Robbery-Financial,2017,1,1,1,0
D14,Theft Over $5000,2017,1,13,0,12
D14,Break & Enter-Apartment,2017,2,18,0,16
D14,Robbery-Financial,2017,1,1,1,0
D14,Theft Over $5000,2017,0,4,0,4
D14,Break & Enter-Apartment,2017,1,4,0,3
D14,Robbery-Financial,2017,2,2,1,0
D14,Theft Under $5000,2017,66,332,0,266
D14,Robbery-Other,2017,10,23,0,13
D14,Theft Under $5000,2017,46,228,0,182
D14,Robbery-Other,2017,13,32,0,19
D14,Theft Under $5000,2017,0,27,0,27
D14,Theft Under $5000,2017,49,301,0,252
D22,Theft Over $5000,2017,1,3,0,2
D22,Theft Over $5000,2017,0,1,0,1
D22,Theft Over $5000,2017,1,5,0,4
D22,Theft Over $5000,2017,0,1,0,1
D22,Theft Over $5000,2017,1,1,1,0
D22,Theft Over $5000,2017,0,3,0,3
D22,Theft Over $5000,2017,0,1,0,1
D22,Theft Over $5000,2017,0,6,0,6
D22,Other,2017,1,2,0,1
D22,Theft Under $5000,2017,13,80,0,67
D22,Theft Under $5000,2017,6,93,0,87
D22,Theft Under $5000,2017,5,62,0,57
D22,Other,2017,4,5,0,1
D22,Theft Under $5000,2017,311,805,0,494
D22,Other,2017,16,23,0,7
D22,Other,2017,19,19,1,0
D14,Other,2017,130,138,0,8
D14,Robbery-Other,2017,0,2,0,2
D22,Theft Under $5000,2017,3,39,0,36
D22,Theft Under $5000,2017,28,151,0,123
D22,Theft Under $5000,2017,84,255,0,171
D22,Auto Theft,2017,1,21,0,20
D22,Theft Under $5000,2017,70,182,0,112
D22,Theft Under $5000,2017,31,128,0,97
D22,Theft Under $5000,2017,18,100,0,82
D22,Theft Under $5000,2017,20,119,0,99
D22,Theft Under $5000,2017,1,10,0,9
D22,Theft Under $5000,2017,28,115,0,87
D22,Theft Under $5000,2017,15,90,0,75
D22,Theft Under $5000,2017,43,204,0,161
D22,Theft Under $5000,2017,0,1,0,1
D22,Assault,2017,14,19,0,5
D22,Assault,2017,18,25,0,7
D22,Assault,2017,42,53,0,11
D22,Assault,2017,73,129,0,56
D22,Assault,2017,31,47,0,16
D22,Assault,2017,0,1,0,1
D22,Assault,2017,54,76,0,22
D22,Assault,2017,1,1,1,0
D22,Assault,2017,43,64,0,21
D22,Assault,2017,9,17,0,8
D22,Assault,2017,41,62,0,21
D22,Assault,2017,15,21,0,6
D22,Assault,2017,90,245,0,155
D22,Assault,2017,3,10,0,7
D22,Assault,2017,60,90,0,30
D22,Assault,2017,14,22,0,8
D22,Assault,2017,0,1,0,1
D22,Break & Enter-Other,2017,1,1,1,0
D22,Assault,2017,61,95,0,34
D22,Attempt Murder,2017,1,1,1,0
D22,Attempt Murder,2017,2,4,0,2
D22,Attempt Murder,2017,1,1,1,0
D22,Other,2017,11,17,0,6
D22,Other,2017,4,11,0,7
D22,Other,2017,11,17,0,6
D22,Other,2017,26,44,0,18
D22,Other,2017,5,12,0,7
D22,Other,2017,1,3,0,2
D22,Other,2017,2,2,1,0
D22,Other,2017,15,23,0,8
D22,Break & Enter-Other,2017,0,1,0,1
D22,Other,2017,5,5,1,0
D14,Robbery-Other,2017,0,2,0,2
D22,Other,2017,1,1,1,0
D14,Other,2017,89,96,0,7
D22,Auto Theft,2017,5,14,0,9
D22,Other,2017,4,9,0,5
D22,Other,2017,14,14,1,0
D22,Other,2017,1,1,1,0
D22,Auto Theft,2017,1,9,0,8
D14,Robbery-Other,2017,1,1,1,0
D14,Other,2017,33,37,0,4
D22,Auto Theft,2017,2,23,0,21
D22,Other,2017,2,11,0,9
D22,Other,2017,1,1,1,0
D22,Other,2017,15,15,1,0
D14,Robbery-Other,2017,21,48,0,27
D22,Break & Enter-Other,2017,0,1,0,1
D22,Auto Theft,2017,0,1,0,1
D22,Other,2017,1,1,1,0
D22,Other,2017,8,8,1,0
D14,Robbery-Other,2017,3,9,0,6
D22,Other,2017,9,13,0,4
D22,Break & Enter-Other,2017,4,4,1,0
D14,Other,2017,123,126,0,3
D22,Auto Theft,2017,1,13,0,12
D23,Other,2017,9,9,1,0
D22,Other,2017,5,6,0,1
D14,Robbery-Other,2017,0,2,0,2
D22,Other,2017,25,46,0,21
D22,Break & Enter-Other,2017,1,1,1,0
D22,Break & Enter-Other,2017,0,1,0,1
D22,Break & Enter-Other,2017,0,5,0,5
D22,Break & Enter-Other,2017,1,1,1,0
D22,Break & Enter-Other,2017,1,2,0,1
D22,Fraud,2017,3,24,0,21
D22,Fraud,2017,7,31,0,24
D22,Fraud,2017,9,43,0,34
D22,Fraud,2017,47,180,0,133
D22,Fraud,2017,3,22,0,19
D22,Fraud,2017,19,82,0,63
D22,Fraud,2017,15,70,0,55
D22,Fraud,2017,3,23,0,20
D22,Fraud,2017,11,36,0,25
D22,Fraud,2017,9,46,0,37
D22,Fraud,2017,11,45,0,34
D22,Fraud,2017,0,1,0,1
D22,Fraud,2017,2,33,0,31
D22,Fraud,2017,5,26,0,21
D22,Fraud,2017,12,68,0,56
D22,Fraud,2017,0,1,0,1
D22,Fraud,2017,0,1,0,1
D22,Other,2017,6,21,0,15
D22,Other,2017,10,26,0,16
D22,Other,2017,16,64,0,48
D22,Other,2017,53,144,0,91
D22,Other,2017,9,35,0,26
D22,Other,2017,0,1,0,1
D22,Other,2017,18,53,0,35
D22,Other,2017,31,70,0,39
D22,Other,2017,11,48,0,37
D22,Other,2017,18,50,0,32
D22,Other,2017,9,33,0,24
D22,Other,2017,30,94,0,64
D22,Other,2017,0,6,0,6
D22,Other,2017,18,54,0,36
D22,Other,2017,7,36,0,29
D22,Other,2017,32,93,0,61
D22,Theft Over $5000,2017,0,7,0,7
D22,Theft Over $5000,2017,0,3,0,3
D22,Theft Over $5000,2017,0,2,0,2
D22,Theft Over $5000,2017,8,27,0,19
D22,Theft Over $5000,2017,1,4,0,3
D22,Theft Over $5000,2017,3,9,0,6
D22,Theft Over $5000,2017,0,6,0,6
D22,Theft Over $5000,2017,1,6,0,5
D23,Other,2017,9,9,1,0
D14,Robbery-Other,2017,5,12,0,7
D22,Other,2017,3,3,1,0
D23,Other,2017,14,15,0,1
D22,Auto Theft,2017,0,19,0,19
D22,Other,2017,0,2,0,2
D22,Other,2017,17,17,1,0
D14,Other,2017,66,69,0,3
D22,Other,2017,13,19,0,6
D23,Other,2017,42,45,0,3
D23,Other,2017,1,1,1,0
D14,Robbery-Other,2017,11,19,0,8
D22,Other,2017,3,8,0,5
D14,Other,2017,7,7,1,0
D22,Other,2017,3,3,1,0
D22,Other,2017,13,25,0,12
D14,Robbery-Other,2017,10,16,0,6
D14,Other Criminal Violations - Offensive Weapons,2017,10,10,1,0
D23,Other,2017,15,15,1,0
D22,Auto Theft,2017,6,35,0,29
D14,Robbery-Other,2017,4,12,0,8
D14,Other Criminal Violations - Offensive Weapons,2017,4,4,1,0
D22,Robbery-Financial,2017,1,1,1,0
D22,Other,2017,14,14,1,0
D22,Break & Enter-Apartment,2017,2,3,0,1
D23,Other,2017,4,5,0,1
D14,Robbery-Other,2017,8,19,0,11
D14,Other Criminal Violations - Offensive Weapons,2017,5,5,1,0
D22,Robbery-Financial,2017,0,4,0,4
D22,Other,2017,5,5,1,0
D22,Break & Enter-Apartment,2017,1,5,0,4
D23,Other,2017,32,35,0,3
D14,Robbery-Other,2017,4,6,0,2
D14,Other Criminal Violations - Offensive Weapons,2017,3,3,1,0
D22,Robbery-Financial,2017,3,3,1,0
D22,Other,2017,14,14,1,0
D22,Break & Enter-Apartment,2017,0,1,0,1
D23,Other,2017,10,10,1,0
D14,Sexual Violation,2017,6,7,0,1
D14,Other Criminal Violations - Offensive Weapons,2017,3,3,1,0
D22,Robbery-Financial,2017,3,3,1,0
D22,Other,2017,19,24,0,5
D22,Break & Enter-Apartment,2017,2,7,0,5
D23,Auto Theft,2017,0,4,0,4
D14,Sexual Violation,2017,17,27,0,10
D14,Other Criminal Violations - Offensive Weapons,2017,15,18,0,3
D22,Robbery-Financial,2017,2,2,1,0
D22,Other,2017,11,14,0,3
D22,Break & Enter-Apartment,2017,3,5,0,2
D23,Auto Theft,2017,1,12,0,11
D14,Sexual Violation,2017,5,6,0,1
D14,Other Criminal Violations - Offensive Weapons,2017,2,2,1,0
D14,Other Criminal Violations - Offensive Weapons,2017,1,1,1,0
D14,Other Criminal Violations - Offensive Weapons,2017,2,2,1,0
D14,Other Criminal Violations - Offensive Weapons,2017,8,8,1,0
D14,Other Criminal Violations - Offensive Weapons,2017,10,10,1,0
D14,Other Criminal Violations - Offensive Weapons,2017,10,11,0,1
D14,Other Criminal Violations - Offensive Weapons,2017,16,19,0,3
D14,Other Criminal Violations - Offensive Weapons,2017,3,3,1,0
D14,Other,2017,1,1,1,0
D14,Other,2017,1,1,1,0
D14,Other,2017,1,1,1,0
D14,Other,2017,0,1,0,1
D14,Other,2017,1,1,1,0
D14,Other,2017,0,1,0,1
D14,Other,2017,2,2,1,0
D14,Other,2017,1,1,1,0
D22,Other,2017,7,7,1,0
D22,Other,2017,7,7,1,0
D22,Other,2017,24,27,0,3
D22,Other,2017,6,8,0,2
D22,Other,2017,15,15,1,0
D22,Other,2017,3,3,1,0
D22,Other,2017,12,12,1,0
D22,Other,2017,4,4,1,0
D22,Other,2017,19,19,1,0
D22,Other,2017,4,4,1,0
D22,Other,2017,26,32,0,6
D22,Other,2017,5,6,0,1
D22,Other,2017,28,29,0,1
D22,Other,2017,4,4,1,0
D22,Other,2017,17,18,0,1
D22,Auto Theft,2017,1,16,0,15
D22,Auto Theft,2017,5,14,0,9
D22,Auto Theft,2017,3,29,0,26
D22,Auto Theft,2017,13,79,0,66
D22,Auto Theft,2017,2,9,0,7
D22,Auto Theft,2017,5,18,0,13
D22,Auto Theft,2017,4,25,0,21
D22,Other,2017,16,18,0,2
D22,Robbery-Financial,2017,3,3,1,0
D23,Auto Theft,2017,1,25,0,24
D14,Sexual Violation,2017,9,11,0,2
D22,Other,2017,109,133,0,24
D22,Robbery-Financial,2017,1,1,1,0
D14,Sexual Violation,2017,7,11,0,4
D23,Auto Theft,2017,8,37,0,29
D22,Break & Enter-Apartment,2017,6,10,0,4
D14,Sexual Violation,2017,7,12,0,5
D22,Other,2017,8,10,0,2
D22,Robbery-Financial,2017,1,1,1,0
D22,Break & Enter-Apartment,2017,2,8,0,6
D23,Auto Theft,2017,3,50,0,47
D14,Sexual Violation,2017,3,5,0,2
D22,Other,2017,31,36,0,5
D22,Robbery-Financial,2017,1,1,1,0
D22,Break & Enter-Apartment,2017,0,1,0,1
D23,Auto Theft,2017,4,23,0,19
D14,Sexual Violation,2017,1,2,0,1
D22,Other,2017,2,2,1,0
D22,Robbery-Other,2017,4,5,0,1
D22,Break & Enter-Apartment,2017,5,8,0,3
D23,Auto Theft,2017,1,24,0,23
D14,Sexual Violation,2017,4,5,0,1
D22,Other,2017,19,19,1,0
D22,Robbery-Other,2017,0,3,0,3
D22,Break & Enter-Apartment,2017,1,4,0,3
D14,Sexual Violation,2017,10,18,0,8
D23,Auto Theft,2017,26,333,0,307
D22,Other,2017,33,42,0,9
D22,Break & Enter-Apartment,2017,8,11,0,3
D23,Auto Theft,2017,0,43,0,43
D22,Robbery-Other,2017,6,14,0,8
D14,Sexual Violation,2017,9,13,0,4
D22,Other,2017,17,21,0,4
D22,Break & Enter-Apartment,2017,1,7,0,6
D23,Break & Enter-Apartment,2017,0,5,0,5
D22,Robbery-Other,2017,17,38,0,21
D14,Sexual Violation,2017,10,16,0,6
D22,Other,2017,36,41,0,5
D22,Break & Enter-Apartment,2017,0,2,0,2
D23,Break & Enter-Apartment,2017,0,6,0,6
D22,Robbery-Other,2017,1,5,0,4
D14,Sexual Violation,2017,7,16,0,9
D22,Other,2017,13,15,0,2
D22,Break & Enter-Apartment,2017,3,9,0,6
D23,Break & Enter-Apartment,2017,1,22,0,21
D22,Robbery-Other,2017,4,6,0,2
D14,Sexual Violation,2017,9,19,0,10
D22,Other,2017,633,683,0,50
D22,Break & Enter-Commercial,2017,4,16,0,12
D23,Break & Enter-Apartment,2017,3,20,0,17
D22,Robbery-Other,2017,7,13,0,6
D14,Other,2017,3,3,1,0
D22,Other,2017,4,4,1,0
D22,Break & Enter-Commercial,2017,1,3,0,2
D23,Break & Enter-Apartment,2017,0,1,0,1
D22,Robbery-Other,2017,4,12,0,8
D14,Other,2017,8,8,1,0
D22,Other,2017,49,55,0,6
D22,Break & Enter-Commercial,2017,0,2,0,2
D23,Break & Enter-Apartment,2017,2,11,0,9
D22,Robbery-Other,2017,5,11,0,6
D14,Other,2017,5,5,1,0
D22,Other,2017,12,16,0,4
D22,Break & Enter-Commercial,2017,17,41,0,24
D23,Break & Enter-Apartment,2017,2,5,0,3
D22,Robbery-Other,2017,2,6,0,4
D14,Other,2017,8,9,0,1
D22,Other,2017,36,42,0,6
D22,Other,2017,2,2,1,0
D22,Other,2017,1,1,1,0
D22,Other Criminal Violations - Offensive Weapons,2017,2,2,1,0
D22,Other Criminal Violations - Offensive Weapons,2017,1,3,0,2
D22,Other Criminal Violations - Offensive Weapons,2017,6,6,1,0
D22,Other Criminal Violations - Offensive Weapons,2017,5,5,1,0
D22,Other Criminal Violations - Offensive Weapons,2017,3,4,0,1
D22,Other Criminal Violations - Offensive Weapons,2017,5,5,1,0
D22,Other Criminal Violations - Offensive Weapons,2017,2,2,1,0
D22,Other Criminal Violations - Offensive Weapons,2017,5,5,1,0
D22,Other Criminal Violations - Offensive Weapons,2017,3,3,1,0
D22,Other Criminal Violations - Offensive Weapons,2017,12,14,0,2
D22,Other Criminal Violations - Offensive Weapons,2017,1,1,1,0
D22,Other Criminal Violations - Offensive Weapons,2017,7,7,1,0
D22,Other Criminal Violations - Offensive Weapons,2017,3,3,1,0
D22,Other Criminal Violations - Offensive Weapons,2017,11,11,1,0
D22,Other,2017,2,2,1,0
D22,Other,2017,1,1,1,0
D22,Other,2017,6,8,0,2
D22,Robbery-Other,2017,9,14,0,5
D23,Break & Enter-Commercial,2017,0,1,0,1
D14,Other,2017,14,18,0,4
D22,Break & Enter-Commercial,2017,1,1,1,0
D22,Robbery-Other,2017,0,1,0,1
D23,Break & Enter-Commercial,2017,0,9,0,9
D14,Other,2017,8,8,1,0
D22,Break & Enter-Commercial,2017,2,5,0,3
D22,Robbery-Other,2017,5,20,0,15
D23,Break & Enter-Commercial,2017,4,6,0,2
D14,Other,2017,4,4,1,0
D22,Break & Enter-Commercial,2017,8,17,0,9
D22,Robbery-Other,2017,0,5,0,5
D23,Break & Enter-Commercial,2017,1,2,0,1
D14,Other,2017,1,1,1,0
D22,Break & Enter-Commercial,2017,2,5,0,3
D22,Robbery-Other,2017,13,22,0,9
D14,Other,2017,4,4,1,0
D23,Break & Enter-Commercial,2017,1,5,0,4
D14,Other,2017,30,31,0,1
D22,Sexual Violation,2017,7,11,0,4
D23,Break & Enter-Commercial,2017,2,4,0,2
D14,Other,2017,9,9,1,0
D22,Break & Enter-Commercial,2017,1,8,0,7
D22,Sexual Violation,2017,0,2,0,2
D14,Other,2017,5,5,1,0
D22,Break & Enter-Commercial,2017,2,2,1,0
D23,Break & Enter-Commercial,2017,17,75,0,58
D22,Sexual Violation,2017,2,5,0,3
D14,Other,2017,13,14,0,1
D22,Break & Enter-Commercial,2017,10,16,0,6
D23,Break & Enter-Commercial,2017,0,7,0,7
D22,Sexual Violation,2017,4,16,0,12
D14,Other,2017,5,5,1,0
D22,Break & Enter-Commercial,2017,7,15,0,8
D23,Break & Enter-House,2017,1,5,0,4
D22,Sexual Violation,2017,3,6,0,3
D14,Other,2017,1,1,1,0
D22,Break & Enter-Commercial,2017,1,3,0,2
D23,Break & Enter-House,2017,1,16,0,15
D22,Sexual Violation,2017,3,11,0,8
D14,Other,2017,36,41,0,5
D22,Break & Enter-Commercial,2017,4,11,0,7
D23,Break & Enter-House,2017,0,10,0,10
D22,Sexual Violation,2017,7,11,0,4
D14,Other,2017,28,33,0,5
D22,Break & Enter-House,2017,0,3,0,3
D23,Break & Enter-House,2017,3,7,0,4
D22,Sexual Violation,2017,2,5,0,3
D14,Other,2017,10,11,0,1
D22,Break & Enter-House,2017,10,33,0,23
D23,Break & Enter-House,2017,1,7,0,6
D22,Sexual Violation,2017,11,13,0,2
D14,Other,2017,67,67,1,0
D22,Break & Enter-House,2017,2,14,0,12
D23,Break & Enter-House,2017,1,11,0,10
D22,Sexual Violation,2017,1,1,1,0
D14,Other,2017,22,25,0,3
D22,Break & Enter-House,2017,3,4,0,1
D23,Break & Enter-House,2017,5,35,0,30
D22,Sexual Violation,2017,8,17,0,9
D14,Other,2017,131,139,0,8
D23,Break & Enter-House,2017,3,25,0,22
D22,Break & Enter-House,2017,0,2,0,2
D22,Sexual Violation,2017,1,4,0,3
D14,Other,2017,56,61,0,5
D22,Break & Enter-House,2017,2,14,0,12
D23,Break & Enter-Other,2017,0,1,0,1
D22,Sexual Violation,2017,7,12,0,5
D14,Other,2017,15,15,1,0
D22,Break & Enter-House,2017,8,25,0,17
D23,Break & Enter-Other,2017,0,1,0,1
D22,Sexual Violation,2017,0,1,0,1
D14,Other,2017,49,54,0,5
D22,Break & Enter-House,2017,4,11,0,7
D23,Break & Enter-Other,2017,2,5,0,3
D22,Sexual Violation,2017,8,11,0,3
D22,Break & Enter-House,2017,2,6,0,4
D22,Other,2017,8,8,1,0
D22,Break & Enter-House,2017,3,11,0,8
D22,Break & Enter-House,2017,0,1,0,1
D22,Break & Enter-House,2017,1,4,0,3
D22,Break & Enter-House,2017,6,23,0,17
D22,Break & Enter-House,2017,8,28,0,20
D23,Other,2017,3,3,1,0
D31,Other,2017,0,1,0,1
D23,Other,2017,3,3,1,0
D23,Other,2017,7,7,1,0
D23,Other,2017,13,13,1,0
D31,Other,2017,1,2,0,1
D23,Break & Enter-Other,2017,1,2,0,1
D23,Other,2017,5,5,1,0
D31,Other,2017,5,5,1,0
D23,Other,2017,5,5,1,0
D23,Break & Enter-Other,2017,0,4,0,4
D31,Other,2017,1,2,0,1
D23,Other,2017,4,5,0,1
D23,Break & Enter-Other,2017,1,3,0,2
D31,Other,2017,1,1,1,0
D23,Other,2017,6,6,1,0
D23,Fraud,2017,1,4,0,3
D31,Other,2017,1,1,1,0
D23,Other,2017,45,47,0,2
D31,Robbery-Financial,2017,3,3,1,0
D31,Auto Theft,2017,2,54,0,52
D23,Fraud,2017,5,24,0,19
D23,Fraud,2017,2,18,0,16
D23,Fraud,2017,0,1,0,1
D23,Fraud,2017,8,54,0,46
D23,Fraud,2017,33,167,0,134
D23,Fraud,2017,2,6,0,4
D23,Fraud,2017,4,33,0,29
D23,Fraud,2017,6,35,0,29
D23,Fraud,2017,57,218,0,161
D23,Fraud,2017,11,49,0,38
D23,Other,2017,0,1,0,1
D23,Other,2017,1,3,0,2
D23,Other,2017,15,44,0,29
D23,Other,2017,6,29,0,23
D23,Other,2017,2,2,1,0
D23,Other,2017,17,77,0,60
D23,Other,2017,0,1,0,1
D23,Other,2017,49,145,0,96
D23,Other,2017,3,5,0,2
D23,Other,2017,0,3,0,3
D23,Other,2017,13,37,0,24
D23,Other,2017,9,30,0,21
D23,Other,2017,65,209,0,144
D23,Other,2017,17,67,0,50
D23,Theft Over $5000,2017,0,1,0,1
D23,Theft Over $5000,2017,0,2,0,2
D23,Theft Over $5000,2017,0,6,0,6
D23,Theft Over $5000,2017,1,6,0,5
D23,Theft Over $5000,2017,1,1,1,0
D23,Theft Over $5000,2017,1,1,1,0
D23,Theft Over $5000,2017,2,4,0,2
D23,Theft Over $5000,2017,14,58,0,44
D23,Theft Over $5000,2017,0,4,0,4
D23,Theft Under $5000,2017,0,5,0,5
D23,Theft Under $5000,2017,81,147,0,66
D23,Theft Under $5000,2017,2,39,0,37
D23,Theft Under $5000,2017,0,2,0,2
D23,Theft Under $5000,2017,45,164,0,119
D23,Theft Under $5000,2017,119,309,0,190
D23,Theft Under $5000,2017,4,5,0,1
D23,Theft Under $5000,2017,5,49,0,44
D23,Theft Under $5000,2017,15,61,0,46
D23,Theft Under $5000,2017,192,712,0,520
D23,Theft Under $5000,2017,17,143,0,126
D23,Assault,2017,1,2,0,1
D32,Break & Enter-Apartment,2017,2,7,0,5
D23,Assault,2017,38,58,0,20
D31,Other,2017,16,51,0,35
D23,Assault,2017,21,34,0,13
D31,Other,2017,7,7,1,0
D32,Break & Enter-Apartment,2017,0,2,0,2
D23,Assault,2017,0,1,0,1
D31,Auto Theft,2017,4,83,0,79
D31,Other,2017,4,4,1,0
D31,Robbery-Financial,2017,2,2,1,0
D31,Other,2017,4,5,0,1
D23,Assault,2017,58,90,0,32
D31,Auto Theft,2017,1,59,0,58
D32,Break & Enter-Apartment,2017,0,1,0,1
D32,Other,2017,8,9,0,1
D23,Other,2017,7,8,0,1
D31,Other,2017,60,160,0,100
D23,Assault,2017,150,245,0,95
D32,Other,2017,2,2,1,0
D23,Other,2017,1,1,1,0
D32,Break & Enter-Apartment,2017,0,3,0,3
D31,Robbery-Other,2017,23,42,0,19
D31,Auto Theft,2017,1,2,0,1
D31,Other,2017,30,81,0,51
D23,Assault,2017,2,6,0,4
D32,Other,2017,1,2,0,1
D23,Other,2017,16,17,0,1
D32,Break & Enter-Apartment,2017,1,18,0,17
D31,Robbery-Other,2017,2,10,0,8
D31,Auto Theft,2017,3,54,0,51
D31,Other,2017,25,72,0,47
D23,Assault,2017,0,2,0,2
D32,Other,2017,4,4,1,0
D23,Other,2017,8,10,0,2
D32,Break & Enter-Apartment,2017,0,1,0,1
D31,Robbery-Other,2017,16,47,0,31
D31,Auto Theft,2017,1,23,0,22
D31,Other,2017,2,3,0,1
D23,Assault,2017,47,73,0,26
D32,Other,2017,5,5,1,0
D23,Other,2017,24,24,1,0
D32,Break & Enter-Apartment,2017,1,28,0,27
D31,Robbery-Other,2017,10,25,0,15
D31,Auto Theft,2017,7,65,0,58
D31,Other,2017,46,145,0,99
D23,Assault,2017,33,55,0,22
D32,Other,2017,7,7,1,0
D23,Other,2017,23,28,0,5
D32,Break & Enter-Apartment,2017,0,1,0,1
D31,Robbery-Other,2017,14,30,0,16
D31,Break & Enter-Apartment,2017,8,12,0,4
D31,Other,2017,3,16,0,13
D23,Assault,2017,157,268,0,111
D23,Assault,2017,59,91,0,32
D23,Attempt Murder,2017,2,2,1,0
D23,Attempt Murder,2017,0,1,0,1
D23,Attempt Murder,2017,3,6,0,3
D23,Other,2017,0,1,0,1
D23,Other,2017,1,3,0,2
D23,Other,2017,7,10,0,3
D23,Other,2017,12,16,0,4
D23,Other,2017,18,27,0,9
D23,Other,2017,57,83,0,26
D23,Other,2017,11,19,0,8
D23,Other,2017,9,15,0,6
D23,Other,2017,51,89,0,38
D23,Other,2017,18,32,0,14
D23,Robbery-Financial,2017,1,1,1,0
D23,Robbery-Financial,2017,4,6,0,2
D23,Robbery-Financial,2017,1,1,1,0
D23,Robbery-Other,2017,0,1,0,1
D23,Robbery-Other,2017,8,21,0,13
D23,Robbery-Other,2017,1,5,0,4
D23,Robbery-Other,2017,1,1,1,0
D23,Robbery-Other,2017,2,13,0,11
D23,Robbery-Other,2017,22,65,0,43
D23,Robbery-Other,2017,0,4,0,4
D23,Robbery-Other,2017,0,2,0,2
D23,Robbery-Other,2017,11,26,0,15
D23,Robbery-Other,2017,6,20,0,14
D23,Robbery-Other,2017,22,105,0,83
D23,Robbery-Other,2017,7,16,0,9
D23,Sexual Violation,2017,1,1,1,0
D23,Sexual Violation,2017,1,1,1,0
D23,Sexual Violation,2017,2,4,0,2
D23,Sexual Violation,2017,7,7,1,0
D23,Sexual Violation,2017,15,21,0,6
D23,Sexual Violation,2017,1,3,0,2
D23,Sexual Violation,2017,2,2,1,0
D23,Sexual Violation,2017,5,6,0,1
D23,Sexual Violation,2017,5,6,0,1
D23,Sexual Violation,2017,26,42,0,16
D23,Sexual Violation,2017,9,14,0,5
D23,Other,2017,4,4,1,0
D23,Other,2017,135,140,0,5
D32,Break & Enter-Apartment,2017,1,3,0,2
D31,Break & Enter-Apartment,2017,0,3,0,3
D31,Robbery-Other,2017,0,1,0,1
D32,Other,2017,3,3,1,0
D32,Other,2017,9,10,0,1
D31,Other,2017,67,186,0,119
D32,Break & Enter-Apartment,2017,0,1,0,1
D31,Break & Enter-Apartment,2017,13,21,0,8
D32,Other,2017,1,1,1,0
D23,Other,2017,3,3,1,0
D31,Robbery-Other,2017,15,47,0,32
D31,Theft Over $5000,2017,1,17,0,16
D32,Break & Enter-Apartment,2017,2,6,0,4
D31,Break & Enter-Apartment,2017,1,4,0,3
D32,Other,2017,6,7,0,1
D23,Other,2017,1,1,1,0
D31,Robbery-Other,2017,4,12,0,8
D31,Theft Over $5000,2017,2,9,0,7
D32,Break & Enter-Commercial,2017,0,5,0,5
D31,Break & Enter-Apartment,2017,1,3,0,2
D32,Other,2017,9,9,1,0
D23,Other,2017,35,38,0,3
D31,Robbery-Other,2017,19,58,0,39
D31,Theft Over $5000,2017,0,9,0,9
D32,Break & Enter-Commercial,2017,0,3,0,3
D31,Break & Enter-Apartment,2017,5,15,0,10
D23,Other,2017,6,8,0,2
D32,Other,2017,5,5,1,0
D23,Other,2017,138,156,0,18
D31,Sexual Violation,2017,19,28,0,9
D31,Theft Over $5000,2017,3,19,0,16
D32,Break & Enter-Commercial,2017,2,13,0,11
D31,Theft Over $5000,2017,1,9,0,8
D32,Other,2017,4,4,1,0
D23,Other,2017,29,36,0,7
D31,Sexual Violation,2017,8,13,0,5
D31,Break & Enter-Apartment,2017,1,1,1,0
D23,Other,2017,1,1,1,0
D31,Sexual Violation,2017,14,26,0,12
D31,Theft Over $5000,2017,0,1,0,1
D32,Other,2017,6,7,0,1
D23,Other,2017,1,1,1,0
D32,Break & Enter-Commercial,2017,0,1,0,1
D31,Break & Enter-Apartment,2017,12,31,0,19
D31,Sexual Violation,2017,6,11,0,5
D31,Theft Over $5000,2017,1,10,0,9
D23,Other Criminal Violations - Offensive Weapons,2017,4,5,0,1
D32,Other,2017,6,7,0,1
D32,Break & Enter-Commercial,2017,0,11,0,11
D31,Break & Enter-Commercial,2017,1,2,0,1
D31,Sexual Violation,2017,3,6,0,3
D31,Theft Over $5000,2017,0,1,0,1
D23,Other Criminal Violations - Offensive Weapons,2017,3,3,1,0
D32,Other,2017,17,18,0,1
D32,Break & Enter-Commercial,2017,0,2,0,2
D31,Break & Enter-Commercial,2017,0,6,0,6
D31,Sexual Violation,2017,10,20,0,10
D31,Theft Over $5000,2017,3,24,0,21
D23,Other Criminal Violations - Offensive Weapons,2017,13,14,0,1
D32,Auto Theft,2017,0,3,0,3
D32,Break & Enter-Commercial,2017,0,2,0,2
D31,Break & Enter-Commercial,2017,1,8,0,7
D31,Sexual Violation,2017,4,5,0,1
D31,Theft Under $5000,2017,59,196,0,137
D23,Other Criminal Violations - Offensive Weapons,2017,27,32,0,5
D32,Auto Theft,2017,0,26,0,26
D32,Break & Enter-Commercial,2017,0,1,0,1
D31,Break & Enter-Commercial,2017,3,19,0,16
D31,Break & Enter-Commercial,2017,1,7,0,6
D31,Break & Enter-Commercial,2017,1,5,0,4
D31,Break & Enter-Commercial,2017,0,2,0,2
D31,Break & Enter-Commercial,2017,1,15,0,14
D31,Break & Enter-House,2017,1,10,0,9
D31,Break & Enter-House,2017,1,4,0,3
D31,Break & Enter-House,2017,3,12,0,9
D31,Break & Enter-House,2017,1,12,0,11
D31,Break & Enter-House,2017,1,10,0,9
D31,Break & Enter-House,2017,0,12,0,12
D31,Break & Enter-House,2017,0,12,0,12
D31,Break & Enter-House,2017,4,15,0,11
D31,Break & Enter-Other,2017,0,2,0,2
D31,Break & Enter-Other,2017,1,2,0,1
D31,Break & Enter-Other,2017,0,1,0,1
D31,Break & Enter-Other,2017,0,5,0,5
D31,Break & Enter-Other,2017,0,1,0,1
D31,Break & Enter-Other,2017,0,1,0,1
D31,Break & Enter-Other,2017,1,4,0,3
D31,Fraud,2017,11,61,0,50
D31,Fraud,2017,7,43,0,36
D31,Fraud,2017,1,1,1,0
D31,Fraud,2017,15,95,0,80
D31,Fraud,2017,8,72,0,64
D31,Fraud,2017,12,43,0,31
D31,Fraud,2017,1,2,0,1
D31,Fraud,2017,12,69,0,57
D31,Fraud,2017,2,13,0,11
D31,Fraud,2017,0,1,0,1
D31,Fraud,2017,20,165,0,145
D31,Other,2017,44,122,0,78
D23,Other Criminal Violations - Offensive Weapons,2017,3,4,0,1
D31,Sexual Violation,2017,1,1,1,0
D32,Auto Theft,2017,3,38,0,35
D23,Other Criminal Violations - Offensive Weapons,2017,4,5,0,1
D31,Sexual Violation,2017,39,53,0,14
D32,Auto Theft,2017,0,2,0,2
D23,Other Criminal Violations - Offensive Weapons,2017,13,18,0,5
D31,Other,2017,8,9,0,1
D32,Auto Theft,2017,2,29,0,27
D23,Other Criminal Violations - Offensive Weapons,2017,6,7,0,1
D31,Other,2017,13,14,0,1
D31,Other,2017,41,42,0,1
D31,Other,2017,19,20,0,1
D31,Other,2017,10,11,0,1
D31,Other,2017,3,3,1,0
D31,Other,2017,20,21,0,1
D31,Other,2017,6,6,1,0
D31,Other,2017,24,25,0,1
D31,Other,2017,124,134,0,10
D31,Other,2017,25,31,0,6
D31,Other,2017,3,3,1,0
D31,Other,2017,135,149,0,14
D31,Other,2017,55,65,0,10
D31,Other,2017,234,240,0,6
D31,Other,2017,6,7,0,1
D31,Other,2017,148,166,0,18
D31,Other,2017,11,12,0,1
D31,Other,2017,3,3,1,0
D31,Other,2017,148,165,0,17
D31,Other Criminal Violations - Offensive Weapons,2017,26,30,0,4
D31,Other Criminal Violations - Offensive Weapons,2017,7,8,0,1
D31,Other Criminal Violations - Offensive Weapons,2017,32,37,0,5
D31,Other Criminal Violations - Offensive Weapons,2017,5,5,1,0
D31,Other Criminal Violations - Offensive Weapons,2017,18,21,0,3
D31,Other Criminal Violations - Offensive Weapons,2017,3,3,1,0
D31,Other Criminal Violations - Offensive Weapons,2017,23,28,0,5
D31,Other Criminal Violations - Offensive Weapons,2017,3,3,1,0
D31,Other Criminal Violations - Offensive Weapons,2017,33,41,0,8
D31,Other,2017,6,6,1,0
D32,Break & Enter-Commercial,2017,0,8,0,8
D32,Auto Theft,2017,1,7,0,6
D23,Other,2017,1,1,1,0
D32,Break & Enter-Commercial,2017,3,8,0,5
D32,Auto Theft,2017,1,14,0,13
D23,Other,2017,2,2,1,0
D32,Break & Enter-Commercial,2017,0,5,0,5
D32,Auto Theft,2017,2,28,0,26
D23,Other,2017,3,4,0,1
D32,Break & Enter-Commercial,2017,1,6,0,5
D32,Auto Theft,2017,5,30,0,25
D23,Other,2017,1,1,1,0
D32,Break & Enter-Commercial,2017,1,11,0,10
D32,Auto Theft,2017,2,29,0,27
D23,Other,2017,1,1,1,0
D32,Break & Enter-Commercial,2017,0,1,0,1
D32,Auto Theft,2017,0,6,0,6
D23,Other,2017,4,4,1,0
D32,Break & Enter-Commercial,2017,0,1,0,1
D32,Auto Theft,2017,0,13,0,13
D23,Other,2017,2,2,1,0
D32,Break & Enter-Commercial,2017,1,2,0,1
D32,Auto Theft,2017,6,40,0,34
D31,Other,2017,37,40,0,3
D32,Break & Enter-Commercial,2017,0,6,0,6
D32,Auto Theft,2017,3,7,0,4
D31,Other,2017,10,10,1,0
D32,Break & Enter-Commercial,2017,1,39,0,38
D32,Auto Theft,2017,2,18,0,16
D31,Other,2017,87,88,0,1
D32,Break & Enter-Commercial,2017,8,30,0,22
D32,Auto Theft,2017,0,14,0,14
D31,Other,2017,14,15,0,1
D32,Break & Enter-House,2017,0,4,0,4
D32,Auto Theft,2017,0,12,0,12
D31,Other,2017,14,16,0,2
D32,Break & Enter-House,2017,1,27,0,26
D32,Auto Theft,2017,3,31,0,28
D31,Other,2017,12,12,1,0
D32,Break & Enter-House,2017,4,68,0,64
D32,Auto Theft,2017,9,48,0,39
D31,Other,2017,41,46,0,5
D32,Break & Enter-House,2017,0,33,0,33
D32,Break & Enter-Apartment,2017,0,1,0,1
D31,Other,2017,7,8,0,1
D32,Break & Enter-House,2017,8,37,0,29
D32,Break & Enter-Apartment,2017,1,5,0,4
D31,Other,2017,41,41,1,0
D32,Break & Enter-House,2017,1,6,0,5
D32,Break & Enter-Apartment,2017,0,3,0,3
D31,Auto Theft,2017,3,34,0,31
D32,Break & Enter-House,2017,4,68,0,64
D32,Break & Enter-Apartment,2017,0,1,0,1
D31,Auto Theft,2017,2,24,0,22
D32,Break & Enter-House,2017,0,10,0,10
D32,Break & Enter-Apartment,2017,1,5,0,4
D32,Break & Enter-House,2017,2,32,0,30
D32,Break & Enter-Apartment,2017,1,3,0,2
D32,Break & Enter-House,2017,0,19,0,19
D32,Break & Enter-Apartment,2017,1,2,0,1
D32,Break & Enter-House,2017,4,47,0,43
D32,Break & Enter-House,2017,5,56,0,51
D32,Break & Enter-House,2017,1,39,0,38
D32,Break & Enter-House,2017,1,13,0,12
D32,Break & Enter-House,2017,3,25,0,22
D32,Break & Enter-House,2017,1,3,0,2
D32,Break & Enter-Other,2017,0,1,0,1
D32,Break & Enter-Other,2017,1,3,0,2
D32,Break & Enter-Other,2017,0,1,0,1
D32,Break & Enter-Other,2017,0,1,0,1
D31,Theft Under $5000,2017,43,165,0,122
D31,Theft Under $5000,2017,62,243,0,181
D31,Theft Under $5000,2017,24,183,0,159
D31,Theft Under $5000,2017,4,88,0,84
D31,Theft Under $5000,2017,2,12,0,10
D31,Theft Under $5000,2017,167,387,0,220
D31,Theft Under $5000,2017,6,44,0,38
D31,Theft Under $5000,2017,134,476,0,342
D31,Assault,2017,130,187,0,57
D31,Assault,2017,59,87,0,28
D31,Assault,2017,150,248,0,98
D31,Assault,2017,58,96,0,38
D31,Assault,2017,95,130,0,35
D31,Assault,2017,3,10,0,7
D31,Assault,2017,151,236,0,85
D31,Assault,2017,20,28,0,8
D31,Assault,2017,182,255,0,73
D31,Attempt Murder,2017,8,12,0,4
D31,Attempt Murder,2017,1,2,0,1
D31,Attempt Murder,2017,2,7,0,5
D31,Attempt Murder,2017,2,4,0,2
D31,Attempt Murder,2017,0,1,0,1
D31,Attempt Murder,2017,4,4,1,0
D31,Other,2017,25,57,0,32
D31,Other,2017,8,16,0,8
D31,Other,2017,31,55,0,24
D31,Other,2017,16,29,0,13
D31,Other,2017,27,42,0,15
D31,Other,2017,42,65,0,23
D31,Other,2017,1,5,0,4
D31,Other,2017,42,64,0,22
D33,Break & Enter-Other,2017,0,1,0,1
D33,Break & Enter-Other,2017,0,2,0,2
D33,Break & Enter-Other,2017,0,1,0,1
D33,Break & Enter-Other,2017,0,2,0,2
D33,Break & Enter-Other,2017,0,1,0,1
D32,Other,2017,33,39,0,6
D32,Theft Over $5000,2017,0,4,0,4
D33,Break & Enter-Other,2017,2,2,1,0
D33,Fraud,2017,17,90,0,73
D33,Fraud,2017,20,81,0,61
D32,Theft Over $5000,2017,0,6,0,6
D33,Theft Over $5000,2017,0,1,0,1
D32,Other,2017,11,11,1,0
D33,Fraud,2017,1,27,0,26
D32,Theft Over $5000,2017,0,6,0,6
D32,Other,2017,35,39,0,4
D32,Break & Enter-Other,2017,0,1,0,1
D33,Auto Theft,2017,1,17,0,16
D32,Robbery-Other,2017,8,21,0,13
D33,Theft Under $5000,2017,96,343,0,247
D33,Fraud,2017,0,2,0,2
D32,Theft Over $5000,2017,2,11,0,9
D32,Other,2017,11,12,0,1
D32,Break & Enter-Other,2017,0,1,0,1
D33,Auto Theft,2017,3,21,0,18
D32,Robbery-Other,2017,3,14,0,11
D33,Theft Under $5000,2017,157,385,0,228
D33,Fraud,2017,0,1,0,1
D32,Theft Over $5000,2017,0,6,0,6
D32,Other,2017,2,2,1,0
D32,Break & Enter-Other,2017,0,2,0,2
D33,Auto Theft,2017,1,21,0,20
D32,Robbery-Other,2017,1,6,0,5
D32,Assault,2017,20,42,0,22
D33,Theft Under $5000,2017,11,56,0,45
D33,Fraud,2017,13,79,0,66
D32,Theft Over $5000,2017,0,1,0,1
D32,Other,2017,17,19,0,2
D32,Break & Enter-Other,2017,2,2,1,0
D33,Auto Theft,2017,4,29,0,25
D32,Robbery-Other,2017,10,20,0,10
D32,Assault,2017,60,103,0,43
D33,Theft Under $5000,2017,0,1,0,1
D33,Fraud,2017,7,44,0,37
D32,Theft Over $5000,2017,1,9,0,8
D32,Other,2017,52,61,0,9
D32,Break & Enter-Other,2017,0,1,0,1
D33,Auto Theft,2017,3,29,0,26
D32,Sexual Violation,2017,2,5,0,3
D32,Attempt Murder,2017,0,1,0,1
D33,Theft Under $5000,2017,416,619,0,203
D33,Fraud,2017,3,48,0,45
D33,Fraud,2017,5,39,0,34
D33,Fraud,2017,0,5,0,5
D33,Fraud,2017,9,38,0,29
D33,Fraud,2017,6,30,0,24
D33,Fraud,2017,3,25,0,22
D33,Fraud,2017,2,24,0,22
D33,Fraud,2017,1,2,0,1
D33,Other,2017,17,57,0,40
D33,Other,2017,14,50,0,36
D33,Other,2017,6,24,0,18
D33,Other,2017,0,1,0,1
D33,Other,2017,1,1,1,0
D33,Other,2017,25,91,0,66
D33,Other,2017,34,78,0,44
D33,Other,2017,17,36,0,19
D33,Other,2017,12,34,0,22
D33,Other,2017,0,1,0,1
D33,Other,2017,1,4,0,3
D33,Other,2017,7,49,0,42
D33,Other,2017,11,46,0,35
D33,Other,2017,11,27,0,16
D33,Other,2017,0,1,0,1
D33,Other,2017,13,31,0,18
D33,Other,2017,1,6,0,5
D33,Theft Over $5000,2017,3,5,0,2
D33,Theft Over $5000,2017,2,7,0,5
D33,Theft Over $5000,2017,0,3,0,3
D33,Theft Over $5000,2017,1,1,1,0
D33,Theft Over $5000,2017,0,10,0,10
D33,Theft Over $5000,2017,2,5,0,3
D33,Theft Over $5000,2017,1,9,0,8
D33,Theft Over $5000,2017,0,4,0,4
D33,Theft Over $5000,2017,1,1,1,0
D33,Theft Over $5000,2017,0,5,0,5
D33,Theft Over $5000,2017,0,5,0,5
D33,Theft Over $5000,2017,1,7,0,6
D32,Sexual Violation,2017,2,6,0,4
D33,Theft Under $5000,2017,17,106,0,89
D32,Other,2017,6,9,0,3
D33,Auto Theft,2017,6,15,0,9
D32,Theft Over $5000,2017,3,17,0,14
D32,Attempt Murder,2017,0,3,0,3
D32,Break & Enter-Other,2017,0,1,0,1
D32,Sexual Violation,2017,5,8,0,3
D33,Theft Under $5000,2017,11,81,0,70
D32,Other,2017,32,35,0,3
D33,Auto Theft,2017,0,18,0,18
D33,Auto Theft,2017,2,17,0,15
D33,Auto Theft,2017,0,17,0,17
D33,Auto Theft,2017,0,9,0,9
D33,Auto Theft,2017,3,12,0,9
D33,Break & Enter-Apartment,2017,6,18,0,12
D33,Break & Enter-Apartment,2017,1,5,0,4
D33,Break & Enter-Apartment,2017,1,6,0,5
D33,Break & Enter-Apartment,2017,0,2,0,2
D33,Break & Enter-Apartment,2017,2,8,0,6
D33,Break & Enter-Apartment,2017,5,20,0,15
D33,Break & Enter-Apartment,2017,3,11,0,8
D33,Break & Enter-Apartment,2017,1,5,0,4
D33,Break & Enter-Apartment,2017,2,6,0,4
D33,Break & Enter-Apartment,2017,0,1,0,1
D33,Break & Enter-Apartment,2017,2,3,0,1
D33,Break & Enter-Apartment,2017,2,6,0,4
D33,Break & Enter-Commercial,2017,3,8,0,5
D33,Break & Enter-Commercial,2017,0,10,0,10
D33,Break & Enter-Commercial,2017,0,2,0,2
D33,Break & Enter-Commercial,2017,0,1,0,1
D33,Break & Enter-Commercial,2017,0,3,0,3
D33,Break & Enter-Commercial,2017,0,13,0,13
D33,Break & Enter-Commercial,2017,0,9,0,9
D33,Break & Enter-Commercial,2017,1,6,0,5
D33,Break & Enter-Commercial,2017,0,1,0,1
D33,Break & Enter-Commercial,2017,1,7,0,6
D33,Break & Enter-Commercial,2017,0,3,0,3
D33,Break & Enter-House,2017,3,37,0,34
D33,Break & Enter-House,2017,0,24,0,24
D33,Break & Enter-House,2017,4,30,0,26
D33,Break & Enter-House,2017,1,9,0,8
D33,Break & Enter-House,2017,2,21,0,19
D33,Break & Enter-House,2017,0,9,0,9
D33,Break & Enter-House,2017,2,3,0,1
D33,Break & Enter-House,2017,1,15,0,14
D33,Break & Enter-House,2017,4,22,0,18
D33,Break & Enter-House,2017,0,7,0,7
D33,Break & Enter-House,2017,14,36,0,22
D33,Break & Enter-House,2017,0,5,0,5
D33,Break & Enter-Other,2017,1,2,0,1
D33,Break & Enter-Other,2017,0,1,0,1
D33,Break & Enter-Other,2017,0,1,0,1
D33,Break & Enter-Other,2017,1,2,0,1
D32,Theft Over $5000,2017,1,4,0,3
D32,Sexual Violation,2017,1,3,0,2
D32,Sexual Violation,2017,4,6,0,2
D32,Theft Over $5000,2017,0,4,0,4
D33,Theft Under $5000,2017,43,117,0,74
D32,Other,2017,45,55,0,10
D32,Sexual Violation,2017,3,3,1,0
D32,Fraud,2017,2,32,0,30
D32,Theft Over $5000,2017,1,7,0,6
D32,Other,2017,5,5,1,0
D32,Sexual Violation,2017,2,7,0,5
D32,Fraud,2017,2,26,0,24
D32,Theft Over $5000,2017,2,14,0,12
D32,Other,2017,32,35,0,3
D32,Sexual Violation,2017,3,5,0,2
D32,Fraud,2017,0,1,0,1
D32,Theft Over $5000,2017,7,17,0,10
D33,Theft Under $5000,2017,1,6,0,5
D32,Other,2017,207,216,0,9
D32,Sexual Violation,2017,8,13,0,5
D32,Fraud,2017,3,42,0,39
D32,Theft Under $5000,2017,22,103,0,81
D33,Theft Under $5000,2017,10,85,0,75
D32,Other,2017,120,135,0,15
D32,Sexual Violation,2017,3,5,0,2
D32,Fraud,2017,0,10,0,10
D32,Theft Under $5000,2017,16,82,0,66
D33,Theft Under $5000,2017,27,90,0,63
D32,Other Criminal Violations - Offensive Weapons,2017,1,2,0,1
D32,Sexual Violation,2017,0,1,0,1
D32,Fraud,2017,24,100,0,76
D32,Theft Under $5000,2017,12,166,0,154
D33,Theft Under $5000,2017,28,112,0,84
D32,Other Criminal Violations - Offensive Weapons,2017,1,1,1,0
D32,Sexual Violation,2017,8,12,0,4
D32,Fraud,2017,1,11,0,10
D32,Theft Under $5000,2017,2,28,0,26
D33,Theft Under $5000,2017,0,1,0,1
D32,Other Criminal Violations - Offensive Weapons,2017,5,6,0,1
D32,Sexual Violation,2017,7,19,0,12
D32,Fraud,2017,7,50,0,43
D32,Theft Under $5000,2017,88,298,0,210
D33,Theft Under $5000,2017,1,2,0,1
D32,Other Criminal Violations - Offensive Weapons,2017,0,1,0,1
D32,Sexual Violation,2017,4,5,0,1
D32,Fraud,2017,1,34,0,33
D32,Fraud,2017,5,43,0,38
D32,Fraud,2017,1,20,0,19
D32,Fraud,2017,1,5,0,4
D32,Fraud,2017,2,45,0,43
D32,Fraud,2017,5,73,0,68
D32,Fraud,2017,1,14,0,13
D32,Fraud,2017,2,48,0,46
D32,Fraud,2017,14,70,0,56
D32,Fraud,2017,10,69,0,59
D32,Fraud,2017,2,59,0,57
D32,Fraud,2017,58,139,0,81
D32,Other,2017,10,21,0,11
D32,Other,2017,15,52,0,37
D32,Other,2017,6,46,0,40
D32,Other,2017,3,8,0,5
D32,Other,2017,12,63,0,51
D32,Other,2017,13,35,0,22
D32,Other,2017,9,54,0,45
D32,Other,2017,11,40,0,29
D32,Other,2017,20,57,0,37
D32,Other,2017,3,24,0,21
D32,Other,2017,4,9,0,5
D32,Other,2017,20,47,0,27
D32,Other,2017,23,97,0,74
D32,Other,2017,8,18,0,10
D32,Other,2017,22,51,0,29
D32,Other,2017,18,56,0,38
D32,Other,2017,16,41,0,25
D32,Other,2017,15,34,0,19
D32,Other,2017,342,394,0,52
D32,Theft Over $5000,2017,0,5,0,5
D32,Theft Over $5000,2017,0,5,0,5
D32,Theft Over $5000,2017,1,11,0,10
D32,Theft Over $5000,2017,0,1,0,1
D32,Theft Over $5000,2017,0,5,0,5
D32,Theft Under $5000,2017,4,42,0,38
D32,Sexual Violation,2017,5,9,0,4
D32,Theft Under $5000,2017,3,65,0,62
D32,Sexual Violation,2017,8,10,0,2
D32,Theft Under $5000,2017,33,110,0,77
D32,Sexual Violation,2017,2,7,0,5
D32,Theft Under $5000,2017,30,181,0,151
D33,Theft Under $5000,2017,25,91,0,66
D32,Other Criminal Violations - Offensive Weapons,2017,4,4,1,0
D32,Sexual Violation,2017,1,4,0,3
D32,Theft Under $5000,2017,2,83,0,81
D33,Theft Under $5000,2017,0,3,0,3
D33,Assault,2017,75,94,0,19
D33,Assault,2017,36,56,0,20
D33,Assault,2017,21,26,0,5
D33,Assault,2017,3,4,0,1
D33,Assault,2017,2,2,1,0
D33,Assault,2017,90,119,0,29
D33,Assault,2017,1,1,1,0
D33,Assault,2017,53,87,0,34
D33,Assault,2017,2,4,0,2
D33,Assault,2017,40,64,0,24
D33,Assault,2017,31,49,0,18
D33,Assault,2017,6,7,0,1
D33,Assault,2017,2,3,0,1
D33,Assault,2017,31,50,0,19
D33,Assault,2017,36,42,0,6
D33,Assault,2017,14,24,0,10
D33,Assault,2017,2,2,1,0
D33,Assault,2017,26,32,0,6
D33,Assault,2017,1,8,0,7
D33,Assault,2017,0,1,0,1
D33,Attempt Murder,2017,3,3,1,0
D33,Attempt Murder,2017,4,4,1,0
D33,Other,2017,27,37,0,10
D33,Other,2017,21,33,0,12
D33,Other,2017,5,9,0,4
D33,Other,2017,1,2,0,1
D33,Other,2017,20,32,0,12
D33,Other,2017,28,39,0,11
D33,Other,2017,15,23,0,8
D33,Other,2017,12,15,0,3
D33,Other,2017,1,1,1,0
D33,Other,2017,2,2,1,0
D33,Other,2017,13,16,0,3
D32,Sexual Violation,2017,10,16,0,6
D32,Other,2017,4,4,1,0
D32,Other,2017,6,7,0,1
D32,Other,2017,1,1,1,0
D32,Other,2017,5,5,1,0
D32,Other Criminal Violations - Offensive Weapons,2017,4,4,1,0
D32,Other,2017,2,2,1,0
D32,Other Criminal Violations - Offensive Weapons,2017,3,3,1,0
D32,Theft Under $5000,2017,1,14,0,13
D32,Other,2017,5,5,1,0
D32,Other Criminal Violations - Offensive Weapons,2017,2,2,1,0
D32,Theft Under $5000,2017,12,80,0,68
D32,Theft Under $5000,2017,67,237,0,170
D32,Theft Under $5000,2017,4,62,0,58
D32,Theft Under $5000,2017,0,1,0,1
D32,Theft Under $5000,2017,15,110,0,95
D32,Theft Under $5000,2017,9,128,0,119
D32,Theft Under $5000,2017,79,194,0,115
D32,Theft Under $5000,2017,129,418,0,289
D32,Theft Under $5000,2017,694,1047,0,353
D32,Assault,2017,38,47,0,9
D32,Assault,2017,32,44,0,12
D32,Assault,2017,24,38,0,14
D32,Assault,2017,2,6,0,4
D32,Assault,2017,33,57,0,24
D32,Assault,2017,23,39,0,16
D32,Assault,2017,23,36,0,13
D32,Assault,2017,58,78,0,20
D32,Assault,2017,43,74,0,31
D32,Assault,2017,18,33,0,15
D32,Assault,2017,3,9,0,6
D32,Assault,2017,52,76,0,24
D32,Assault,2017,68,109,0,41
D32,Assault,2017,14,20,0,6
D32,Assault,2017,51,89,0,38
D32,Assault,2017,46,67,0,21
D32,Assault,2017,50,76,0,26
D32,Other,2017,3,3,1,0
D32,Other,2017,10,10,1,0
D32,Other,2017,2,2,1,0
D32,Other,2017,2,2,1,0
D32,Other,2017,4,4,1,0
D32,Other,2017,2,2,1,0
D32,Other,2017,7,7,1,0
D32,Other,2017,8,8,1,0
D32,Other,2017,2,2,1,0
D32,Other,2017,2,2,1,0
D32,Other,2017,4,5,0,1
D32,Other,2017,9,9,1,0
D32,Other,2017,4,4,1,0
D32,Other,2017,7,9,0,2
D32,Other,2017,8,10,0,2
D32,Other,2017,17,24,0,7
D32,Other,2017,13,18,0,5
D32,Other,2017,3,6,0,3
D32,Other,2017,25,33,0,8
D32,Other,2017,13,13,1,0
D32,Other,2017,14,14,1,0
D32,Other Criminal Violations - Offensive Weapons,2017,10,10,1,0
D32,Other Criminal Violations - Offensive Weapons,2017,2,2,1,0
D32,Other Criminal Violations - Offensive Weapons,2017,5,6,0,1
D32,Other Criminal Violations - Offensive Weapons,2017,8,8,1,0
D32,Other Criminal Violations - Offensive Weapons,2017,6,6,1,0
D32,Other Criminal Violations - Offensive Weapons,2017,8,8,1,0
D32,Other Criminal Violations - Offensive Weapons,2017,6,6,1,0
D32,Other Criminal Violations - Offensive Weapons,2017,0,1,0,1
D32,Other Criminal Violations - Offensive Weapons,2017,13,15,0,2
D32,Other,2017,1,1,1,0
D32,Other,2017,1,1,1,0
D32,Other,2017,1,1,1,0
D32,Other,2017,1,1,1,0
D32,Other,2017,1,1,1,0
D32,Other,2017,3,3,1,0
D32,Other,2017,1,1,1,0
D32,Other,2017,4,4,1,0
D33,Other,2017,5,8,0,3
D33,Other,2017,3,3,1,0
D33,Other,2017,10,12,0,2
D33,Other,2017,6,7,0,1
D33,Other,2017,7,7,1,0
D33,Other,2017,3,3,1,0
D33,Other,2017,2,2,1,0
D33,Other,2017,1,1,1,0
D33,Other,2017,3,4,0,1
D33,Other,2017,4,4,1,0
D33,Other,2017,7,7,1,0
D32,Attempt Murder,2017,1,1,1,0
D32,Other,2017,10,13,0,3
D32,Other,2017,11,19,0,8
D32,Other,2017,0,1,0,1
D32,Other,2017,9,15,0,6
D32,Other,2017,8,10,0,2
D32,Other,2017,20,24,0,4
D32,Other,2017,6,11,0,5
D32,Other,2017,13,20,0,7
D32,Other,2017,16,21,0,5
D32,Other,2017,10,19,0,9
D32,Other,2017,8,12,0,4
D32,Other,2017,1,6,0,5
D32,Other,2017,11,14,0,3
D32,Other,2017,20,39,0,19
D32,Other,2017,2,8,0,6
D32,Other,2017,0,1,0,1
D32,Other,2017,18,32,0,14
D32,Other,2017,21,32,0,11
D32,Other,2017,12,15,0,3
D32,Other,2017,11,21,0,10
D32,Other,2017,21,31,0,10
D32,Robbery-Financial,2017,2,2,1,0
D32,Robbery-Financial,2017,0,3,0,3
D32,Robbery-Financial,2017,1,1,1,0
D32,Robbery-Financial,2017,0,1,0,1
D32,Robbery-Financial,2017,0,1,0,1
D32,Robbery-Financial,2017,1,1,1,0
D32,Robbery-Financial,2017,2,2,1,0
D32,Robbery-Financial,2017,2,2,1,0
D32,Robbery-Other,2017,4,10,0,6
D32,Robbery-Other,2017,7,13,0,6
D32,Robbery-Other,2017,1,1,1,0
D32,Robbery-Other,2017,1,14,0,13
D32,Robbery-Other,2017,0,1,0,1
D32,Robbery-Other,2017,4,10,0,6
D32,Robbery-Other,2017,1,2,0,1
D32,Robbery-Other,2017,7,29,0,22
D32,Robbery-Other,2017,6,19,0,13
D32,Robbery-Other,2017,4,14,0,10
D32,Robbery-Other,2017,0,5,0,5
D32,Robbery-Other,2017,2,6,0,4
D32,Robbery-Other,2017,4,19,0,15
D32,Robbery-Other,2017,14,39,0,25
D32,Robbery-Other,2017,0,1,0,1
D32,Robbery-Other,2017,5,13,0,8
D41,Other,2017,1,1,1,0
D41,Other,2017,38,39,0,1
D41,Other,2017,33,34,0,1
D41,Auto Theft,2017,0,10,0,10
D41,Auto Theft,2017,0,5,0,5
D41,Auto Theft,2017,3,15,0,12
D41,Auto Theft,2017,8,40,0,32
D41,Auto Theft,2017,0,6,0,6
D41,Auto Theft,2017,7,42,0,35
D41,Auto Theft,2017,3,10,0,7
D41,Auto Theft,2017,0,5,0,5
D41,Auto Theft,2017,6,33,0,27
D41,Auto Theft,2017,1,3,0,2
D41,Auto Theft,2017,1,11,0,10
D41,Auto Theft,2017,8,72,0,64
D41,Theft Under $5000,2017,12,56,0,44
D41,Break & Enter-Apartment,2017,2,5,0,3
D41,Break & Enter-Apartment,2017,4,18,0,14
D41,Break & Enter-Apartment,2017,2,16,0,14
D41,Break & Enter-Apartment,2017,2,4,0,2
D41,Break & Enter-Apartment,2017,5,28,0,23
D41,Break & Enter-Apartment,2017,0,7,0,7
D41,Break & Enter-Apartment,2017,5,18,0,13
D41,Break & Enter-Apartment,2017,6,20,0,14
D41,Break & Enter-Apartment,2017,3,23,0,20
D41,Break & Enter-Apartment,2017,1,6,0,5
D41,Break & Enter-Commercial,2017,2,5,0,3
D41,Break & Enter-Commercial,2017,3,7,0,4
D41,Break & Enter-Commercial,2017,7,17,0,10
D41,Break & Enter-Commercial,2017,14,60,0,46
D41,Break & Enter-Commercial,2017,0,1,0,1
D41,Break & Enter-Commercial,2017,13,44,0,31
D41,Break & Enter-Commercial,2017,2,8,0,6
D41,Break & Enter-Commercial,2017,0,4,0,4
D41,Break & Enter-Commercial,2017,6,14,0,8
D41,Break & Enter-Commercial,2017,1,3,0,2
D41,Break & Enter-Commercial,2017,7,19,0,12
D41,Break & Enter-Commercial,2017,10,45,0,35
D41,Break & Enter-House,2017,1,6,0,5
D41,Break & Enter-House,2017,0,1,0,1
D41,Break & Enter-House,2017,11,45,0,34
D41,Break & Enter-House,2017,5,17,0,12
D41,Break & Enter-House,2017,2,7,0,5
D41,Break & Enter-House,2017,3,12,0,9
D41,Break & Enter-House,2017,1,1,1,0
D41,Break & Enter-House,2017,1,5,0,4
D41,Break & Enter-House,2017,2,12,0,10
D41,Break & Enter-House,2017,9,25,0,16
D41,Break & Enter-House,2017,4,28,0,24
D41,Break & Enter-Other,2017,1,2,0,1
D41,Break & Enter-Other,2017,1,3,0,2
D41,Sexual Violation,2017,10,16,0,6
D41,Break & Enter-Other,2017,2,9,0,7
D42,Break & Enter-House,2017,2,40,0,38
D33,Other,2017,49,55,0,6
D42,Other,2017,6,6,1,0
D41,Theft Under $5000,2017,32,79,0,47
D41,Sexual Violation,2017,11,21,0,10
D41,Break & Enter-Other,2017,0,2,0,2
D42,Break & Enter-House,2017,1,22,0,21
D33,Other,2017,32,37,0,5
D42,Other,2017,18,20,0,2
D41,Theft Under $5000,2017,84,285,0,201
D41,Sexual Violation,2017,3,5,0,2
D41,Sexual Violation,2017,15,19,0,4
D41,Sexual Violation,2017,2,4,0,2
D41,Sexual Violation,2017,9,18,0,9
D41,Sexual Violation,2017,10,18,0,8
D41,Sexual Violation,2017,3,3,1,0
D41,Sexual Violation,2017,7,9,0,2
D41,Sexual Violation,2017,21,28,0,7
D41,Other,2017,3,3,1,0
D41,Other,2017,4,4,1,0
D41,Other,2017,14,15,0,1
D41,Other,2017,21,22,0,1
D41,Other,2017,5,5,1,0
D41,Other,2017,24,25,0,1
D41,Other,2017,5,5,1,0
D41,Other,2017,5,5,1,0
D41,Other,2017,15,15,1,0
D41,Other,2017,0,1,0,1
D41,Other,2017,6,6,1,0
D41,Other,2017,17,19,0,2
D41,Other,2017,18,19,0,1
D41,Other,2017,35,37,0,2
D41,Other,2017,74,79,0,5
D41,Other,2017,309,325,0,16
D41,Other,2017,15,16,0,1
D41,Other,2017,241,325,0,84
D41,Other,2017,25,26,0,1
D41,Other,2017,83,89,0,6
D41,Other,2017,93,96,0,3
D41,Other,2017,23,25,0,2
D41,Other,2017,103,111,0,8
D41,Other,2017,112,122,0,10
D41,Other,2017,5,5,1,0
D41,Other Criminal Violations - Offensive Weapons,2017,9,9,1,0
D41,Other Criminal Violations - Offensive Weapons,2017,7,7,1,0
D41,Other Criminal Violations - Offensive Weapons,2017,11,12,0,1
D41,Other Criminal Violations - Offensive Weapons,2017,30,30,1,0
D41,Other Criminal Violations - Offensive Weapons,2017,6,6,1,0
D41,Other Criminal Violations - Offensive Weapons,2017,17,19,0,2
D41,Other Criminal Violations - Offensive Weapons,2017,11,13,0,2
D41,Other Criminal Violations - Offensive Weapons,2017,7,8,0,1
D41,Other Criminal Violations - Offensive Weapons,2017,16,18,0,2
D41,Other Criminal Violations - Offensive Weapons,2017,14,17,0,3
D41,Other Criminal Violations - Offensive Weapons,2017,16,17,0,1
D41,Other,2017,1,1,1,0
D41,Other,2017,1,2,0,1
D41,Other,2017,1,1,1,0
D41,Other,2017,2,2,1,0
D41,Break & Enter-Other,2017,0,4,0,4
D33,Other,2017,10,12,0,2
D41,Break & Enter-Other,2017,0,1,0,1
D42,Break & Enter-House,2017,0,28,0,28
D41,Theft Under $5000,2017,100,130,0,30
D42,Other,2017,5,6,0,1
D42,Other,2017,14,16,0,2
D42,Other,2017,17,19,0,2
D42,Other,2017,13,13,1,0
D42,Other,2017,10,10,1,0
D42,Other,2017,10,11,0,1
D33,Other,2017,2,2,1,0
D42,Other,2017,1,1,1,0
D33,Other,2017,4,4,1,0
D41,Break & Enter-Other,2017,1,2,0,1
D41,Theft Under $5000,2017,80,357,0,277
D42,Break & Enter-House,2017,1,24,0,23
D42,Other,2017,8,9,0,1
D33,Other,2017,45,52,0,7
D41,Break & Enter-Other,2017,3,4,0,1
D41,Theft Under $5000,2017,201,678,0,477
D42,Break & Enter-House,2017,2,23,0,21
D42,Other,2017,5,5,1,0
D33,Other,2017,38,42,0,4
D41,Break & Enter-Other,2017,2,2,1,0
D41,Assault,2017,35,44,0,9
D42,Break & Enter-Other,2017,0,1,0,1
D42,Other,2017,1,1,1,0
D33,Other,2017,3,5,0,2
D41,Break & Enter-Other,2017,3,8,0,5
D41,Assault,2017,39,57,0,18
D42,Break & Enter-Other,2017,0,2,0,2
D42,Auto Theft,2017,3,33,0,30
D33,Other,2017,16,20,0,4
D41,Fraud,2017,0,9,0,9
D41,Assault,2017,94,143,0,49
D42,Break & Enter-Other,2017,1,1,1,0
D42,Auto Theft,2017,4,36,0,32
D33,Other,2017,10,11,0,1
D41,Fraud,2017,6,25,0,19
D41,Assault,2017,160,224,0,64
D42,Break & Enter-Other,2017,0,2,0,2
D42,Auto Theft,2017,0,13,0,13
D33,Other,2017,1,1,1,0
D41,Fraud,2017,6,50,0,44
D41,Assault,2017,17,26,0,9
D41,Assault,2017,115,171,0,56
D41,Assault,2017,51,63,0,12
D41,Assault,2017,60,77,0,17
D41,Assault,2017,120,172,0,52
D41,Assault,2017,8,15,0,7
D41,Assault,2017,94,141,0,47
D41,Assault,2017,130,170,0,40
D41,Attempt Murder,2017,1,1,1,0
D41,Attempt Murder,2017,2,3,0,1
D41,Attempt Murder,2017,0,1,0,1
D41,Attempt Murder,2017,1,1,1,0
D41,Other,2017,6,11,0,5
D41,Other,2017,12,15,0,3
D41,Other,2017,17,26,0,9
D41,Other,2017,33,55,0,22
D41,Other,2017,8,9,0,1
D41,Other,2017,21,37,0,16
D41,Other,2017,8,13,0,5
D41,Other,2017,26,31,0,5
D41,Other,2017,23,36,0,13
D41,Other,2017,2,5,0,3
D41,Other,2017,28,41,0,13
D41,Other,2017,33,54,0,21
D41,Robbery-Financial,2017,1,2,0,1
D41,Robbery-Financial,2017,3,3,1,0
D41,Robbery-Other,2017,4,6,0,2
D41,Robbery-Other,2017,6,19,0,13
D41,Robbery-Other,2017,5,9,0,4
D41,Robbery-Other,2017,15,43,0,28
D41,Robbery-Other,2017,6,14,0,8
D41,Robbery-Other,2017,15,29,0,14
D41,Robbery-Other,2017,9,16,0,7
D41,Robbery-Other,2017,5,11,0,6
D41,Robbery-Other,2017,25,48,0,23
D41,Robbery-Other,2017,1,5,0,4
D41,Robbery-Other,2017,19,32,0,13
D41,Robbery-Other,2017,11,28,0,17
D41,Sexual Violation,2017,7,10,0,3
D41,Sexual Violation,2017,5,7,0,2
D33,Other,2017,3,3,1,0
D41,Fraud,2017,16,83,0,67
D33,Other,2017,21,25,0,4
D42,Break & Enter-Other,2017,0,1,0,1
D41,Fraud,2017,1,8,0,7
D33,Other,2017,21,22,0,1
D42,Auto Theft,2017,1,1,1,0
D42,Break & Enter-Other,2017,0,2,0,2
D41,Fraud,2017,13,73,0,60
D42,Auto Theft,2017,2,16,0,14
D42,Break & Enter-Other,2017,0,1,0,1
D33,Other,2017,21,21,1,0
D42,Break & Enter-Other,2017,0,1,0,1
D41,Fraud,2017,2,17,0,15
D33,Other,2017,1,1,1,0
D42,Fraud,2017,8,64,0,56
D41,Fraud,2017,8,36,0,28
D33,Other,2017,16,18,0,2
D42,Fraud,2017,17,84,0,67
D41,Fraud,2017,11,49,0,38
D42,Auto Theft,2017,2,27,0,25
D33,Other,2017,5,6,0,1
D42,Fraud,2017,0,1,0,1
D41,Fraud,2017,5,15,0,10
D42,Auto Theft,2017,2,31,0,29
D33,Other,2017,1,1,1,0
D42,Fraud,2017,10,42,0,32
D41,Fraud,2017,5,35,0,30
D42,Auto Theft,2017,3,61,0,58
D33,Other,2017,12,12,1,0
D42,Fraud,2017,6,43,0,37
D41,Fraud,2017,0,1,0,1
D33,Other Criminal Violations - Offensive Weapons,2017,11,11,1,0
D42,Fraud,2017,6,65,0,59
D41,Fraud,2017,35,119,0,84
D42,Auto Theft,2017,0,25,0,25
D33,Other Criminal Violations - Offensive Weapons,2017,1,1,1,0
D41,Other,2017,6,15,0,9
D42,Auto Theft,2017,1,32,0,31
D33,Other Criminal Violations - Offensive Weapons,2017,1,1,1,0
D41,Other,2017,16,26,0,10
D42,Fraud,2017,10,54,0,44
D42,Auto Theft,2017,1,18,0,17
D33,Other Criminal Violations - Offensive Weapons,2017,11,12,0,1
D41,Other,2017,41,114,0,73
D42,Fraud,2017,5,64,0,59
D42,Auto Theft,2017,0,8,0,8
D33,Other Criminal Violations - Offensive Weapons,2017,10,10,1,0
D41,Other,2017,71,161,0,90
D42,Fraud,2017,7,47,0,40
D42,Break & Enter-Apartment,2017,0,2,0,2
D33,Other Criminal Violations - Offensive Weapons,2017,3,4,0,1
D41,Other,2017,9,30,0,21
D42,Fraud,2017,2,6,0,4
D42,Break & Enter-Apartment,2017,0,4,0,4
D33,Other Criminal Violations - Offensive Weapons,2017,7,8,0,1
D41,Other,2017,38,116,0,78
D42,Fraud,2017,5,41,0,36
D42,Break & Enter-Apartment,2017,0,3,0,3
D33,Other Criminal Violations - Offensive Weapons,2017,2,2,1,0
D41,Other,2017,13,28,0,15
D42,Fraud,2017,6,62,0,56
D42,Break & Enter-Apartment,2017,0,3,0,3
D33,Other Criminal Violations - Offensive Weapons,2017,5,6,0,1
D41,Other,2017,19,49,0,30
D42,Fraud,2017,2,23,0,21
D42,Break & Enter-Apartment,2017,0,7,0,7
D33,Other Criminal Violations - Offensive Weapons,2017,2,3,0,1
D41,Other,2017,39,121,0,82
D42,Other,2017,20,74,0,54
D42,Break & Enter-Apartment,2017,0,5,0,5
D33,Other Criminal Violations - Offensive Weapons,2017,2,2,1,0
D41,Other,2017,10,18,0,8
D42,Other,2017,24,91,0,67
D42,Break & Enter-Apartment,2017,1,8,0,7
D33,Other Criminal Violations - Offensive Weapons,2017,2,3,0,1
D33,Other Criminal Violations - Offensive Weapons,2017,2,4,0,2
D33,Other,2017,0,1,0,1
D33,Other,2017,1,1,1,0
D33,Other,2017,0,1,0,1
D33,Other,2017,1,1,1,0
D33,Other,2017,1,1,1,0
D33,Other,2017,2,2,1,0
D33,Other,2017,1,1,1,0
D33,Other,2017,1,1,1,0
D41,Other,2017,4,4,1,0
D41,Other,2017,7,7,1,0
D41,Other,2017,18,18,1,0
D41,Other,2017,40,40,1,0
D41,Other,2017,5,5,1,0
D41,Other,2017,39,43,0,4
D41,Other,2017,7,9,0,2
D41,Other,2017,11,14,0,3
D41,Other,2017,13,14,0,1
D42,Other,2017,19,65,0,46
D42,Other,2017,0,1,0,1
D42,Other,2017,17,64,0,47
D42,Other,2017,31,91,0,60
D42,Other,2017,20,66,0,46
D42,Other,2017,13,81,0,68
D41,Other,2017,41,123,0,82
D42,Other,2017,13,86,0,73
D41,Other,2017,55,157,0,102
D42,Other,2017,3,8,0,5
D41,Theft Over $5000,2017,0,2,0,2
D42,Other,2017,14,55,0,41
D41,Theft Over $5000,2017,1,5,0,4
D42,Other,2017,12,61,0,49
D41,Theft Over $5000,2017,1,5,0,4
D42,Other,2017,17,52,0,35
D41,Theft Over $5000,2017,3,7,0,4
D42,Theft Over $5000,2017,0,11,0,11
D41,Theft Over $5000,2017,0,1,0,1
D42,Theft Over $5000,2017,1,14,0,13
D41,Theft Over $5000,2017,1,4,0,3
D42,Theft Over $5000,2017,0,1,0,1
D41,Theft Over $5000,2017,0,1,0,1
D42,Theft Over $5000,2017,1,3,0,2
D41,Theft Over $5000,2017,0,4,0,4
D42,Theft Over $5000,2017,0,3,0,3
D41,Theft Over $5000,2017,1,3,0,2
D42,Theft Over $5000,2017,2,3,0,1
D41,Theft Over $5000,2017,0,1,0,1
D42,Break & Enter-Apartment,2017,0,3,0,3
D42,Theft Over $5000,2017,1,4,0,3
D41,Theft Over $5000,2017,3,11,0,8
D42,Theft Over $5000,2017,2,19,0,17
D42,Break & Enter-Commercial,2017,1,11,0,10
D41,Theft Under $5000,2017,4,26,0,22
D42,Theft Over $5000,2017,1,7,0,6
D42,Break & Enter-Commercial,2017,0,55,0,55
D41,Theft Under $5000,2017,45,106,0,61
D42,Theft Over $5000,2017,1,6,0,5
D42,Break & Enter-Commercial,2017,0,3,0,3
D41,Theft Under $5000,2017,53,171,0,118
D42,Theft Over $5000,2017,1,8,0,7
D42,Break & Enter-Commercial,2017,2,11,0,9
D41,Theft Under $5000,2017,113,375,0,262
D42,Break & Enter-Commercial,2017,0,4,0,4
D41,Theft Under $5000,2017,1,35,0,34
D42,Break & Enter-Commercial,2017,0,4,0,4
D41,Theft Under $5000,2017,58,291,0,233
D42,Break & Enter-Commercial,2017,5,64,0,59
D42,Break & Enter-Commercial,2017,0,8,0,8
D42,Break & Enter-Commercial,2017,0,1,0,1
D42,Break & Enter-Commercial,2017,1,8,0,7
D42,Break & Enter-Commercial,2017,4,21,0,17
D42,Break & Enter-Commercial,2017,2,4,0,2
D42,Break & Enter-House,2017,3,35,0,32
D42,Break & Enter-House,2017,1,31,0,30
D42,Break & Enter-House,2017,3,30,0,27
D42,Break & Enter-House,2017,2,26,0,24
D42,Break & Enter-House,2017,4,15,0,11
D42,Break & Enter-House,2017,1,8,0,7
D33,Other,2017,2,11,0,9
D33,Other,2017,3,9,0,6
D33,Other,2017,7,9,0,2
D33,Other,2017,0,2,0,2
D33,Robbery-Financial,2017,1,1,1,0
D33,Robbery-Financial,2017,1,1,1,0
D33,Robbery-Other,2017,4,9,0,5
D33,Robbery-Other,2017,2,6,0,4
D33,Robbery-Other,2017,2,4,0,2
D33,Robbery-Other,2017,6,17,0,11
D33,Robbery-Other,2017,13,25,0,12
D33,Robbery-Other,2017,9,12,0,3
D33,Robbery-Other,2017,8,24,0,16
D33,Robbery-Other,2017,1,1,1,0
D33,Robbery-Other,2017,6,18,0,12
D33,Robbery-Other,2017,0,5,0,5
D33,Robbery-Other,2017,3,7,0,4
D33,Robbery-Other,2017,0,1,0,1
D33,Sexual Violation,2017,8,13,0,5
D33,Sexual Violation,2017,8,11,0,3
D33,Sexual Violation,2017,2,6,0,4
D33,Sexual Violation,2017,0,1,0,1
D33,Sexual Violation,2017,6,10,0,4
D33,Sexual Violation,2017,7,11,0,4
D33,Sexual Violation,2017,4,10,0,6
D33,Sexual Violation,2017,10,13,0,3
D33,Sexual Violation,2017,3,3,1,0
D33,Sexual Violation,2017,5,6,0,1
D33,Sexual Violation,2017,0,3,0,3
D33,Sexual Violation,2017,2,3,0,1
D33,Sexual Violation,2017,1,2,0,1
D33,Sexual Violation,2017,1,2,0,1
D33,Other,2017,13,17,0,4
D33,Other,2017,9,9,1,0
D33,Other,2017,4,4,1,0
D33,Other,2017,1,1,1,0
D33,Other,2017,1,1,1,0
D33,Other,2017,8,8,1,0
D33,Other,2017,5,5,1,0
D33,Other,2017,5,5,1,0
D33,Other,2017,3,3,1,0
D33,Other,2017,4,4,1,0
D33,Other,2017,1,1,1,0
D33,Other,2017,5,5,1,0
D33,Other,2017,9,9,1,0
D33,Other,2017,5,5,1,0
D33,Other,2017,3,3,1,0
D33,Other,2017,2,2,1,0
D33,Other,2017,5,5,1,0
D33,Other,2017,4,4,1,0
D42,Other Criminal Violations - Offensive Weapons,2017,11,11,1,0
D42,Other Criminal Violations - Offensive Weapons,2017,7,7,1,0
D42,Other Criminal Violations - Offensive Weapons,2017,11,12,0,1
D42,Other Criminal Violations - Offensive Weapons,2017,11,11,1,0
D42,Robbery-Other,2017,13,30,0,17
D43,Other Criminal Violations - Offensive Weapons,2017,7,7,1,0
D43,Assault,2017,56,88,0,32
D42,Theft Over $5000,2017,0,4,0,4
D42,Other Criminal Violations - Offensive Weapons,2017,6,7,0,1
D42,Other Criminal Violations - Offensive Weapons,2017,11,12,0,1
D42,Other Criminal Violations - Offensive Weapons,2017,2,2,1,0
D42,Other Criminal Violations - Offensive Weapons,2017,9,10,0,1
D42,Other Criminal Violations - Offensive Weapons,2017,2,2,1,0
D42,Other Criminal Violations - Offensive Weapons,2017,2,2,1,0
D42,Other,2017,0,1,0,1
D42,Other,2017,6,8,0,2
D42,Other,2017,3,3,1,0
D42,Other,2017,3,4,0,1
D42,Other,2017,3,3,1,0
D42,Other,2017,1,1,1,0
D42,Other,2017,1,1,1,0
D42,Other,2017,3,3,1,0
D43,Other,2017,2,2,1,0
D43,Other,2017,32,36,0,4
D43,Other,2017,7,7,1,0
D43,Other,2017,19,19,1,0
D43,Other,2017,25,27,0,2
D43,Other,2017,37,38,0,1
D43,Other,2017,4,4,1,0
D43,Other,2017,60,73,0,13
D43,Other,2017,7,7,1,0
D43,Other,2017,5,6,0,1
D43,Other,2017,41,42,0,1
D43,Fraud,2017,1,3,0,2
D43,Other,2017,0,1,0,1
D43,Other,2017,80,80,1,0
D43,Other,2017,4,4,1,0
D43,Other,2017,14,15,0,1
D43,Auto Theft,2017,0,4,0,4
D43,Auto Theft,2017,0,20,0,20
D43,Auto Theft,2017,2,9,0,7
D43,Auto Theft,2017,5,12,0,7
D43,Auto Theft,2017,3,19,0,16
D43,Auto Theft,2017,7,26,0,19
D43,Auto Theft,2017,0,5,0,5
D43,Auto Theft,2017,1,14,0,13
D43,Auto Theft,2017,1,12,0,11
D43,Auto Theft,2017,2,22,0,20
D43,Auto Theft,2017,9,32,0,23
D43,Auto Theft,2017,0,1,0,1
D43,Auto Theft,2017,0,22,0,22
D43,Break & Enter-Apartment,2017,1,4,0,3
D43,Break & Enter-Apartment,2017,2,18,0,16
D43,Break & Enter-Apartment,2017,2,2,1,0
D43,Break & Enter-Apartment,2017,1,2,0,1
D43,Break & Enter-Apartment,2017,3,11,0,8
D43,Sexual Violation,2017,2,4,0,2
D43,Sexual Violation,2017,2,6,0,4
D43,Fraud,2017,8,58,0,50
D43,Sexual Violation,2017,0,1,0,1
D42,Robbery-Other,2017,12,29,0,17
D43,Fraud,2017,28,129,0,101
D43,Break & Enter-Apartment,2017,1,2,0,1
D42,Theft Under $5000,2017,36,170,0,134
D43,Other Criminal Violations - Offensive Weapons,2017,10,13,0,3
D43,Fraud,2017,0,18,0,18
D43,Assault,2017,29,37,0,8
D42,Theft Under $5000,2017,66,249,0,183
D43,Break & Enter-Apartment,2017,0,1,0,1
D43,Other Criminal Violations - Offensive Weapons,2017,6,7,0,1
D43,Fraud,2017,18,85,0,67
D42,Robbery-Other,2017,6,24,0,18
D43,Assault,2017,1,1,1,0
D42,Theft Under $5000,2017,1,4,0,3
D43,Sexual Violation,2017,1,1,1,0
D43,Break & Enter-Apartment,2017,1,4,0,3
D43,Other Criminal Violations - Offensive Weapons,2017,32,33,0,1
D43,Other,2017,10,21,0,11
D42,Robbery-Other,2017,9,24,0,15
D43,Assault,2017,59,81,0,22
D42,Theft Under $5000,2017,6,59,0,53
D43,Sexual Violation,2017,4,5,0,1
D43,Break & Enter-Apartment,2017,4,7,0,3
D43,Other Criminal Violations - Offensive Weapons,2017,4,4,1,0
D43,Other,2017,39,67,0,28
D42,Robbery-Other,2017,0,5,0,5
D43,Assault,2017,69,102,0,33
D42,Theft Under $5000,2017,37,161,0,124
D43,Sexual Violation,2017,5,13,0,8
D43,Break & Enter-Apartment,2017,24,39,0,15
D43,Other Criminal Violations - Offensive Weapons,2017,5,5,1,0
D43,Other,2017,12,31,0,19
D42,Robbery-Other,2017,7,24,0,17
D43,Assault,2017,149,195,0,46
D42,Theft Under $5000,2017,58,190,0,132
D43,Sexual Violation,2017,13,21,0,8
D43,Break & Enter-Apartment,2017,3,7,0,4
D43,Other Criminal Violations - Offensive Weapons,2017,11,12,0,1
D43,Other,2017,22,46,0,24
D42,Robbery-Other,2017,2,9,0,7
D42,Theft Under $5000,2017,41,145,0,104
D43,Assault,2017,30,39,0,9
D42,Theft Under $5000,2017,75,248,0,173
D42,Sexual Violation,2017,8,11,0,3
D43,Other,2017,27,60,0,33
D42,Theft Under $5000,2017,23,182,0,159
D43,Assault,2017,48,62,0,14
D43,Break & Enter-Commercial,2017,1,8,0,7
D43,Other Criminal Violations - Offensive Weapons,2017,11,13,0,2
D43,Sexual Violation,2017,2,2,1,0
D43,Other Criminal Violations - Offensive Weapons,2017,38,41,0,3
D43,Break & Enter-Commercial,2017,2,7,0,5
D43,Assault,2017,99,149,0,50
D43,Other,2017,66,131,0,65
D42,Sexual Violation,2017,7,11,0,4
D43,Sexual Violation,2017,4,6,0,2
D42,Theft Under $5000,2017,1,4,0,3
D43,Other Criminal Violations - Offensive Weapons,2017,5,5,1,0
D43,Break & Enter-Commercial,2017,0,1,0,1
D43,Assault,2017,10,17,0,7
D43,Other,2017,9,30,0,21
D42,Sexual Violation,2017,7,13,0,6
D43,Sexual Violation,2017,13,23,0,10
D42,Theft Under $5000,2017,14,72,0,58
D43,Other Criminal Violations - Offensive Weapons,2017,6,8,0,2
D43,Break & Enter-Commercial,2017,1,6,0,5
D43,Assault,2017,90,129,0,39
D43,Other,2017,18,54,0,36
D42,Sexual Violation,2017,4,5,0,1
D43,Sexual Violation,2017,2,2,1,0
D42,Theft Under $5000,2017,116,356,0,240
D43,Other,2017,3,3,1,0
D43,Break & Enter-Commercial,2017,4,16,0,12
D43,Assault,2017,262,347,0,85
D43,Other,2017,23,76,0,53
D42,Sexual Violation,2017,12,25,0,13
D43,Sexual Violation,2017,6,8,0,2
D42,Theft Under $5000,2017,8,96,0,88
D43,Other,2017,1,1,1,0
D43,Break & Enter-Commercial,2017,2,8,0,6
D43,Assault,2017,9,19,0,10
D43,Other,2017,2,6,0,4
D42,Sexual Violation,2017,9,14,0,5
D43,Sexual Violation,2017,18,34,0,16
D43,Sexual Violation,2017,1,2,0,1
D43,Sexual Violation,2017,14,20,0,6
D43,Other,2017,3,3,1,0
D43,Other,2017,9,11,0,2
D43,Other,2017,5,5,1,0
D43,Other,2017,16,16,1,0
D43,Other,2017,11,12,0,1
D43,Other,2017,34,35,0,1
D43,Other,2017,5,6,0,1
D43,Other,2017,12,12,1,0
D43,Other,2017,13,13,1,0
D43,Other,2017,2,2,1,0
D43,Other,2017,16,17,0,1
D43,Other,2017,21,23,0,2
D43,Other,2017,4,4,1,0
D43,Other,2017,27,28,0,1
D43,Other,2017,1,1,1,0
D43,Other,2017,21,22,0,1
D43,Other,2017,68,79,0,11
D43,Other,2017,25,29,0,4
D43,Other,2017,105,119,0,14
D43,Other,2017,64,70,0,6
D43,Other,2017,68,74,0,6
D43,Other,2017,128,141,0,13
D43,Other,2017,19,22,0,3
D43,Other,2017,33,37,0,4
D43,Other,2017,50,52,0,2
D43,Other,2017,15,17,0,2
D43,Other,2017,1,1,1,0
D43,Other,2017,126,137,0,11
D43,Other,2017,371,393,0,22
D43,Other,2017,18,19,0,1
D43,Other,2017,82,90,0,8
D43,Other,2017,4,4,1,0
D43,Other,2017,1,1,1,0
D43,Other Criminal Violations - Offensive Weapons,2017,5,5,1,0
D43,Other Criminal Violations - Offensive Weapons,2017,12,12,1,0
D43,Other,2017,1,1,1,0
D42,Sexual Violation,2017,0,5,0,5
D43,Other,2017,36,81,0,45
D43,Assault,2017,110,157,0,47
D43,Break & Enter-Commercial,2017,0,2,0,2
D43,Other,2017,1,1,1,0
D42,Sexual Violation,2017,4,7,0,3
D43,Other,2017,128,258,0,130
D43,Other,2017,1,1,1,0
D43,Break & Enter-Commercial,2017,2,4,0,2
D43,Attempt Murder,2017,1,1,1,0
D42,Assault,2017,40,70,0,30
D42,Sexual Violation,2017,2,3,0,1
D43,Other,2017,12,28,0,16
D43,Break & Enter-Commercial,2017,0,2,0,2
D43,Attempt Murder,2017,3,4,0,1
D42,Assault,2017,67,98,0,31
D42,Sexual Violation,2017,6,13,0,7
D43,Other,2017,1,1,1,0
D43,Other,2017,35,108,0,73
D43,Break & Enter-Commercial,2017,0,11,0,11
D43,Attempt Murder,2017,1,1,1,0
D42,Assault,2017,1,1,1,0
D42,Sexual Violation,2017,7,15,0,8
D43,Other,2017,3,3,1,0
D43,Theft Over $5000,2017,1,2,0,1
D43,Break & Enter-Commercial,2017,9,21,0,12
D43,Attempt Murder,2017,2,2,1,0
D42,Assault,2017,51,75,0,24
D42,Sexual Violation,2017,3,9,0,6
D43,Other,2017,2,4,0,2
D43,Theft Over $5000,2017,4,13,0,9
D43,Break & Enter-Commercial,2017,0,2,0,2
D43,Attempt Murder,2017,1,1,1,0
D42,Assault,2017,36,80,0,44
D42,Other,2017,5,5,1,0
D43,Other,2017,2,3,0,1
D43,Theft Over $5000,2017,1,3,0,2
D43,Break & Enter-Commercial,2017,5,14,0,9
D43,Other,2017,6,7,0,1
D42,Assault,2017,125,152,0,27
D42,Other,2017,20,20,1,0
D43,Theft Over $5000,2017,2,6,0,4
D43,Break & Enter-House,2017,2,10,0,8
D51,Other,2017,34,35,0,1
D43,Other,2017,14,20,0,6
D42,Assault,2017,65,92,0,27
D42,Other,2017,1,1,1,0
D43,Theft Over $5000,2017,1,1,1,0
D43,Break & Enter-House,2017,2,4,0,2
D51,Other,2017,61,66,0,5
D43,Other,2017,18,26,0,8
D42,Assault,2017,40,68,0,28
D42,Other,2017,15,15,1,0
D43,Theft Over $5000,2017,4,10,0,6
D43,Break & Enter-House,2017,5,20,0,15
D43,Break & Enter-House,2017,2,13,0,11
D43,Break & Enter-House,2017,4,11,0,7
D43,Break & Enter-House,2017,5,22,0,17
D43,Break & Enter-House,2017,0,5,0,5
D43,Break & Enter-House,2017,4,24,0,20
D43,Break & Enter-House,2017,1,10,0,9
D43,Break & Enter-House,2017,3,14,0,11
D43,Break & Enter-House,2017,6,21,0,15
D43,Break & Enter-House,2017,1,7,0,6
D43,Break & Enter-House,2017,3,12,0,9
D43,Break & Enter-Other,2017,0,1,0,1
D43,Break & Enter-Other,2017,2,2,1,0
D43,Break & Enter-Other,2017,0,1,0,1
D43,Break & Enter-Other,2017,1,1,1,0
D43,Break & Enter-Other,2017,0,1,0,1
D43,Break & Enter-Other,2017,4,6,0,2
D43,Break & Enter-Other,2017,0,1,0,1
D43,Break & Enter-Other,2017,0,5,0,5
D43,Fraud,2017,3,20,0,17
D43,Fraud,2017,18,89,0,71
D43,Fraud,2017,3,27,0,24
D43,Fraud,2017,13,40,0,27
D43,Fraud,2017,9,41,0,32
D43,Fraud,2017,19,85,0,66
D43,Fraud,2017,1,22,0,21
D43,Fraud,2017,4,46,0,42
D43,Fraud,2017,4,30,0,26
D43,Other,2017,15,20,0,5
D51,Other,2017,92,94,0,2
D42,Assault,2017,59,88,0,29
D43,Theft Over $5000,2017,0,4,0,4
D42,Other,2017,7,7,1,0
D43,Other,2017,21,32,0,11
D51,Other,2017,169,173,0,4
D42,Assault,2017,3,4,0,1
D43,Theft Over $5000,2017,0,2,0,2
D42,Other,2017,21,22,0,1
D43,Other,2017,31,53,0,22
D51,Other,2017,2,2,1,0
D42,Assault,2017,31,39,0,8
D43,Theft Over $5000,2017,0,2,0,2
D42,Other,2017,17,17,1,0
D43,Other,2017,12,20,0,8
D51,Other,2017,43,48,0,5
D42,Assault,2017,68,110,0,42
D43,Theft Over $5000,2017,1,1,1,0
D43,Theft Over $5000,2017,0,4,0,4
D43,Theft Over $5000,2017,5,11,0,6
D43,Theft Over $5000,2017,0,1,0,1
D43,Theft Over $5000,2017,1,14,0,13
D43,Theft Under $5000,2017,14,54,0,40
D43,Theft Under $5000,2017,385,606,0,221
D43,Theft Under $5000,2017,13,78,0,65
D43,Theft Under $5000,2017,36,133,0,97
D43,Theft Under $5000,2017,47,114,0,67
D43,Theft Under $5000,2017,115,260,0,145
D43,Theft Under $5000,2017,10,62,0,52
D43,Theft Under $5000,2017,24,131,0,107
D43,Theft Under $5000,2017,19,106,0,87
D43,Theft Under $5000,2017,7,26,0,19
D43,Theft Under $5000,2017,1,1,1,0
D43,Theft Under $5000,2017,118,248,0,130
D43,Theft Under $5000,2017,0,1,0,1
D43,Theft Under $5000,2017,143,370,0,227
D43,Theft Under $5000,2017,15,63,0,48
D43,Theft Under $5000,2017,47,244,0,197
D43,Assault,2017,32,48,0,16
D51,Other,2017,14,14,1,0
D43,Other,2017,21,32,0,11
D42,Assault,2017,40,58,0,18
D42,Other,2017,18,19,0,1
D51,Other,2017,3,4,0,1
D43,Other,2017,38,54,0,16
D42,Attempt Murder,2017,0,2,0,2
D42,Other,2017,30,31,0,1
D51,Other,2017,12,12,1,0
D43,Other,2017,5,6,0,1
D42,Attempt Murder,2017,3,3,1,0
D42,Other,2017,11,11,1,0
D51,Auto Theft,2017,0,8,0,8
D43,Other,2017,23,34,0,11
D42,Attempt Murder,2017,1,1,1,0
D42,Other,2017,9,9,1,0
D51,Auto Theft,2017,4,19,0,15
D43,Other,2017,79,117,0,38
D42,Other,2017,10,22,0,12
D42,Other,2017,3,3,1,0
D51,Auto Theft,2017,1,15,0,14
D43,Other,2017,3,3,1,0
D42,Other,2017,22,39,0,17
D42,Other,2017,17,21,0,4
D51,Auto Theft,2017,2,25,0,23
D51,Auto Theft,2017,0,1,0,1
D51,Auto Theft,2017,2,14,0,12
D51,Auto Theft,2017,0,11,0,11
D51,Auto Theft,2017,1,6,0,5
D51,Auto Theft,2017,1,11,0,10
D51,Auto Theft,2017,0,1,0,1
D51,Break & Enter-Apartment,2017,14,36,0,22
D51,Break & Enter-Apartment,2017,11,56,0,45
D51,Break & Enter-Apartment,2017,3,27,0,24
D51,Break & Enter-Apartment,2017,14,65,0,51
D51,Break & Enter-Apartment,2017,11,36,0,25
D51,Break & Enter-Apartment,2017,8,16,0,8
D51,Break & Enter-Apartment,2017,7,27,0,20
D51,Break & Enter-Commercial,2017,6,12,0,6
D51,Break & Enter-Commercial,2017,5,24,0,19
D51,Break & Enter-Commercial,2017,12,72,0,60
D51,Break & Enter-Commercial,2017,7,42,0,35
D43,Other,2017,41,58,0,17
D42,Other,2017,20,29,0,9
D42,Other,2017,52,59,0,7
D43,Robbery-Financial,2017,1,1,1,0
D42,Other,2017,7,20,0,13
D42,Other,2017,1,1,1,0
D43,Robbery-Financial,2017,2,2,1,0
D42,Other,2017,33,58,0,25
D42,Other,2017,1,1,1,0
D43,Robbery-Financial,2017,1,3,0,2
D42,Other,2017,13,35,0,22
D42,Other,2017,43,47,0,4
D43,Robbery-Other,2017,4,5,0,1
D42,Other,2017,15,23,0,8
D42,Other,2017,1,1,1,0
D43,Robbery-Other,2017,22,44,0,22
D42,Other,2017,1,1,1,0
D42,Other,2017,29,32,0,3
D43,Robbery-Other,2017,7,9,0,2
D42,Other,2017,17,38,0,21
D42,Other,2017,40,46,0,6
D43,Robbery-Other,2017,4,16,0,12
D42,Other,2017,0,2,0,2
D42,Other,2017,54,63,0,9
D43,Robbery-Other,2017,5,19,0,14
D42,Other,2017,1,7,0,6
D42,Other,2017,36,41,0,5
D43,Robbery-Other,2017,37,69,0,32
D42,Other,2017,17,34,0,17
D43,Robbery-Other,2017,5,10,0,5
D42,Other,2017,23,32,0,9
D42,Other,2017,11,16,0,5
D43,Robbery-Other,2017,4,15,0,11
D42,Other,2017,35,41,0,6
D42,Robbery-Financial,2017,1,1,1,0
D43,Robbery-Other,2017,9,15,0,6
D42,Other,2017,6,7,0,1
D42,Robbery-Financial,2017,1,1,1,0
D43,Robbery-Other,2017,2,3,0,1
D42,Other,2017,10,16,0,6
D42,Robbery-Financial,2017,1,1,1,0
D43,Robbery-Other,2017,9,19,0,10
D42,Other,2017,30,32,0,2
D42,Robbery-Other,2017,5,20,0,15
D43,Robbery-Other,2017,31,57,0,26
D42,Other,2017,25,29,0,4
D42,Robbery-Other,2017,12,33,0,21
D43,Robbery-Other,2017,2,3,0,1
D42,Other,2017,1,1,1,0
D42,Robbery-Other,2017,6,13,0,7
D43,Robbery-Other,2017,22,48,0,26
D42,Other,2017,2,2,1,0
D42,Robbery-Other,2017,12,24,0,12
D42,Other Criminal Violations - Offensive Weapons,2017,7,7,1,0
D52,Auto Theft,2017,0,2,0,2
D52,Auto Theft,2017,6,12,0,6
D52,Auto Theft,2017,2,14,0,12
D52,Auto Theft,2017,4,6,0,2
D52,Auto Theft,2017,3,15,0,12
D52,Auto Theft,2017,2,15,0,13
D52,Break & Enter-Apartment,2017,5,21,0,16
D52,Break & Enter-Apartment,2017,6,22,0,16
D52,Break & Enter-Apartment,2017,7,31,0,24
D52,Break & Enter-Apartment,2017,2,6,0,4
D51,Theft Under $5000,2017,233,1174,0,941
D52,Break & Enter-Apartment,2017,4,4,1,0
D52,Break & Enter-Apartment,2017,10,27,0,17
D52,Break & Enter-Apartment,2017,5,10,0,5
D51,Theft Under $5000,2017,0,1,0,1
D52,Robbery-Other,2017,0,1,0,1
D51,Break & Enter-Commercial,2017,0,1,0,1
D52,Break & Enter-Commercial,2017,9,28,0,19
D52,Robbery-Other,2017,7,18,0,11
D51,Break & Enter-Commercial,2017,1,4,0,3
D51,Theft Under $5000,2017,0,1,0,1
D51,Break & Enter-Commercial,2017,1,9,0,8
D52,Robbery-Other,2017,6,14,0,8
D52,Break & Enter-Commercial,2017,8,16,0,8
D51,Theft Under $5000,2017,239,960,0,721
D51,Break & Enter-Commercial,2017,1,4,0,3
D52,Robbery-Other,2017,10,33,0,23
D52,Break & Enter-Commercial,2017,5,17,0,12
D51,Theft Under $5000,2017,1,18,0,17
D51,Break & Enter-Commercial,2017,7,22,0,15
D52,Robbery-Other,2017,0,2,0,2
D51,Sexual Violation,2017,23,49,0,26
D52,Break & Enter-Commercial,2017,1,7,0,6
D51,Theft Under $5000,2017,61,251,0,190
D53,Break & Enter-Apartment,2017,17,24,0,7
D51,Break & Enter-House,2017,1,8,0,7
D52,Other,2017,49,118,0,69
D52,Robbery-Other,2017,3,8,0,5
D51,Sexual Violation,2017,0,1,0,1
D52,Break & Enter-Commercial,2017,0,1,0,1
D51,Theft Under $5000,2017,54,197,0,143
D53,Break & Enter-Apartment,2017,7,22,0,15
D53,Break & Enter-Apartment,2017,2,11,0,9
D53,Break & Enter-Apartment,2017,0,5,0,5
D53,Break & Enter-Apartment,2017,2,12,0,10
D53,Break & Enter-Commercial,2017,5,26,0,21
D53,Break & Enter-Commercial,2017,0,1,0,1
D53,Break & Enter-Commercial,2017,0,1,0,1
D53,Break & Enter-Commercial,2017,0,1,0,1
D53,Break & Enter-Commercial,2017,1,3,0,2
D53,Break & Enter-Commercial,2017,3,9,0,6
D53,Break & Enter-Commercial,2017,3,7,0,4
D53,Break & Enter-Commercial,2017,0,5,0,5
D53,Break & Enter-Commercial,2017,5,15,0,10
D53,Break & Enter-Commercial,2017,3,10,0,7
D53,Break & Enter-Commercial,2017,1,8,0,7
D53,Break & Enter-Commercial,2017,3,7,0,4
D53,Break & Enter-Commercial,2017,0,3,0,3
D53,Break & Enter-House,2017,5,11,0,6
D53,Break & Enter-House,2017,1,33,0,32
D53,Break & Enter-House,2017,4,16,0,12
D53,Break & Enter-House,2017,1,2,0,1
D53,Break & Enter-House,2017,1,9,0,8
D53,Break & Enter-House,2017,3,21,0,18
D53,Break & Enter-House,2017,2,35,0,33
D53,Break & Enter-House,2017,3,16,0,13
D53,Break & Enter-House,2017,2,4,0,2
D53,Break & Enter-House,2017,0,2,0,2
D53,Break & Enter-House,2017,14,31,0,17
D53,Break & Enter-House,2017,0,2,0,2
D53,Break & Enter-House,2017,1,11,0,10
D53,Break & Enter-House,2017,0,2,0,2
D53,Break & Enter-Other,2017,0,1,0,1
D53,Break & Enter-Other,2017,0,1,0,1
D53,Break & Enter-Other,2017,0,1,0,1
D53,Break & Enter-Other,2017,1,2,0,1
D53,Break & Enter-Other,2017,3,3,1,0
D53,Break & Enter-Other,2017,0,1,0,1
D53,Break & Enter-Other,2017,0,1,0,1
D53,Break & Enter-Other,2017,0,2,0,2
D53,Break & Enter-Other,2017,1,2,0,1
D53,Break & Enter-Other,2017,0,3,0,3
D53,Break & Enter-Other,2017,0,1,0,1
D53,Break & Enter-Other,2017,0,1,0,1
D53,Fraud,2017,23,112,0,89
D53,Fraud,2017,2,5,0,3
D53,Fraud,2017,1,12,0,11
D53,Fraud,2017,2,15,0,13
D53,Fraud,2017,1,9,0,8
D53,Fraud,2017,2,9,0,7
D52,Other,2017,197,354,0,157
D52,Other Criminal Violations - Offensive Weapons,2017,56,60,0,4
D51,Theft Under $5000,2017,3,138,0,135
D52,Theft Over $5000,2017,2,14,0,12
D52,Other,2017,9,11,0,2
D52,Break & Enter-Commercial,2017,14,40,0,26
D51,Sexual Violation,2017,16,30,0,14
D51,Theft Under $5000,2017,179,701,0,522
D52,Theft Over $5000,2017,1,6,0,5
D52,Other,2017,1,2,0,1
D51,Break & Enter-House,2017,0,2,0,2
D51,Sexual Violation,2017,6,11,0,5
D52,Break & Enter-Commercial,2017,53,101,0,48
D51,Theft Under $5000,2017,0,1,0,1
D52,Theft Over $5000,2017,3,20,0,17
D52,Robbery-Other,2017,1,2,0,1
D51,Break & Enter-House,2017,0,4,0,4
D51,Sexual Violation,2017,2,3,0,1
D51,Theft Under $5000,2017,0,1,0,1
D52,Break & Enter-House,2017,1,5,0,4
D52,Robbery-Other,2017,15,27,0,12
D51,Break & Enter-House,2017,6,14,0,8
D52,Theft Over $5000,2017,2,13,0,11
D51,Sexual Violation,2017,13,17,0,4
D51,Assault,2017,59,90,0,31
D52,Break & Enter-Other,2017,2,6,0,4
D52,Robbery-Other,2017,36,77,0,41
D51,Break & Enter-House,2017,0,2,0,2
D52,Theft Over $5000,2017,0,2,0,2
D51,Other,2017,11,12,0,1
D51,Assault,2017,173,272,0,99
D52,Break & Enter-Other,2017,3,7,0,4
D52,Sexual Violation,2017,0,1,0,1
D51,Break & Enter-House,2017,0,3,0,3
D52,Theft Over $5000,2017,0,7,0,7
D51,Other,2017,5,6,0,1
D51,Assault,2017,226,366,0,140
D52,Break & Enter-Other,2017,4,9,0,5
D52,Other,2017,3,5,0,2
D52,Sexual Violation,2017,9,21,0,12
D51,Break & Enter-Other,2017,1,2,0,1
D52,Theft Over $5000,2017,12,35,0,23
D52,Theft Under $5000,2017,0,1,0,1
D52,Theft Under $5000,2017,71,439,0,368
D52,Theft Under $5000,2017,0,1,0,1
D52,Theft Under $5000,2017,2,12,0,10
D52,Theft Under $5000,2017,6,43,0,37
D52,Theft Under $5000,2017,25,256,0,231
D52,Theft Under $5000,2017,149,857,0,708
D52,Theft Under $5000,2017,0,1,0,1
D52,Theft Under $5000,2017,5,35,0,30
D52,Theft Under $5000,2017,0,1,0,1
D52,Theft Under $5000,2017,22,192,0,170
D52,Theft Under $5000,2017,0,1,0,1
D52,Theft Under $5000,2017,5,281,0,276
D52,Theft Under $5000,2017,113,601,0,488
D52,Theft Under $5000,2017,0,1,0,1
D52,Theft Under $5000,2017,1310,2538,0,1228
D52,Assault,2017,88,128,0,40
D52,Assault,2017,8,11,0,3
D52,Assault,2017,33,63,0,30
D52,Assault,2017,67,103,0,36
D52,Assault,2017,109,169,0,60
D52,Assault,2017,14,24,0,10
D52,Assault,2017,65,94,0,29
D52,Assault,2017,23,48,0,25
D52,Assault,2017,146,258,0,112
D52,Assault,2017,364,562,0,198
D52,Attempt Murder,2017,1,1,1,0
D52,Attempt Murder,2017,1,1,1,0
D52,Other,2017,22,45,0,23
D52,Other,2017,0,3,0,3
D52,Other,2017,7,11,0,4
D52,Other,2017,30,58,0,28
D52,Other,2017,2,4,0,2
D52,Other,2017,9,18,0,9
D52,Other,2017,16,23,0,7
D52,Other,2017,21,42,0,21
D52,Other,2017,102,167,0,65
D52,Robbery-Financial,2017,2,2,1,0
D52,Robbery-Financial,2017,0,1,0,1
D52,Robbery-Financial,2017,2,2,1,0
D52,Robbery-Other,2017,8,16,0,8
D51,Other,2017,10,10,1,0
D52,Sexual Violation,2017,0,1,0,1
D52,Break & Enter-Other,2017,1,3,0,2
D52,Other,2017,2,2,1,0
D51,Other,2017,16,18,0,2
D51,Assault,2017,237,395,0,158
D52,Other,2017,5,5,1,0
D52,Sexual Violation,2017,1,3,0,2
D52,Other,2017,6,6,1,0
D51,Other,2017,2,2,1,0
D51,Assault,2017,2,5,0,3
D51,Break & Enter-Other,2017,1,5,0,4
D51,Assault,2017,91,136,0,45
D51,Other,2017,3,3,1,0
D53,Other,2017,8,10,0,2
D52,Sexual Violation,2017,11,16,0,5
D52,Break & Enter-Other,2017,4,12,0,8
D53,Other,2017,3,3,1,0
D51,Assault,2017,75,104,0,29
D51,Other,2017,1,2,0,1
D51,Break & Enter-Other,2017,2,9,0,7
D52,Sexual Violation,2017,6,18,0,12
D52,Break & Enter-Other,2017,2,8,0,6
D51,Assault,2017,0,1,0,1
D53,Other,2017,1,1,1,0
D51,Other,2017,1,1,1,0
D51,Break & Enter-Other,2017,5,14,0,9
D52,Sexual Violation,2017,0,1,0,1
D52,Break & Enter-Other,2017,3,15,0,12
D51,Assault,2017,27,66,0,39
D53,Other,2017,2,2,1,0
D51,Other,2017,11,11,1,0
D51,Break & Enter-Other,2017,0,6,0,6
D52,Sexual Violation,2017,11,16,0,5
D51,Assault,2017,77,113,0,36
D53,Other,2017,1,1,1,0
D51,Other,2017,95,102,0,7
D52,Fraud,2017,37,133,0,96
D51,Break & Enter-Other,2017,1,1,1,0
D52,Sexual Violation,2017,8,12,0,4
D51,Assault,2017,1,1,1,0
D53,Other,2017,0,1,0,1
D51,Other,2017,190,202,0,12
D52,Fraud,2017,0,4,0,4
D51,Break & Enter-Other,2017,0,3,0,3
D52,Sexual Violation,2017,13,30,0,17
D51,Attempt Murder,2017,1,1,1,0
D53,Other,2017,1,1,1,0
D51,Other,2017,161,173,0,12
D52,Fraud,2017,3,13,0,10
D51,Break & Enter-Other,2017,1,3,0,2
D51,Attempt Murder,2017,0,2,0,2
D52,Sexual Violation,2017,33,61,0,28
D53,Other,2017,4,7,0,3
D51,Other,2017,358,378,0,20
D52,Fraud,2017,11,82,0,71
D51,Fraud,2017,26,59,0,33
D52,Fraud,2017,21,95,0,74
D51,Attempt Murder,2017,0,4,0,4
D51,Fraud,2017,31,141,0,110
D53,Other,2017,0,1,0,1
D52,Fraud,2017,1,8,0,7
D51,Other,2017,102,102,1,0
D51,Attempt Murder,2017,0,1,0,1
D51,Fraud,2017,60,192,0,132
D53,Other,2017,3,3,1,0
D52,Fraud,2017,16,87,0,71
D51,Other,2017,76,82,0,6
D51,Other,2017,5,20,0,15
D52,Other,2017,1,1,1,0
D51,Fraud,2017,0,1,0,1
D53,Other,2017,4,4,1,0
D52,Fraud,2017,2,32,0,30
D51,Other,2017,56,59,0,3
D51,Other,2017,19,33,0,14
D52,Other,2017,1,2,0,1
D51,Fraud,2017,39,157,0,118
D53,Other,2017,5,5,1,0
D52,Fraud,2017,31,138,0,107
D51,Other,2017,4,4,1,0
D51,Other,2017,40,60,0,20
D52,Other,2017,12,12,1,0
D51,Fraud,2017,1,6,0,5
D53,Other,2017,22,23,0,1
D52,Fraud,2017,143,450,0,307
D51,Other,2017,68,74,0,6
D51,Other,2017,41,71,0,30
D52,Other,2017,10,10,1,0
D51,Fraud,2017,13,57,0,44
D53,Other,2017,5,6,0,1
D52,Other,2017,48,120,0,72
D51,Other,2017,1,1,1,0
D51,Other,2017,22,43,0,21
D52,Other,2017,1,1,1,0
D51,Fraud,2017,1,27,0,26
D53,Other,2017,34,35,0,1
D52,Other,2017,5,6,0,1
D52,Other,2017,13,13,1,0
D51,Other,2017,50,50,1,0
D52,Other,2017,1,1,1,0
D51,Other,2017,11,24,0,13
D52,Other,2017,10,16,0,6
D51,Fraud,2017,3,17,0,14
D51,Other Criminal Violations - Offensive Weapons,2017,13,14,0,1
D52,Other,2017,17,18,0,1
D51,Other,2017,1,2,0,1
D53,Other,2017,1,1,1,0
D52,Other,2017,13,13,1,0
D51,Other,2017,18,34,0,16
D52,Other,2017,33,84,0,51
D51,Fraud,2017,18,78,0,60
D51,Other Criminal Violations - Offensive Weapons,2017,34,35,0,1
D53,Other,2017,13,14,0,1
D52,Other,2017,109,119,0,10
D51,Robbery-Financial,2017,1,1,1,0
D52,Other,2017,78,207,0,129
D51,Other,2017,49,142,0,93
D51,Other Criminal Violations - Offensive Weapons,2017,40,42,0,2
D53,Auto Theft,2017,5,13,0,8
D52,Other,2017,18,18,1,0
D51,Robbery-Financial,2017,3,3,1,0
D52,Other,2017,0,1,0,1
D51,Other,2017,74,178,0,104
D51,Other Criminal Violations - Offensive Weapons,2017,58,62,0,4
D53,Auto Theft,2017,0,14,0,14
D52,Other,2017,1,1,1,0
D51,Robbery-Financial,2017,1,1,1,0
D52,Other,2017,1,1,1,0
D51,Other Criminal Violations - Offensive Weapons,2017,1,1,1,0
D51,Other,2017,100,244,0,144
D53,Auto Theft,2017,1,1,1,0
D52,Other,2017,31,33,0,2
D51,Robbery-Other,2017,21,37,0,16
D52,Other,2017,0,1,0,1
D51,Other Criminal Violations - Offensive Weapons,2017,16,16,1,0
D51,Other,2017,0,1,0,1
D53,Auto Theft,2017,1,3,0,2
D52,Other,2017,1,1,1,0
D51,Robbery-Other,2017,11,33,0,22
D52,Other,2017,3,10,0,7
D51,Other,2017,120,329,0,209
D51,Other Criminal Violations - Offensive Weapons,2017,8,9,0,1
D51,Other,2017,2,5,0,3
D53,Auto Theft,2017,1,1,1,0
D52,Other,2017,0,1,0,1
D51,Robbery-Other,2017,32,87,0,55
D52,Other,2017,39,45,0,6
D53,Auto Theft,2017,0,2,0,2
D52,Other,2017,32,162,0,130
D51,Robbery-Other,2017,26,82,0,56
D51,Other,2017,37,113,0,76
D51,Other Criminal Violations - Offensive Weapons,2017,12,12,1,0
D52,Other,2017,1,2,0,1
D53,Auto Theft,2017,1,6,0,5
D52,Other,2017,25,97,0,72
D51,Robbery-Other,2017,1,1,1,0
D51,Other,2017,32,83,0,51
D51,Other,2017,0,2,0,2
D52,Other,2017,143,152,0,9
D53,Auto Theft,2017,3,16,0,13
D51,Robbery-Other,2017,12,29,0,17
D51,Other,2017,3,14,0,11
D51,Other,2017,0,3,0,3
D52,Other,2017,61,63,0,2
D53,Auto Theft,2017,0,4,0,4
D51,Robbery-Other,2017,6,15,0,9
D51,Other,2017,26,111,0,85
D51,Other,2017,4,4,1,0
D52,Other,2017,53,59,0,6
D53,Auto Theft,2017,1,10,0,9
D51,Robbery-Other,2017,8,14,0,6
D51,Theft Over $5000,2017,0,7,0,7
D51,Other,2017,1,1,1,0
D52,Other,2017,37,42,0,5
D53,Auto Theft,2017,0,2,0,2
D51,Robbery-Other,2017,5,11,0,6
D51,Theft Over $5000,2017,0,10,0,10
D52,Other,2017,28,29,0,1
D52,Other,2017,116,121,0,5
D53,Auto Theft,2017,0,4,0,4
D51,Sexual Violation,2017,1,1,1,0
D51,Theft Over $5000,2017,3,20,0,17
D52,Other,2017,2,2,1,0
D52,Other,2017,1194,1235,0,41
D53,Auto Theft,2017,3,9,0,6
D51,Theft Over $5000,2017,6,20,0,14
D51,Sexual Violation,2017,12,20,0,8
D53,Auto Theft,2017,1,9,0,8
D52,Other Criminal Violations - Offensive Weapons,2017,26,30,0,4
D52,Other,2017,12,12,1,0
D51,Sexual Violation,2017,19,41,0,22
D53,Auto Theft,2017,0,1,0,1
D52,Other Criminal Violations - Offensive Weapons,2017,4,4,1,0
D51,Theft Over $5000,2017,2,8,0,6
D52,Other,2017,15,17,0,2
D51,Sexual Violation,2017,15,45,0,30
D53,Auto Theft,2017,0,2,0,2
D52,Other Criminal Violations - Offensive Weapons,2017,11,12,0,1
D51,Theft Over $5000,2017,0,2,0,2
D52,Other,2017,35,35,1,0
D53,Auto Theft,2017,0,2,0,2
D52,Other Criminal Violations - Offensive Weapons,2017,15,16,0,1
D51,Theft Over $5000,2017,0,7,0,7
D52,Other,2017,3,3,1,0
D53,Break & Enter-Apartment,2017,10,31,0,21
D52,Other Criminal Violations - Offensive Weapons,2017,15,18,0,3
D51,Theft Over $5000,2017,0,7,0,7
D52,Other,2017,16,16,1,0
D53,Break & Enter-Apartment,2017,0,1,0,1
D52,Other Criminal Violations - Offensive Weapons,2017,8,8,1,0
D51,Theft Over $5000,2017,0,1,0,1
D52,Other,2017,8,8,1,0
D53,Break & Enter-Apartment,2017,1,2,0,1
D52,Other Criminal Violations - Offensive Weapons,2017,2,2,1,0
D51,Theft Under $5000,2017,75,390,0,315
D52,Other,2017,21,22,0,1
D53,Break & Enter-Apartment,2017,0,4,0,4
D52,Other Criminal Violations - Offensive Weapons,2017,24,25,0,1
D51,Theft Under $5000,2017,554,1632,0,1078
D52,Other,2017,44,50,0,6
D53,Break & Enter-Apartment,2017,1,16,0,15
D53,Break & Enter-Apartment,2017,1,7,0,6
D52,Auto Theft,2017,0,7,0,7
D53,Break & Enter-Apartment,2017,1,3,0,2
D52,Auto Theft,2017,0,1,0,1
D53,Break & Enter-Apartment,2017,2,9,0,7
D53,Break & Enter-Apartment,2017,5,17,0,12
D55,Break & Enter-Commercial,2017,5,9,0,4
D55,Break & Enter-Commercial,2017,2,11,0,9
D53,Fraud,2017,4,31,0,27
D55,Break & Enter-Commercial,2017,2,5,0,3
D55,Break & Enter-Commercial,2017,1,3,0,2
D53,Fraud,2017,6,39,0,33
D55,Break & Enter-Commercial,2017,8,29,0,21
D55,Fraud,2017,16,91,0,75
D53,Other,2017,6,14,0,8
D53,Fraud,2017,5,37,0,32
D55,Break & Enter-Commercial,2017,5,12,0,7
D53,Other,2017,2,7,0,5
D55,Fraud,2017,5,29,0,24
D53,Fraud,2017,0,2,0,2
D55,Break & Enter-Commercial,2017,5,13,0,8
D53,Robbery-Financial,2017,3,3,1,0
D55,Fraud,2017,9,45,0,36
D53,Fraud,2017,4,31,0,27
D55,Break & Enter-Commercial,2017,5,10,0,5
D53,Robbery-Financial,2017,0,1,0,1
D55,Fraud,2017,1,15,0,14
D53,Fraud,2017,10,83,0,73
D55,Break & Enter-Commercial,2017,4,8,0,4
D53,Robbery-Financial,2017,1,1,1,0
D55,Fraud,2017,7,25,0,18
D53,Fraud,2017,8,58,0,50
D55,Break & Enter-Commercial,2017,0,1,0,1
D53,Robbery-Other,2017,13,33,0,20
D55,Fraud,2017,0,17,0,17
D53,Fraud,2017,7,46,0,39
D55,Break & Enter-House,2017,4,6,0,2
D53,Robbery-Other,2017,1,1,1,0
D55,Other,2017,1,1,1,0
D53,Fraud,2017,12,56,0,44
D55,Break & Enter-House,2017,0,9,0,9
D53,Robbery-Other,2017,1,1,1,0
D55,Other,2017,17,79,0,62
D53,Fraud,2017,4,27,0,23
D55,Break & Enter-House,2017,1,11,0,10
D53,Robbery-Other,2017,2,3,0,1
D53,Other,2017,12,12,1,0
D55,Other,2017,26,27,0,1
D53,Theft Under $5000,2017,1,21,0,20
D55,Other,2017,8,33,0,25
D55,Other,2017,1,1,1,0
D55,Other,2017,10,43,0,33
D55,Other,2017,16,42,0,26
D55,Other,2017,35,131,0,96
D55,Other,2017,19,64,0,45
D55,Other,2017,18,74,0,56
D55,Other,2017,2,4,0,2
D55,Other,2017,15,66,0,51
D55,Other,2017,28,85,0,57
D55,Other,2017,9,28,0,19
D55,Other,2017,17,44,0,27
D55,Other,2017,58,183,0,125
D55,Other,2017,20,54,0,34
D55,Other,2017,30,96,0,66
D55,Other,2017,8,29,0,21
D55,Other,2017,38,83,0,45
D55,Other,2017,12,33,0,21
D55,Theft Over $5000,2017,0,2,0,2
D55,Theft Over $5000,2017,0,1,0,1
D55,Theft Over $5000,2017,1,3,0,2
D55,Theft Over $5000,2017,3,9,0,6
D55,Theft Over $5000,2017,1,4,0,3
D55,Theft Over $5000,2017,1,8,0,7
D55,Theft Over $5000,2017,2,5,0,3
D55,Theft Over $5000,2017,0,2,0,2
D55,Theft Over $5000,2017,2,2,1,0
D55,Theft Over $5000,2017,0,1,0,1
D55,Theft Over $5000,2017,4,19,0,15
D55,Theft Over $5000,2017,1,3,0,2
D55,Theft Over $5000,2017,1,7,0,6
D55,Theft Over $5000,2017,0,5,0,5
D55,Theft Over $5000,2017,0,3,0,3
D55,Theft Under $5000,2017,2,2,1,0
D55,Theft Under $5000,2017,55,175,0,120
D55,Theft Under $5000,2017,17,58,0,41
D55,Theft Under $5000,2017,63,149,0,86
D55,Theft Under $5000,2017,10,63,0,53
D55,Theft Under $5000,2017,119,367,0,248
D55,Theft Under $5000,2017,10,76,0,66
D55,Theft Under $5000,2017,18,154,0,136
D55,Theft Under $5000,2017,2,13,0,11
D55,Theft Under $5000,2017,26,132,0,106
D53,Other,2017,5,5,1,0
D55,Theft Under $5000,2017,29,126,0,97
D53,Theft Under $5000,2017,0,2,0,2
D53,Other,2017,42,159,0,117
D53,Robbery-Other,2017,2,2,1,0
D55,Other,2017,1,1,1,0
D55,Break & Enter-House,2017,2,20,0,18
D53,Other,2017,2,2,1,0
D53,Robbery-Other,2017,2,5,0,3
D53,Theft Under $5000,2017,2,20,0,18
D55,Other,2017,3,4,0,1
D55,Break & Enter-House,2017,7,17,0,10
D53,Other,2017,3,3,1,0
D55,Theft Under $5000,2017,0,1,0,1
D53,Other,2017,1,3,0,2
D55,Break & Enter-House,2017,0,1,0,1
D53,Other,2017,7,8,0,1
D53,Robbery-Other,2017,5,9,0,4
D55,Other,2017,7,8,0,1
D53,Theft Under $5000,2017,1,18,0,17
D55,Theft Under $5000,2017,27,114,0,87
D53,Other,2017,1,7,0,6
D55,Break & Enter-House,2017,5,9,0,4
D53,Other,2017,65,73,0,8
D53,Robbery-Other,2017,3,6,0,3
D55,Other,2017,62,64,0,2
D53,Theft Under $5000,2017,12,76,0,64
D55,Theft Under $5000,2017,110,303,0,193
D53,Other,2017,3,14,0,11
D55,Break & Enter-House,2017,0,1,0,1
D55,Break & Enter-House,2017,4,13,0,9
D55,Break & Enter-House,2017,1,10,0,9
D55,Break & Enter-House,2017,0,6,0,6
D55,Break & Enter-House,2017,3,11,0,8
D55,Break & Enter-House,2017,14,33,0,19
D55,Break & Enter-House,2017,1,6,0,5
D55,Break & Enter-House,2017,4,8,0,4
D55,Break & Enter-House,2017,1,4,0,3
D55,Break & Enter-House,2017,4,11,0,7
D55,Break & Enter-House,2017,1,8,0,7
D55,Break & Enter-Other,2017,0,3,0,3
D55,Break & Enter-Other,2017,3,6,0,3
D55,Break & Enter-Other,2017,1,3,0,2
D55,Break & Enter-Other,2017,0,7,0,7
D55,Break & Enter-Other,2017,0,2,0,2
D55,Break & Enter-Other,2017,1,2,0,1
D55,Break & Enter-Other,2017,1,5,0,4
D55,Break & Enter-Other,2017,0,1,0,1
D55,Break & Enter-Other,2017,0,1,0,1
D55,Fraud,2017,2,12,0,10
D55,Fraud,2017,4,22,0,18
D55,Fraud,2017,2,31,0,29
D55,Fraud,2017,4,25,0,21
D55,Fraud,2017,13,58,0,45
D55,Fraud,2017,6,52,0,46
D55,Fraud,2017,5,27,0,22
D55,Fraud,2017,2,3,0,1
D55,Fraud,2017,4,37,0,33
D55,Fraud,2017,14,51,0,37
D55,Fraud,2017,1,2,0,1
D55,Fraud,2017,2,19,0,17
D55,Fraud,2017,0,32,0,32
D55,Theft Under $5000,2017,262,847,0,585
D55,Theft Under $5000,2017,122,209,0,87
D55,Theft Under $5000,2017,77,315,0,238
D55,Theft Under $5000,2017,9,48,0,39
D55,Theft Under $5000,2017,36,177,0,141
D55,Theft Under $5000,2017,4,38,0,34
D55,Assault,2017,0,1,0,1
D55,Assault,2017,41,59,0,18
D55,Assault,2017,38,47,0,9
D55,Assault,2017,1,2,0,1
D55,Assault,2017,36,70,0,34
D55,Assault,2017,58,75,0,17
D55,Assault,2017,95,148,0,53
D55,Assault,2017,81,108,0,27
D55,Assault,2017,45,69,0,24
D55,Assault,2017,1,5,0,4
D55,Assault,2017,30,57,0,27
D55,Assault,2017,92,122,0,30
D55,Assault,2017,1,2,0,1
D55,Assault,2017,18,38,0,20
D55,Assault,2017,42,61,0,19
D55,Assault,2017,104,149,0,45
D55,Assault,2017,67,94,0,27
D55,Assault,2017,63,94,0,31
D55,Assault,2017,25,35,0,10
D55,Assault,2017,51,74,0,23
D55,Assault,2017,21,29,0,8
D55,Attempt Murder,2017,1,1,1,0
D55,Attempt Murder,2017,1,2,0,1
D55,Attempt Murder,2017,4,4,1,0
D55,Attempt Murder,2017,1,1,1,0
D55,Other,2017,9,18,0,9
D55,Other,2017,10,15,0,5
D55,Other,2017,5,14,0,9
D55,Other,2017,7,11,0,4
D55,Other,2017,33,46,0,13
D55,Other,2017,22,33,0,11
D55,Other,2017,8,20,0,12
D55,Other,2017,1,5,0,4
D55,Other,2017,12,20,0,8
D55,Other,2017,20,37,0,17
D55,Other,2017,6,17,0,11
D55,Other,2017,12,16,0,4
D55,Other,2017,42,76,0,34
D55,Other,2017,18,23,0,5
D53,Robbery-Other,2017,0,1,0,1
D53,Other,2017,3,5,0,2
D55,Other,2017,19,19,1,0
D53,Theft Under $5000,2017,16,96,0,80
D53,Other,2017,4,15,0,11
D53,Theft Under $5000,2017,36,177,0,141
D53,Theft Under $5000,2017,2,6,0,4
D53,Theft Under $5000,2017,1,1,1,0
D53,Theft Under $5000,2017,44,122,0,78
D53,Theft Under $5000,2017,159,610,0,451
D53,Theft Under $5000,2017,70,261,0,191
D53,Theft Under $5000,2017,104,230,0,126
D53,Theft Under $5000,2017,3,12,0,9
D53,Theft Under $5000,2017,101,298,0,197
D53,Theft Under $5000,2017,9,73,0,64
D53,Other,2017,2,2,1,0
D53,Assault,2017,75,122,0,47
D53,Other,2017,5,17,0,12
D53,Other,2017,8,15,0,7
D53,Assault,2017,4,6,0,2
D53,Assault,2017,7,8,0,1
D53,Assault,2017,12,15,0,3
D53,Assault,2017,9,10,0,1
D53,Assault,2017,2,6,0,4
D53,Assault,2017,9,13,0,4
D53,Robbery-Other,2017,5,5,1,0
D53,Assault,2017,10,11,0,1
D53,Other,2017,6,8,0,2
D53,Other,2017,0,1,0,1
D55,Other,2017,12,13,0,1
D55,Other,2017,8,8,1,0
D55,Other,2017,13,14,0,1
D55,Other,2017,20,20,1,0
D55,Auto Theft,2017,0,9,0,9
D55,Auto Theft,2017,0,7,0,7
D55,Auto Theft,2017,0,5,0,5
D55,Auto Theft,2017,2,10,0,8
D55,Auto Theft,2017,6,26,0,20
D55,Auto Theft,2017,2,13,0,11
D55,Auto Theft,2017,1,14,0,13
D55,Auto Theft,2017,0,2,0,2
D55,Auto Theft,2017,0,11,0,11
D55,Auto Theft,2017,4,11,0,7
D55,Auto Theft,2017,0,1,0,1
D55,Auto Theft,2017,1,4,0,3
D55,Auto Theft,2017,15,36,0,21
D55,Auto Theft,2017,0,7,0,7
D55,Auto Theft,2017,5,14,0,9
D55,Auto Theft,2017,2,2,1,0
D55,Auto Theft,2017,0,7,0,7
D55,Auto Theft,2017,0,2,0,2
D55,Break & Enter-Apartment,2017,3,6,0,3
D55,Break & Enter-Apartment,2017,4,8,0,4
D55,Break & Enter-Apartment,2017,0,2,0,2
D55,Break & Enter-Apartment,2017,2,5,0,3
D55,Break & Enter-Apartment,2017,3,12,0,9
D55,Break & Enter-Apartment,2017,2,8,0,6
D55,Break & Enter-Apartment,2017,4,7,0,3
D55,Break & Enter-Apartment,2017,0,4,0,4
D55,Break & Enter-Apartment,2017,8,16,0,8
D55,Break & Enter-Apartment,2017,3,6,0,3
D55,Break & Enter-Apartment,2017,1,1,1,0
D55,Break & Enter-Apartment,2017,1,19,0,18
D55,Break & Enter-Apartment,2017,3,10,0,7
D55,Break & Enter-Apartment,2017,2,12,0,10
D55,Break & Enter-Apartment,2017,1,3,0,2
D55,Break & Enter-Apartment,2017,3,10,0,7
D53,Robbery-Other,2017,9,28,0,19
D55,Break & Enter-Apartment,2017,1,1,1,0
D53,Other,2017,8,35,0,27
D53,Other,2017,7,7,1,0
D53,Assault,2017,16,18,0,2
D53,Assault,2017,23,37,0,14
D53,Assault,2017,27,37,0,10
D53,Assault,2017,0,3,0,3
D53,Assault,2017,31,47,0,16
D53,Assault,2017,63,99,0,36
D53,Assault,2017,64,74,0,10
D53,Assault,2017,57,83,0,26
D53,Assault,2017,2,6,0,4
D53,Assault,2017,41,64,0,23
D53,Assault,2017,18,23,0,5
D53,Attempt Murder,2017,0,1,0,1
D53,Other,2017,19,28,0,9
D53,Other,2017,0,4,0,4
D53,Other,2017,8,9,0,1
D53,Other,2017,8,9,0,1
D53,Other,2017,3,4,0,1
D53,Other,2017,4,6,0,2
D53,Other,2017,9,17,0,8
D53,Other,2017,8,13,0,5
D53,Other,2017,4,12,0,8
D53,Other,2017,9,16,0,7
D53,Other,2017,18,25,0,7
D53,Other,2017,20,31,0,11
D53,Other,2017,21,25,0,4
D53,Other,2017,3,3,1,0
D55,Break & Enter-Commercial,2017,0,2,0,2
D55,Break & Enter-Commercial,2017,3,7,0,4
D55,Break & Enter-Commercial,2017,7,16,0,9
D55,Break & Enter-Commercial,2017,13,28,0,15
D55,Break & Enter-Commercial,2017,5,10,0,5
D53,Robbery-Other,2017,0,5,0,5
D53,Other,2017,2,2,1,0
D53,Robbery-Other,2017,3,6,0,3
D53,Robbery-Other,2017,0,4,0,4
D53,Other,2017,7,7,1,0
D53,Robbery-Other,2017,7,12,0,5
D53,Other,2017,4,5,0,1
D53,Robbery-Other,2017,0,2,0,2
D53,Other,2017,1,1,1,0
D53,Sexual Violation,2017,12,23,0,11
D53,Other,2017,12,12,1,0
D53,Sexual Violation,2017,1,1,1,0
D53,Other,2017,10,13,0,3
D53,Sexual Violation,2017,1,1,1,0
D53,Other,2017,28,36,0,8
D53,Sexual Violation,2017,2,2,1,0
D53,Other,2017,6,30,0,24
D53,Other,2017,30,32,0,2
D53,Other,2017,16,50,0,34
D53,Other,2017,22,25,0,3
D53,Other,2017,2,3,0,1
D53,Sexual Violation,2017,2,2,1,0
D53,Other,2017,72,82,0,10
D53,Other,2017,13,35,0,22
D53,Sexual Violation,2017,0,2,0,2
D53,Other,2017,33,36,0,3
D53,Other,2017,42,107,0,65
D53,Sexual Violation,2017,1,3,0,2
D53,Other,2017,36,43,0,7
D53,Other,2017,14,50,0,36
D53,Sexual Violation,2017,0,1,0,1
D53,Other,2017,3,3,1,0
D53,Other,2017,21,65,0,44
D53,Sexual Violation,2017,2,5,0,3
D53,Other,2017,18,18,1,0
D53,Other,2017,0,1,0,1
D53,Sexual Violation,2017,10,12,0,2
D53,Other,2017,49,55,0,6
D53,Other,2017,23,70,0,47
D53,Sexual Violation,2017,0,1,0,1
D53,Other,2017,11,11,1,0
D53,Other,2017,9,51,0,42
D53,Sexual Violation,2017,5,6,0,1
D53,Other Criminal Violations - Offensive Weapons,2017,3,4,0,1
D53,Theft Over $5000,2017,1,26,0,25
D53,Sexual Violation,2017,5,16,0,11
D53,Other Criminal Violations - Offensive Weapons,2017,1,1,1,0
D53,Theft Over $5000,2017,0,3,0,3
D53,Sexual Violation,2017,2,6,0,4
D53,Other Criminal Violations - Offensive Weapons,2017,2,2,1,0
D53,Theft Over $5000,2017,0,3,0,3
D53,Sexual Violation,2017,6,10,0,4
D53,Other Criminal Violations - Offensive Weapons,2017,1,1,1,0
D53,Theft Over $5000,2017,0,3,0,3
D53,Sexual Violation,2017,0,1,0,1
D53,Other Criminal Violations - Offensive Weapons,2017,3,3,1,0
D53,Theft Over $5000,2017,0,1,0,1
D53,Sexual Violation,2017,4,10,0,6
D53,Other Criminal Violations - Offensive Weapons,2017,4,4,1,0
D53,Other Criminal Violations - Offensive Weapons,2017,4,4,1,0
D53,Other Criminal Violations - Offensive Weapons,2017,13,13,1,0
D53,Other Criminal Violations - Offensive Weapons,2017,4,6,0,2
D53,Other Criminal Violations - Offensive Weapons,2017,7,11,0,4
D53,Other Criminal Violations - Offensive Weapons,2017,5,5,1,0
D53,Other Criminal Violations - Offensive Weapons,2017,1,1,1,0
D53,Other,2017,0,1,0,1
D53,Other,2017,1,1,1,0
D53,Other,2017,1,1,1,0
D55,Other,2017,16,16,1,0
D55,Other,2017,4,4,1,0
D55,Other,2017,1,1,1,0
D55,Other,2017,19,19,1,0
D55,Other,2017,9,9,1,0
D55,Other,2017,36,37,0,1
D55,Other,2017,33,33,1,0
D55,Other,2017,12,13,0,1
D55,Other,2017,1,1,1,0
D55,Other,2017,3,3,1,0
D53,Theft Over $5000,2017,0,2,0,2
D53,Sexual Violation,2017,2,3,0,1
D53,Theft Over $5000,2017,2,2,1,0
D53,Other,2017,5,5,1,0
D53,Theft Over $5000,2017,0,4,0,4
D53,Other,2017,1,1,1,0
D53,Theft Over $5000,2017,2,4,0,2
D53,Other,2017,2,2,1,0
D53,Theft Over $5000,2017,0,2,0,2
D53,Other,2017,1,1,1,0
D53,Other,2017,2,2,1,0
D53,Theft Over $5000,2017,2,10,0,8
D53,Other,2017,2,2,1,0
D53,Theft Over $5000,2017,0,1,0,1
D53,Other,2017,2,2,1,0
D53,Theft Over $5000,2017,2,9,0,7
D53,Other,2017,4,4,1,0
D53,Theft Over $5000,2017,0,1,0,1
D53,Other,2017,6,6,1,0
D53,Theft Over $5000,2017,0,4,0,4
D53,Other,2017,2,2,1,0
D53,Other,2017,1,1,1,0
D53,Theft Over $5000,2017,0,1,0,1
D53,Theft Under $5000,2017,79,556,0,477
D53,Theft Under $5000,2017,2,5,0,3
D53,Theft Under $5000,2017,2,32,0,30
D53,Theft Under $5000,2017,9,40,0,31
D55,Other,2017,15,30,0,15
D11,Other,2018,23,25,0,2
D55,Other,2017,11,15,0,4
D11,Other,2018,3,3,1,0
D55,Other,2017,23,35,0,12
D11,Other,2018,9,9,1,0
D55,Other Criminal Violations - Offensive Weapons,2017,9,10,0,1
D55,Other,2017,10,12,0,2
D11,Other,2018,0,1,0,1
D55,Other Criminal Violations - Offensive Weapons,2017,1,1,1,0
D55,Robbery-Financial,2017,1,2,0,1
D11,Other,2018,14,14,1,0
D55,Other Criminal Violations - Offensive Weapons,2017,3,4,0,1
D55,Robbery-Financial,2017,4,4,1,0
D11,Other,2018,8,9,0,1
D55,Other Criminal Violations - Offensive Weapons,2017,2,5,0,3
D55,Robbery-Financial,2017,2,2,1,0
D11,Other,2018,10,11,0,1
D55,Other Criminal Violations - Offensive Weapons,2017,15,15,1,0
D55,Robbery-Financial,2017,2,2,1,0
D11,Other,2018,9,9,1,0
D55,Other Criminal Violations - Offensive Weapons,2017,5,6,0,1
D55,Robbery-Financial,2017,1,2,0,1
D11,Auto Theft,2018,6,10,0,4
D55,Other Criminal Violations - Offensive Weapons,2017,5,6,0,1
D55,Robbery-Financial,2017,1,1,1,0
D11,Theft Under $5000,2018,201,589,0,388
D11,Auto Theft,2018,4,21,0,17
D55,Other Criminal Violations - Offensive Weapons,2017,6,6,1,0
D55,Robbery-Financial,2017,2,2,1,0
D11,Theft Under $5000,2018,57,354,0,297
D11,Auto Theft,2018,2,22,0,20
D55,Other Criminal Violations - Offensive Weapons,2017,11,12,0,1
D55,Robbery-Other,2017,0,1,0,1
D11,Theft Under $5000,2018,6,47,0,41
D11,Auto Theft,2018,5,25,0,20
D55,Other Criminal Violations - Offensive Weapons,2017,7,8,0,1
D11,Robbery-Other,2018,4,6,0,2
D55,Robbery-Other,2017,3,13,0,10
D55,Robbery-Other,2017,3,5,0,2
D55,Robbery-Other,2017,20,25,0,5
D55,Robbery-Other,2017,4,9,0,5
D55,Robbery-Other,2017,25,33,0,8
D55,Robbery-Other,2017,14,19,0,5
D55,Robbery-Other,2017,11,22,0,11
D55,Robbery-Other,2017,1,2,0,1
D55,Robbery-Other,2017,10,20,0,10
D55,Robbery-Other,2017,9,15,0,6
D55,Robbery-Other,2017,0,3,0,3
D55,Robbery-Other,2017,3,4,0,1
D55,Robbery-Other,2017,21,40,0,19
D55,Robbery-Other,2017,7,17,0,10
D55,Robbery-Other,2017,20,42,0,22
D55,Robbery-Other,2017,4,7,0,3
D55,Robbery-Other,2017,8,16,0,8
D55,Robbery-Other,2017,3,6,0,3
D55,Sexual Violation,2017,0,1,0,1
D55,Sexual Violation,2017,2,7,0,5
D55,Sexual Violation,2017,3,5,0,2
D55,Sexual Violation,2017,0,1,0,1
D55,Sexual Violation,2017,9,13,0,4
D55,Sexual Violation,2017,3,9,0,6
D55,Sexual Violation,2017,14,33,0,19
D55,Sexual Violation,2017,8,20,0,12
D55,Sexual Violation,2017,4,14,0,10
D55,Sexual Violation,2017,1,7,0,6
D55,Sexual Violation,2017,6,11,0,5
D55,Sexual Violation,2017,3,11,0,8
D55,Sexual Violation,2017,7,11,0,4
D55,Sexual Violation,2017,2,6,0,4
D55,Sexual Violation,2017,13,23,0,10
D55,Sexual Violation,2017,4,8,0,4
D55,Sexual Violation,2017,8,11,0,3
D55,Sexual Violation,2017,4,7,0,3
D55,Sexual Violation,2017,7,7,1,0
D55,Sexual Violation,2017,3,5,0,2
D11,Break & Enter-House,2018,1,3,0,2
D11,Sexual Violation,2018,8,12,0,4
D11,Auto Theft,2018,4,24,0,20
D55,Other,2017,0,1,0,1
D11,Break & Enter-Other,2018,1,5,0,4
D11,Theft Under $5000,2018,25,54,0,29
D55,Other,2017,1,1,1,0
D11,Sexual Violation,2018,5,15,0,10
D55,Other,2017,1,1,1,0
D11,Auto Theft,2018,3,16,0,13
D11,Break & Enter-Other,2018,0,5,0,5
D11,Sexual Violation,2018,9,18,0,9
D55,Other,2017,3,3,1,0
D11,Theft Under $5000,2018,0,3,0,3
D55,Other,2017,2,2,1,0
D11,Sexual Violation,2018,4,7,0,3
D11,Auto Theft,2018,2,9,0,7
D11,Break & Enter-Other,2018,1,6,0,5
D11,Theft Under $5000,2018,25,37,0,12
D55,Other,2017,1,1,1,0
D11,Sexual Violation,2018,6,11,0,5
D11,Auto Theft,2018,0,2,0,2
D11,Break & Enter-Other,2018,0,7,0,7
D11,Theft Under $5000,2018,86,462,0,376
D55,Other,2017,1,1,1,0
D11,Sexual Violation,2018,4,8,0,4
D11,Auto Theft,2018,3,22,0,19
D11,Break & Enter-Other,2018,5,8,0,3
D11,Theft Under $5000,2018,48,211,0,163
NSA,Other,2017,1,1,1,0
D11,Sexual Violation,2018,4,6,0,2
D11,Auto Theft,2018,2,27,0,25
D11,Break & Enter-Other,2018,0,13,0,13
D11,Theft Under $5000,2018,3,13,0,10
NSA,Other,2017,3,4,0,1
D11,Sexual Violation,2018,5,14,0,9
D11,Auto Theft,2018,1,6,0,5
D11,Break & Enter-Other,2018,0,3,0,3
D11,Theft Under $5000,2018,8,44,0,36
NSA,Other,2017,1,1,1,0
D11,Sexual Violation,2018,2,5,0,3
D11,Auto Theft,2018,0,6,0,6
D11,Fraud,2018,7,37,0,30
D11,Assault,2018,43,79,0,36
NSA,Other,2017,1,1,1,0
D11,Sexual Violation,2018,0,1,0,1
D11,Break & Enter-Apartment,2018,1,1,1,0
D11,Fraud,2018,5,43,0,38
D11,Assault,2018,56,93,0,37
D11,Sexual Violation,2018,1,7,0,6
NSA,Other,2017,109,118,0,9
D11,Other,2018,1,1,1,0
D11,Fraud,2018,4,58,0,54
D11,Assault,2018,50,75,0,25
NSA,Other,2017,1,1,1,0
D11,Other,2018,3,3,1,0
D11,Break & Enter-Apartment,2018,6,36,0,30
D11,Assault,2018,60,94,0,34
D11,Fraud,2018,4,37,0,33
NSA,Auto Theft,2017,0,33,0,33
D11,Other,2018,16,18,0,2
D11,Break & Enter-Apartment,2018,1,11,0,10
D11,Assault,2018,80,120,0,40
D11,Fraud,2018,11,58,0,47
NSA,Break & Enter-Apartment,2017,1,8,0,7
D11,Other,2018,16,16,1,0
D11,Break & Enter-Apartment,2018,8,14,0,6
D11,Assault,2018,15,22,0,7
D11,Fraud,2018,2,14,0,12
NSA,Break & Enter-Commercial,2017,1,5,0,4
D11,Other,2018,3,4,0,1
D11,Break & Enter-Apartment,2018,7,15,0,8
D11,Assault,2018,9,16,0,7
D11,Fraud,2018,4,22,0,18
NSA,Break & Enter-House,2017,4,11,0,7
D11,Break & Enter-Apartment,2018,0,1,0,1
D11,Assault,2018,0,1,0,1
D11,Fraud,2018,0,1,0,1
D11,Other,2018,2,2,1,0
NSA,Break & Enter-Other,2017,3,4,0,1
D11,Break & Enter-Apartment,2018,1,5,0,4
D11,Assault,2018,4,5,0,1
D11,Other,2018,6,6,1,0
D11,Fraud,2018,2,12,0,10
NSA,Fraud,2017,0,1,0,1
D11,Break & Enter-Apartment,2018,6,22,0,16
D11,Assault,2018,48,79,0,31
D11,Other,2018,2,2,1,0
D11,Fraud,2018,9,60,0,51
NSA,Fraud,2017,0,1,0,1
D11,Break & Enter-Apartment,2018,0,3,0,3
D11,Assault,2018,16,29,0,13
D11,Other,2018,6,6,1,0
D11,Fraud,2018,2,29,0,27
NSA,Fraud,2017,0,1,0,1
D11,Break & Enter-Apartment,2018,5,9,0,4
D11,Assault,2018,8,20,0,12
D11,Assault,2018,37,61,0,24
D11,Attempt Murder,2018,1,1,1,0
D11,Other,2018,6,15,0,9
D11,Other,2018,15,28,0,13
D11,Other,2018,13,25,0,12
D11,Other,2018,15,23,0,8
D11,Other,2018,12,23,0,11
D11,Other,2018,6,10,0,4
D11,Other,2018,2,8,0,6
D11,Other,2018,0,2,0,2
D11,Other,2018,7,21,0,14
D11,Other,2018,4,11,0,7
D11,Other,2018,1,2,0,1
D11,Other,2018,7,19,0,12
D11,Robbery-Financial,2018,3,3,1,0
D11,Robbery-Financial,2018,1,1,1,0
D11,Robbery-Financial,2018,2,2,1,0
D11,Robbery-Financial,2018,1,1,1,0
D11,Robbery-Other,2018,5,9,0,4
D11,Robbery-Other,2018,10,23,0,13
D11,Robbery-Other,2018,2,8,0,6
D11,Robbery-Other,2018,9,20,0,11
D11,Robbery-Other,2018,1,14,0,13
D11,Robbery-Other,2018,1,1,1,0
D11,Robbery-Other,2018,0,2,0,2
D11,Robbery-Other,2018,8,22,0,14
D11,Robbery-Other,2018,7,15,0,8
D11,Robbery-Other,2018,1,3,0,2
D11,Fraud,2018,1,5,0,4
D11,Other,2018,4,5,0,1
NSA,Fraud,2017,0,1,0,1
D11,Break & Enter-Commercial,2018,3,13,0,10
D11,Fraud,2018,2,17,0,15
D11,Other,2018,51,63,0,12
NSA,Fraud,2017,0,1,0,1
D11,Break & Enter-Commercial,2018,1,3,0,2
D11,Other,2018,18,64,0,46
D11,Other,2018,49,59,0,10
NSA,Fraud,2017,0,1,0,1
D11,Break & Enter-Commercial,2018,3,12,0,9
D11,Other,2018,14,63,0,49
D11,Other,2018,51,53,0,2
NSA,Fraud,2017,0,2,0,2
D11,Break & Enter-Commercial,2018,4,18,0,14
D11,Other,2018,30,81,0,51
NSA,Fraud,2017,37,223,0,186
D11,Other,2018,93,101,0,8
D11,Other,2018,27,98,0,71
D11,Break & Enter-Commercial,2018,9,29,0,20
NSA,Fraud,2017,0,1,0,1
D11,Other,2018,88,101,0,13
D11,Other,2018,49,146,0,97
D11,Break & Enter-Commercial,2018,0,2,0,2
NSA,Fraud,2017,0,1,0,1
D11,Other,2018,11,12,0,1
D11,Other,2018,3,24,0,21
D11,Break & Enter-Commercial,2018,4,10,0,6
NSA,Fraud,2017,0,1,0,1
D11,Other,2018,14,16,0,2
D11,Other,2018,3,17,0,14
D11,Break & Enter-Commercial,2018,3,11,0,8
NSA,Fraud,2017,0,1,0,1
D11,Other,2018,5,5,1,0
D11,Other,2018,1,2,0,1
D11,Break & Enter-Commercial,2018,1,9,0,8
NSA,Fraud,2017,0,1,0,1
D11,Other,2018,3,4,0,1
D11,Other,2018,3,7,0,4
D11,Break & Enter-Commercial,2018,1,1,1,0
NSA,Other,2017,2,3,0,1
D11,Other,2018,63,72,0,9
D11,Other,2018,22,88,0,66
D11,Break & Enter-Commercial,2018,0,5,0,5
NSA,Other,2017,50,147,0,97
D11,Other,2018,7,10,0,3
D11,Other,2018,9,29,0,20
D11,Break & Enter-House,2018,2,4,0,2
NSA,Other,2017,0,1,0,1
D11,Other,2018,11,11,1,0
D11,Other,2018,3,10,0,7
D11,Break & Enter-House,2018,4,18,0,14
NSA,Theft Over $5000,2017,0,1,0,1
D11,Other,2018,54,58,0,4
D11,Other,2018,15,44,0,29
D11,Break & Enter-House,2018,0,17,0,17
NSA,Theft Over $5000,2017,4,15,0,11
D11,Other Criminal Violations - Offensive Weapons,2018,8,10,0,2
D11,Theft Over $5000,2018,4,8,0,4
D11,Break & Enter-House,2018,6,18,0,12
NSA,Theft Over $5000,2017,1,1,1,0
D11,Other Criminal Violations - Offensive Weapons,2018,7,8,0,1
D11,Theft Over $5000,2018,2,4,0,2
D11,Break & Enter-House,2018,4,25,0,21
D11,Break & Enter-House,2018,1,7,0,6
D11,Break & Enter-House,2018,0,3,0,3
D11,Break & Enter-House,2018,5,29,0,24
D11,Break & Enter-House,2018,1,7,0,6
NSA,Theft Under $5000,2017,1,1,1,0
D11,Other Criminal Violations - Offensive Weapons,2018,8,8,1,0
D11,Theft Over $5000,2018,2,3,0,1
NSA,Theft Under $5000,2017,0,1,0,1
D11,Other Criminal Violations - Offensive Weapons,2018,3,3,1,0
D11,Theft Over $5000,2018,2,4,0,2
NSA,Theft Under $5000,2017,0,1,0,1
D11,Other Criminal Violations - Offensive Weapons,2018,10,11,0,1
D11,Theft Over $5000,2018,2,6,0,4
D11,Other Criminal Violations - Offensive Weapons,2018,2,2,1,0
D11,Theft Over $5000,2018,1,2,0,1
D11,Other Criminal Violations - Offensive Weapons,2018,3,3,1,0
D11,Theft Over $5000,2018,1,3,0,2
D11,Other Criminal Violations - Offensive Weapons,2018,7,9,0,2
D11,Theft Over $5000,2018,1,1,1,0
D11,Other Criminal Violations - Offensive Weapons,2018,1,1,1,0
D11,Theft Over $5000,2018,0,2,0,2
D11,Other Criminal Violations - Offensive Weapons,2018,5,6,0,1
D11,Theft Over $5000,2018,1,5,0,4
D11,Other Criminal Violations - Offensive Weapons,2018,5,6,0,1
D11,Theft Over $5000,2018,1,2,0,1
D11,Other,2018,5,5,1,0
D11,Theft Over $5000,2018,0,1,0,1
D11,Other,2018,2,2,1,0
D11,Theft Under $5000,2018,0,1,0,1
D11,Other,2018,1,1,1,0
D11,Theft Under $5000,2018,215,375,0,160
D11,Other,2018,0,1,0,1
D11,Theft Under $5000,2018,91,392,0,301
D11,Theft Under $5000,2018,70,206,0,136
D55,Other,2017,2,2,1,0
D55,Other,2017,3,3,1,0
D55,Other,2017,8,8,1,0
D55,Other,2017,3,3,1,0
D55,Other,2017,1,1,1,0
D55,Other,2017,4,4,1,0
D55,Other,2017,6,6,1,0
D55,Other,2017,8,8,1,0
D55,Other,2017,12,13,0,1
D55,Other,2017,2,2,1,0
D55,Other,2017,15,16,0,1
D55,Other,2017,9,9,1,0
D55,Other,2017,22,22,1,0
D55,Other,2017,2,2,1,0
D55,Other,2017,24,24,1,0
D55,Other,2017,1,2,0,1
D55,Other,2017,20,21,0,1
D55,Other,2017,3,3,1,0
D55,Other,2017,5,7,0,2
D55,Other,2017,6,6,1,0
D55,Other,2017,39,46,0,7
D55,Other,2017,20,26,0,6
D55,Other,2017,2,2,1,0
D55,Other,2017,36,39,0,3
D55,Other,2017,21,25,0,4
D55,Other,2017,106,121,0,15
D55,Other,2017,51,56,0,5
D55,Other,2017,43,49,0,6
D55,Other,2017,67,67,1,0
D55,Other,2017,31,33,0,2
D55,Other,2017,57,64,0,7
D55,Other,2017,2,2,1,0
D55,Other,2017,27,30,0,3
D55,Other,2017,38,40,0,2
D55,Other,2017,130,149,0,19
D55,Other,2017,58,66,0,8
D55,Other,2017,63,70,0,7
D55,Other,2017,26,27,0,1
D55,Other,2017,81,90,0,9
D55,Other,2017,30,34,0,4
D55,Other,2017,23,23,1,0
D55,Other Criminal Violations - Offensive Weapons,2017,4,5,0,1
D55,Other Criminal Violations - Offensive Weapons,2017,3,3,1,0
D55,Other Criminal Violations - Offensive Weapons,2017,9,9,1,0
D55,Other Criminal Violations - Offensive Weapons,2017,4,4,1,0
D55,Other Criminal Violations - Offensive Weapons,2017,19,19,1,0
D55,Other Criminal Violations - Offensive Weapons,2017,7,10,0,3
D55,Other Criminal Violations - Offensive Weapons,2017,6,6,1,0
D55,Other Criminal Violations - Offensive Weapons,2017,0,1,0,1
D55,Other Criminal Violations - Offensive Weapons,2017,3,3,1,0
NSA,Theft Under $5000,2017,47,250,0,203
NSA,Theft Under $5000,2017,0,1,0,1
NSA,Assault,2017,1,3,0,2
NSA,Assault,2017,0,1,0,1
NSA,Assault,2017,0,1,0,1
NSA,Assault,2017,1,2,0,1
NSA,Assault,2017,98,213,0,115
NSA,Assault,2017,0,1,0,1
NSA,Assault,2017,0,2,0,2
NSA,Attempt Murder,2017,1,1,1,0
NSA,Other,2017,1,1,1,0
NSA,Other,2017,0,1,0,1
NSA,Other,2017,25,54,0,29
NSA,Robbery-Financial,2017,10,11,0,1
NSA,Robbery-Other,2017,1,1,1,0
NSA,Robbery-Other,2017,17,47,0,30
NSA,Sexual Violation,2017,1,2,0,1
NSA,Sexual Violation,2017,0,2,0,2
NSA,Sexual Violation,2017,0,1,0,1
NSA,Sexual Violation,2017,0,1,0,1
NSA,Sexual Violation,2017,0,1,0,1
NSA,Sexual Violation,2017,1,1,1,0
NSA,Sexual Violation,2017,0,1,0,1
NSA,Sexual Violation,2017,26,119,0,93
NSA,Sexual Violation,2017,0,1,0,1
NSA,Sexual Violation,2017,0,1,0,1
NSA,Sexual Violation,2017,1,2,0,1
NSA,Sexual Violation,2017,0,1,0,1
NSA,Sexual Violation,2017,0,2,0,2
NSA,Sexual Violation,2017,0,1,0,1
NSA,Other,2017,77,80,0,3
NSA,Other,2017,1,1,1,0
NSA,Other,2017,2,2,1,0
NSA,Other,2017,5,5,1,0
NSA,Other,2017,1,1,1,0
NSA,Other,2017,1,1,1,0
NSA,Other,2017,1,1,1,0
NSA,Other,2017,2,2,1,0
NSA,Other,2017,203,230,0,27
NSA,Other,2017,1,1,1,0
NSA,Other,2017,0,1,0,1
NSA,Other,2017,2,2,1,0
NSA,Other Criminal Violations - Offensive Weapons,2017,35,37,0,2
NSA,Other,2017,1,1,1,0
NSA,Other,2017,8,15,0,7
D11,Other,2018,1,1,1,0
D11,Other,2018,9,9,1,0
D11,Other,2018,1,3,0,2
D11,Other,2018,4,4,1,0
D11,Other,2018,9,10,0,1
D12,Other,2018,2,2,1,0
D13,Other,2018,26,28,0,2
D13,Break & Enter-House,2018,1,4,0,3
D13,Other,2018,3,3,1,0
D13,Other,2018,3,3,1,0
D13,Other,2018,20,20,1,0
D13,Break & Enter-House,2018,1,5,0,4
D12,Other,2018,17,19,0,2
D12,Break & Enter-House,2018,3,6,0,3
D13,Other,2018,1,1,1,0
D13,Break & Enter-House,2018,1,10,0,9
D13,Theft Over $5000,2018,1,4,0,3
D12,Other,2018,13,13,1,0
D12,Break & Enter-House,2018,0,2,0,2
D12,Theft Under $5000,2018,23,144,0,121
D13,Other,2018,4,4,1,0
D13,Break & Enter-House,2018,9,20,0,11
D13,Theft Over $5000,2018,2,2,1,0
D12,Other,2018,1,1,1,0
D12,Break & Enter-Other,2018,1,3,0,2
D13,Other,2018,14,14,1,0
D12,Sexual Violation,2018,9,17,0,8
D12,Theft Under $5000,2018,6,62,0,56
D13,Break & Enter-House,2018,6,22,0,16
D13,Theft Over $5000,2018,2,7,0,5
D12,Other,2018,16,17,0,1
D12,Break & Enter-Other,2018,4,4,1,0
D13,Other,2018,1,1,1,0
D12,Sexual Violation,2018,2,4,0,2
D12,Theft Under $5000,2018,25,156,0,131
D13,Break & Enter-House,2018,0,15,0,15
D13,Theft Over $5000,2018,0,1,0,1
D12,Other,2018,5,5,1,0
D12,Break & Enter-Other,2018,1,8,0,7
D13,Other,2018,0,2,0,2
D12,Sexual Violation,2018,2,9,0,7
D12,Theft Under $5000,2018,5,29,0,24
D13,Break & Enter-House,2018,5,14,0,9
D13,Theft Over $5000,2018,0,2,0,2
D12,Other,2018,21,21,1,0
D12,Break & Enter-Other,2018,0,1,0,1
D13,Other,2018,30,31,0,1
D12,Sexual Violation,2018,1,2,0,1
D12,Assault,2018,33,42,0,9
D13,Robbery-Financial,2018,2,2,1,0
D13,Break & Enter-House,2018,0,4,0,4
D13,Break & Enter-House,2018,2,4,0,2
D13,Break & Enter-House,2018,1,11,0,10
D13,Break & Enter-House,2018,1,10,0,9
D13,Break & Enter-Other,2018,2,4,0,2
D13,Break & Enter-Other,2018,1,3,0,2
D13,Break & Enter-Other,2018,1,2,0,1
D13,Break & Enter-Other,2018,0,4,0,4
D13,Break & Enter-Other,2018,1,4,0,3
D13,Break & Enter-Other,2018,0,1,0,1
D13,Break & Enter-Other,2018,1,2,0,1
D13,Break & Enter-Other,2018,0,4,0,4
D13,Break & Enter-Other,2018,0,3,0,3
D13,Fraud,2018,0,1,0,1
D13,Fraud,2018,5,41,0,36
D13,Fraud,2018,3,26,0,23
D13,Fraud,2018,2,17,0,15
D13,Fraud,2018,15,42,0,27
D13,Fraud,2018,3,18,0,15
D13,Fraud,2018,9,17,0,8
D13,Fraud,2018,1,22,0,21
D13,Fraud,2018,4,39,0,35
D13,Fraud,2018,4,11,0,7
D13,Fraud,2018,6,45,0,39
D13,Fraud,2018,13,39,0,26
D13,Fraud,2018,4,24,0,20
D13,Other,2018,29,71,0,42
D13,Other,2018,7,24,0,17
D13,Other,2018,9,30,0,21
D13,Other,2018,22,80,0,58
D13,Other,2018,6,19,0,13
D13,Other,2018,2,11,0,9
D13,Other,2018,3,18,0,15
D13,Other,2018,17,66,0,49
D13,Other,2018,9,46,0,37
D13,Other,2018,1,1,1,0
D13,Other,2018,25,91,0,66
D13,Other,2018,33,82,0,49
D13,Other,2018,17,40,0,23
D13,Theft Over $5000,2018,3,4,0,1
D13,Theft Over $5000,2018,0,1,0,1
D13,Theft Over $5000,2018,1,2,0,1
D13,Theft Over $5000,2018,1,5,0,4
D12,Other,2018,14,15,0,1
D13,Robbery-Financial,2018,2,2,1,0
D13,Robbery-Financial,2018,1,1,1,0
D13,Robbery-Other,2018,8,19,0,11
D13,Other,2018,9,9,1,0
D12,Sexual Violation,2018,8,15,0,7
D12,Break & Enter-Other,2018,0,1,0,1
D13,Theft Over $5000,2018,1,2,0,1
D12,Other,2018,28,33,0,5
D13,Robbery-Other,2018,2,8,0,6
D12,Sexual Violation,2018,4,10,0,6
D13,Other,2018,13,15,0,2
D12,Break & Enter-Other,2018,0,2,0,2
D13,Auto Theft,2018,6,36,0,30
D12,Assault,2018,63,95,0,32
D13,Robbery-Other,2018,2,5,0,3
D12,Break & Enter-Other,2018,0,4,0,4
D12,Sexual Violation,2018,12,32,0,20
D13,Auto Theft,2018,1,11,0,10
D12,Assault,2018,23,31,0,8
D13,Theft Over $5000,2018,0,2,0,2
D12,Other,2018,6,8,0,2
D13,Robbery-Other,2018,6,13,0,7
D12,Fraud,2018,3,31,0,28
D12,Sexual Violation,2018,3,9,0,6
D13,Auto Theft,2018,1,8,0,7
D12,Assault,2018,43,60,0,17
D13,Theft Under $5000,2018,35,122,0,87
D12,Other,2018,37,37,1,0
D13,Robbery-Other,2018,0,1,0,1
D13,Robbery-Other,2018,4,5,0,1
D13,Robbery-Other,2018,0,3,0,3
D13,Robbery-Other,2018,3,3,1,0
D13,Robbery-Other,2018,0,1,0,1
D13,Robbery-Other,2018,5,13,0,8
D13,Robbery-Other,2018,8,17,0,9
D13,Robbery-Other,2018,5,22,0,17
D13,Sexual Violation,2018,8,11,0,3
D13,Sexual Violation,2018,6,8,0,2
D13,Sexual Violation,2018,3,7,0,4
D13,Sexual Violation,2018,2,7,0,5
D13,Sexual Violation,2018,2,3,0,1
D13,Sexual Violation,2018,1,2,0,1
D13,Sexual Violation,2018,3,4,0,1
D13,Sexual Violation,2018,9,13,0,4
D13,Sexual Violation,2018,1,2,0,1
D13,Sexual Violation,2018,2,2,1,0
D13,Sexual Violation,2018,10,17,0,7
D13,Sexual Violation,2018,4,10,0,6
D13,Sexual Violation,2018,19,21,0,2
D13,Other,2018,11,11,1,0
D13,Other,2018,5,5,1,0
D13,Other,2018,1,1,1,0
D13,Other,2018,11,12,0,1
D13,Other,2018,4,4,1,0
D13,Other,2018,8,8,1,0
D13,Other,2018,4,4,1,0
D13,Other,2018,18,18,1,0
D13,Other,2018,7,7,1,0
D13,Other,2018,6,6,1,0
D13,Other,2018,44,48,0,4
D13,Other,2018,15,22,0,7
D13,Other,2018,66,67,0,1
D13,Other,2018,38,41,0,3
D13,Other,2018,1,1,1,0
D13,Other,2018,10,11,0,1
D13,Other,2018,8,10,0,2
D13,Other,2018,19,19,1,0
D13,Other,2018,23,25,0,2
D13,Other,2018,6,10,0,4
D13,Other,2018,4,4,1,0
D13,Other,2018,88,100,0,12
D12,Fraud,2018,19,64,0,45
D12,Other,2018,1,1,1,0
D13,Theft Under $5000,2018,23,57,0,34
D12,Auto Theft,2018,4,11,0,7
D13,Auto Theft,2018,1,11,0,10
D12,Assault,2018,16,22,0,6
D12,Fraud,2018,2,9,0,7
D12,Auto Theft,2018,22,48,0,26
D13,Theft Under $5000,2018,95,242,0,147
D13,Auto Theft,2018,6,20,0,14
D12,Other,2018,8,8,1,0
D12,Fraud,2018,11,33,0,22
D13,Auto Theft,2018,1,16,0,15
D12,Assault,2018,59,83,0,24
D12,Auto Theft,2018,1,14,0,13
D13,Theft Under $5000,2018,18,113,0,95
D12,Other,2018,24,25,0,1
D12,Fraud,2018,3,17,0,14
D13,Auto Theft,2018,2,13,0,11
D12,Assault,2018,1,1,1,0
D12,Auto Theft,2018,12,23,0,11
D13,Theft Under $5000,2018,0,39,0,39
D12,Other,2018,6,6,1,0
D12,Fraud,2018,9,37,0,28
D13,Auto Theft,2018,2,22,0,20
D12,Assault,2018,14,24,0,10
D12,Auto Theft,2018,8,13,0,5
D13,Theft Under $5000,2018,5,31,0,26
D12,Other,2018,7,7,1,0
D12,Fraud,2018,12,34,0,22
D12,Assault,2018,80,110,0,30
D13,Auto Theft,2018,1,5,0,4
D13,Theft Under $5000,2018,53,138,0,85
D12,Other,2018,3,3,1,0
D12,Auto Theft,2018,7,16,0,9
D12,Fraud,2018,17,51,0,34
D13,Theft Under $5000,2018,13,124,0,111
D12,Other,2018,13,13,1,0
D12,Assault,2018,46,61,0,15
D13,Auto Theft,2018,7,31,0,24
D12,Auto Theft,2018,0,1,0,1
D12,Fraud,2018,6,17,0,11
D13,Theft Under $5000,2018,3,68,0,65
D12,Other,2018,4,4,1,0
D12,Assault,2018,93,137,0,44
D13,Auto Theft,2018,3,21,0,18
D12,Auto Theft,2018,8,23,0,15
D12,Fraud,2018,23,85,0,62
D13,Theft Under $5000,2018,2,5,0,3
D12,Other,2018,6,7,0,1
D12,Assault,2018,12,16,0,4
D13,Auto Theft,2018,4,25,0,21
D12,Auto Theft,2018,21,53,0,32
D12,Fraud,2018,5,15,0,10
D13,Theft Under $5000,2018,26,130,0,104
D12,Other,2018,3,3,1,0
D12,Attempt Murder,2018,1,1,1,0
D13,Break & Enter-Apartment,2018,3,13,0,10
D12,Auto Theft,2018,5,15,0,10
D12,Other,2018,20,43,0,23
D13,Theft Under $5000,2018,89,268,0,179
D12,Other,2018,12,13,0,1
D12,Attempt Murder,2018,0,1,0,1
D13,Break & Enter-Apartment,2018,1,2,0,1
D12,Auto Theft,2018,16,56,0,40
D12,Other,2018,36,89,0,53
D13,Theft Under $5000,2018,28,105,0,77
D12,Other,2018,4,4,1,0
D12,Attempt Murder,2018,2,2,1,0
D13,Break & Enter-Apartment,2018,1,3,0,2
D12,Auto Theft,2018,3,8,0,5
D12,Other,2018,11,22,0,11
D13,Assault,2018,49,71,0,22
D12,Other,2018,66,68,0,2
D12,Attempt Murder,2018,3,3,1,0
D13,Break & Enter-Apartment,2018,1,6,0,5
D12,Break & Enter-Apartment,2018,4,7,0,3
D12,Other,2018,15,40,0,25
D12,Attempt Murder,2018,4,5,0,1
D13,Assault,2018,34,52,0,18
D12,Other,2018,77,82,0,5
D13,Break & Enter-Apartment,2018,0,5,0,5
D12,Break & Enter-Apartment,2018,2,11,0,9
D12,Other,2018,7,24,0,17
D12,Attempt Murder,2018,2,2,1,0
D12,Other,2018,2,2,1,0
D13,Break & Enter-Apartment,2018,2,5,0,3
D12,Break & Enter-Apartment,2018,0,1,0,1
D13,Assault,2018,20,33,0,13
D12,Other,2018,32,83,0,51
D12,Attempt Murder,2018,1,1,1,0
D12,Other,2018,16,22,0,6
D13,Break & Enter-Apartment,2018,1,7,0,6
D12,Break & Enter-Apartment,2018,1,4,0,3
D13,Assault,2018,53,84,0,31
D12,Other,2018,1,1,1,0
D12,Other,2018,11,24,0,13
D12,Other,2018,29,32,0,3
D13,Break & Enter-Apartment,2018,0,13,0,13
D12,Break & Enter-Apartment,2018,3,10,0,7
D13,Assault,2018,11,15,0,4
D12,Other,2018,12,28,0,16
D12,Other,2018,18,27,0,9
D12,Other,2018,16,17,0,1
D13,Break & Enter-Apartment,2018,1,1,1,0
D12,Break & Enter-Apartment,2018,0,1,0,1
D13,Assault,2018,8,15,0,7
D12,Other,2018,31,76,0,45
D12,Other,2018,1,1,1,0
D12,Other,2018,45,50,0,5
D13,Break & Enter-Apartment,2018,2,6,0,4
D12,Break & Enter-Apartment,2018,2,5,0,3
D13,Assault,2018,7,10,0,3
D12,Other,2018,6,22,0,16
D12,Other,2018,5,13,0,8
D12,Other,2018,26,26,1,0
D13,Break & Enter-Apartment,2018,2,4,0,2
D12,Break & Enter-Apartment,2018,1,1,1,0
D13,Assault,2018,34,42,0,8
D12,Other,2018,55,98,0,43
D12,Other,2018,8,10,0,2
D12,Other,2018,27,30,0,3
D13,Break & Enter-Apartment,2018,0,1,0,1
D12,Other,2018,6,16,0,10
D12,Break & Enter-Apartment,2018,7,17,0,10
D12,Theft Over $5000,2018,2,11,0,9
D13,Assault,2018,17,21,0,4
D13,Break & Enter-Commercial,2018,4,9,0,5
D12,Other,2018,58,62,0,4
D13,Assault,2018,1,4,0,3
D12,Theft Over $5000,2018,0,2,0,2
D12,Break & Enter-Commercial,2018,13,15,0,2
D12,Other,2018,10,16,0,6
D12,Theft Over $5000,2018,1,3,0,2
D13,Assault,2018,76,122,0,46
D13,Break & Enter-Commercial,2018,1,3,0,2
D12,Other,2018,30,33,0,3
D12,Other,2018,1,1,1,0
D12,Break & Enter-Commercial,2018,2,8,0,6
D12,Theft Over $5000,2018,1,4,0,3
D13,Assault,2018,48,68,0,20
D13,Break & Enter-Commercial,2018,0,1,0,1
D12,Other,2018,113,120,0,7
D12,Other,2018,2,4,0,2
D12,Break & Enter-Commercial,2018,0,2,0,2
D12,Theft Over $5000,2018,0,1,0,1
D13,Assault,2018,28,45,0,17
D13,Break & Enter-Commercial,2018,5,13,0,8
D12,Other,2018,14,15,0,1
D12,Other,2018,8,20,0,12
D12,Break & Enter-Commercial,2018,7,15,0,8
D13,Attempt Murder,2018,1,1,1,0
D13,Break & Enter-Commercial,2018,0,1,0,1
D12,Theft Over $5000,2018,0,2,0,2
D12,Other Criminal Violations - Offensive Weapons,2018,8,10,0,2
D12,Other,2018,6,14,0,8
D12,Break & Enter-Commercial,2018,0,1,0,1
D13,Attempt Murder,2018,3,4,0,1
D13,Break & Enter-Commercial,2018,2,4,0,2
D12,Theft Over $5000,2018,5,13,0,8
D12,Other Criminal Violations - Offensive Weapons,2018,14,14,1,0
D12,Other,2018,23,35,0,12
D12,Break & Enter-Commercial,2018,6,7,0,1
D13,Attempt Murder,2018,2,3,0,1
D13,Break & Enter-Commercial,2018,0,1,0,1
D12,Theft Over $5000,2018,0,2,0,2
D12,Other,2018,5,7,0,2
D12,Other Criminal Violations - Offensive Weapons,2018,0,1,0,1
D12,Robbery-Financial,2018,1,2,0,1
D13,Other,2018,10,14,0,4
D12,Break & Enter-Commercial,2018,2,5,0,3
D13,Break & Enter-Commercial,2018,0,3,0,3
D12,Robbery-Other,2018,10,12,0,2
D13,Other,2018,10,14,0,4
D12,Other Criminal Violations - Offensive Weapons,2018,4,4,1,0
D12,Theft Over $5000,2018,4,8,0,4
D12,Break & Enter-Commercial,2018,3,11,0,8
D13,Other,2018,5,9,0,4
D12,Other Criminal Violations - Offensive Weapons,2018,1,2,0,1
D12,Robbery-Other,2018,7,15,0,8
D13,Break & Enter-Commercial,2018,1,9,0,8
D12,Theft Over $5000,2018,1,1,1,0
D12,Break & Enter-Commercial,2018,3,13,0,10
D13,Other,2018,15,28,0,13
D12,Other Criminal Violations - Offensive Weapons,2018,11,13,0,2
D12,Robbery-Other,2018,0,4,0,4
D13,Break & Enter-Commercial,2018,3,7,0,4
D12,Theft Under $5000,2018,23,65,0,42
D12,Break & Enter-Commercial,2018,0,4,0,4
D13,Other,2018,1,3,0,2
D12,Other Criminal Violations - Offensive Weapons,2018,4,4,1,0
D12,Robbery-Other,2018,9,16,0,7
D13,Break & Enter-Commercial,2018,2,11,0,9
D12,Theft Under $5000,2018,121,304,0,183
D12,Break & Enter-House,2018,4,10,0,6
D13,Other,2018,1,6,0,5
D12,Other Criminal Violations - Offensive Weapons,2018,16,19,0,3
D12,Robbery-Other,2018,2,3,0,1
D13,Break & Enter-Commercial,2018,3,9,0,6
D12,Theft Under $5000,2018,68,118,0,50
D12,Break & Enter-House,2018,0,2,0,2
D13,Other,2018,2,5,0,3
D12,Other Criminal Violations - Offensive Weapons,2018,8,8,1,0
D12,Robbery-Other,2018,3,10,0,7
D13,Break & Enter-House,2018,1,7,0,6
D12,Theft Under $5000,2018,22,86,0,64
D13,Other,2018,5,9,0,4
D12,Break & Enter-House,2018,0,4,0,4
D12,Other Criminal Violations - Offensive Weapons,2018,13,16,0,3
D12,Robbery-Other,2018,1,6,0,5
D12,Theft Under $5000,2018,3,43,0,40
D12,Break & Enter-House,2018,0,5,0,5
D13,Other,2018,6,9,0,3
D12,Robbery-Other,2018,7,17,0,10
D12,Other Criminal Violations - Offensive Weapons,2018,1,1,1,0
D12,Theft Under $5000,2018,12,73,0,61
D12,Break & Enter-House,2018,3,4,0,1
D13,Other,2018,13,22,0,9
D12,Robbery-Other,2018,2,8,0,6
D12,Other,2018,2,3,0,1
D12,Theft Under $5000,2018,0,2,0,2
D12,Break & Enter-House,2018,4,4,1,0
D13,Other,2018,7,17,0,10
D12,Robbery-Other,2018,17,31,0,14
D12,Other,2018,2,2,1,0
D12,Theft Under $5000,2018,144,358,0,214
D12,Break & Enter-House,2018,1,6,0,5
D13,Other,2018,5,15,0,10
D12,Robbery-Other,2018,6,17,0,11
D12,Other,2018,2,2,1,0
D12,Break & Enter-House,2018,0,8,0,8
D13,Robbery-Financial,2018,4,4,1,0
D12,Sexual Violation,2018,5,11,0,6
D12,Other,2018,4,4,1,0
D13,Robbery-Financial,2018,4,4,1,0
D12,Sexual Violation,2018,8,14,0,6
D12,Other,2018,1,1,1,0
D12,Sexual Violation,2018,4,4,1,0
D12,Other,2018,2,2,1,0
D12,Other,2018,3,5,0,2
D14,Fraud,2018,27,82,0,55
D14,Fraud,2018,19,63,0,44
D14,Fraud,2018,1,2,0,1
D14,Fraud,2018,25,60,0,35
D14,Fraud,2018,31,83,0,52
D14,Fraud,2018,31,88,0,57
D13,Other,2018,59,66,0,7
D14,Assault,2018,54,80,0,26
D22,Fraud,2018,1,32,0,31
D14,Fraud,2018,21,60,0,39
D14,Fraud,2018,51,144,0,93
D14,Fraud,2018,24,77,0,53
D14,Other,2018,25,97,0,72
D14,Other,2018,17,108,0,91
D14,Other,2018,7,36,0,29
D14,Other,2018,52,109,0,57
D14,Other,2018,14,42,0,28
D14,Other,2018,61,175,0,114
D14,Other,2018,15,58,0,43
D14,Other,2018,0,2,0,2
D14,Other,2018,23,91,0,68
D14,Other,2018,49,136,0,87
D14,Other,2018,34,112,0,78
D14,Other,2018,18,62,0,44
D14,Other,2018,34,92,0,58
D14,Other,2018,31,81,0,50
D14,Theft Over $5000,2018,0,6,0,6
D14,Theft Over $5000,2018,0,4,0,4
D14,Theft Over $5000,2018,0,1,0,1
D14,Theft Over $5000,2018,1,8,0,7
D14,Theft Over $5000,2018,1,5,0,4
D14,Theft Over $5000,2018,1,12,0,11
D14,Theft Over $5000,2018,3,8,0,5
D14,Theft Over $5000,2018,5,11,0,6
D14,Theft Over $5000,2018,2,9,0,7
D14,Theft Over $5000,2018,0,8,0,8
D14,Theft Over $5000,2018,1,11,0,10
D14,Theft Over $5000,2018,4,10,0,6
D14,Theft Over $5000,2018,4,7,0,3
D14,Theft Under $5000,2018,69,380,0,311
D14,Theft Under $5000,2018,31,205,0,174
D14,Theft Under $5000,2018,8,61,0,53
D14,Theft Under $5000,2018,91,450,0,359
D14,Theft Under $5000,2018,20,140,0,120
D14,Theft Under $5000,2018,68,366,0,298
D14,Theft Under $5000,2018,36,171,0,135
D14,Theft Under $5000,2018,2,11,0,9
D14,Theft Under $5000,2018,68,579,0,511
D14,Theft Under $5000,2018,112,409,0,297
D14,Theft Under $5000,2018,118,509,0,391
D14,Theft Under $5000,2018,25,233,0,208
D14,Theft Under $5000,2018,202,788,0,586
D14,Theft Under $5000,2018,47,266,0,219
D22,Break & Enter-Apartment,2018,0,4,0,4
D22,Break & Enter-Apartment,2018,4,6,0,2
D22,Break & Enter-Apartment,2018,2,3,0,1
D13,Other,2018,2,2,1,0
D22,Break & Enter-Apartment,2018,0,1,0,1
D22,Break & Enter-Commercial,2018,6,13,0,7
D22,Break & Enter-Commercial,2018,2,3,0,1
D22,Break & Enter-Commercial,2018,1,5,0,4
D22,Break & Enter-Commercial,2018,13,50,0,37
D22,Break & Enter-Commercial,2018,0,2,0,2
D22,Break & Enter-Commercial,2018,1,2,0,1
D22,Break & Enter-Commercial,2018,4,16,0,12
D22,Break & Enter-Commercial,2018,1,4,0,3
D22,Break & Enter-Commercial,2018,6,12,0,6
D22,Break & Enter-Commercial,2018,0,5,0,5
D22,Break & Enter-Commercial,2018,7,17,0,10
D22,Break & Enter-Commercial,2018,1,1,1,0
D22,Break & Enter-Commercial,2018,4,12,0,8
D22,Break & Enter-Commercial,2018,2,4,0,2
D22,Break & Enter-Commercial,2018,2,15,0,13
D22,Break & Enter-House,2018,1,8,0,7
D22,Break & Enter-House,2018,10,37,0,27
D22,Break & Enter-House,2018,2,16,0,14
D22,Break & Enter-House,2018,1,4,0,3
D22,Break & Enter-House,2018,2,9,0,7
D22,Break & Enter-House,2018,7,24,0,17
D22,Break & Enter-House,2018,4,12,0,8
D22,Break & Enter-House,2018,5,8,0,3
D22,Break & Enter-House,2018,6,15,0,9
D22,Break & Enter-House,2018,4,12,0,8
D22,Break & Enter-House,2018,3,4,0,1
D22,Break & Enter-House,2018,1,18,0,17
D22,Break & Enter-House,2018,1,21,0,20
D22,Break & Enter-Other,2018,0,2,0,2
D22,Break & Enter-Other,2018,0,2,0,2
D22,Break & Enter-Other,2018,3,4,0,1
D22,Break & Enter-Other,2018,0,2,0,2
D22,Break & Enter-Other,2018,1,2,0,1
D22,Break & Enter-Other,2018,0,2,0,2
D22,Break & Enter-Other,2018,0,1,0,1
D22,Break & Enter-Other,2018,0,1,0,1
D22,Break & Enter-Other,2018,0,2,0,2
D22,Break & Enter-Other,2018,1,2,0,1
D22,Fraud,2018,8,33,0,25
D22,Fraud,2018,1,20,0,19
D14,Other Criminal Violations - Offensive Weapons,2018,17,19,0,2
D14,Break & Enter-Apartment,2018,7,22,0,15
D14,Assault,2018,51,89,0,38
D22,Fraud,2018,2,34,0,32
D22,Fraud,2018,3,37,0,34
D22,Fraud,2018,60,218,0,158
D22,Fraud,2018,4,24,0,20
D22,Fraud,2018,7,61,0,54
D22,Fraud,2018,11,71,0,60
D22,Fraud,2018,4,28,0,24
D14,Robbery-Other,2018,6,11,0,5
D14,Other Criminal Violations - Offensive Weapons,2018,7,7,1,0
D14,Assault,2018,14,24,0,10
D13,Other,2018,2,2,1,0
D14,Robbery-Other,2018,3,7,0,4
D14,Other Criminal Violations - Offensive Weapons,2018,2,2,1,0
D13,Other,2018,36,41,0,5
D14,Break & Enter-Apartment,2018,2,16,0,14
D14,Assault,2018,88,116,0,28
D22,Fraud,2018,4,45,0,41
D14,Sexual Violation,2018,12,20,0,8
D14,Other Criminal Violations - Offensive Weapons,2018,9,10,0,1
D13,Other Criminal Violations - Offensive Weapons,2018,4,5,0,1
D14,Break & Enter-Apartment,2018,4,13,0,9
D14,Assault,2018,36,48,0,12
D22,Fraud,2018,0,3,0,3
D14,Sexual Violation,2018,6,13,0,7
D14,Other Criminal Violations - Offensive Weapons,2018,6,7,0,1
D13,Other Criminal Violations - Offensive Weapons,2018,2,5,0,3
D14,Break & Enter-Apartment,2018,15,40,0,25
D14,Assault,2018,118,210,0,92
D22,Fraud,2018,3,42,0,39
D14,Sexual Violation,2018,3,5,0,2
D14,Other,2018,2,2,1,0
D13,Other Criminal Violations - Offensive Weapons,2018,2,2,1,0
D14,Break & Enter-Apartment,2018,3,12,0,9
D14,Assault,2018,36,61,0,25
D22,Fraud,2018,0,20,0,20
D14,Sexual Violation,2018,6,12,0,6
D14,Other,2018,1,1,1,0
D13,Other Criminal Violations - Offensive Weapons,2018,5,5,1,0
D14,Break & Enter-Apartment,2018,2,11,0,9
D14,Assault,2018,1,2,0,1
D22,Fraud,2018,13,75,0,62
D14,Sexual Violation,2018,4,9,0,5
D14,Other,2018,1,1,1,0
D13,Other Criminal Violations - Offensive Weapons,2018,2,2,1,0
D14,Break & Enter-Apartment,2018,5,28,0,23
D14,Break & Enter-Apartment,2018,6,12,0,6
D14,Break & Enter-Commercial,2018,9,26,0,17
D14,Break & Enter-Commercial,2018,2,20,0,18
D14,Break & Enter-Commercial,2018,1,10,0,9
D14,Break & Enter-Commercial,2018,2,13,0,11
D14,Break & Enter-Commercial,2018,1,2,0,1
D14,Break & Enter-Commercial,2018,19,62,0,43
D14,Break & Enter-Commercial,2018,4,14,0,10
D14,Break & Enter-Commercial,2018,0,1,0,1
D14,Break & Enter-Commercial,2018,2,16,0,14
D14,Break & Enter-Commercial,2018,5,17,0,12
D14,Break & Enter-Commercial,2018,7,34,0,27
D14,Break & Enter-Commercial,2018,6,27,0,21
D14,Break & Enter-Commercial,2018,16,39,0,23
D14,Break & Enter-Commercial,2018,4,11,0,7
D14,Break & Enter-House,2018,6,24,0,18
D14,Break & Enter-House,2018,6,19,0,13
D14,Break & Enter-House,2018,2,5,0,3
D14,Break & Enter-House,2018,4,6,0,2
D14,Break & Enter-House,2018,0,3,0,3
D14,Break & Enter-House,2018,3,11,0,8
D14,Break & Enter-House,2018,9,16,0,7
D14,Break & Enter-House,2018,2,14,0,12
D14,Break & Enter-House,2018,4,15,0,11
D14,Break & Enter-House,2018,2,2,1,0
D14,Break & Enter-House,2018,2,5,0,3
D14,Break & Enter-Other,2018,2,3,0,1
D14,Break & Enter-Other,2018,2,7,0,5
D14,Break & Enter-Other,2018,0,2,0,2
D14,Break & Enter-Other,2018,3,5,0,2
D14,Break & Enter-Other,2018,1,5,0,4
D14,Break & Enter-Other,2018,1,4,0,3
D14,Break & Enter-Other,2018,0,5,0,5
D14,Break & Enter-Other,2018,1,6,0,5
D14,Break & Enter-Other,2018,1,4,0,3
D14,Break & Enter-Other,2018,1,3,0,2
D14,Break & Enter-Other,2018,0,2,0,2
D14,Break & Enter-Other,2018,2,7,0,5
D14,Fraud,2018,23,60,0,37
D14,Fraud,2018,20,55,0,35
D14,Fraud,2018,7,24,0,17
D14,Fraud,2018,53,112,0,59
D14,Fraud,2018,23,61,0,38
D14,Assault,2018,45,69,0,24
D13,Other Criminal Violations - Offensive Weapons,2018,3,4,0,1
D22,Other,2018,13,40,0,27
D14,Sexual Violation,2018,17,33,0,16
D13,Other Criminal Violations - Offensive Weapons,2018,2,5,0,3
D13,Other Criminal Violations - Offensive Weapons,2018,10,12,0,2
D22,Other,2018,11,34,0,23
D14,Sexual Violation,2018,8,15,0,7
D14,Assault,2018,133,178,0,45
D13,Other Criminal Violations - Offensive Weapons,2018,3,4,0,1
D22,Other,2018,9,40,0,31
D14,Other,2018,1,2,0,1
D14,Assault,2018,60,110,0,50
D13,Other Criminal Violations - Offensive Weapons,2018,2,2,1,0
D22,Other,2018,82,168,0,86
D14,Sexual Violation,2018,1,2,0,1
D14,Other,2018,3,3,1,0
D14,Assault,2018,30,55,0,25
D13,Other,2018,1,1,1,0
D22,Other,2018,6,26,0,20
D14,Sexual Violation,2018,14,17,0,3
D14,Other,2018,1,3,0,2
D14,Assault,2018,109,210,0,101
D13,Other,2018,1,1,1,0
D22,Other,2018,12,35,0,23
D14,Sexual Violation,2018,14,26,0,12
D14,Other,2018,1,1,1,0
D14,Assault,2018,60,103,0,43
D13,Other,2018,3,3,1,0
D22,Other,2018,1,1,1,0
D14,Sexual Violation,2018,8,14,0,6
D14,Other,2018,1,1,1,0
D14,Attempt Murder,2018,1,1,1,0
D13,Other,2018,1,2,0,1
D22,Other,2018,19,67,0,48
D14,Sexual Violation,2018,4,12,0,8
D22,Other,2018,4,4,1,0
D14,Attempt Murder,2018,2,2,1,0
D14,Other,2018,2,2,1,0
D22,Other,2018,8,34,0,26
D14,Sexual Violation,2018,5,18,0,13
D22,Other,2018,2,2,1,0
D14,Attempt Murder,2018,4,4,1,0
D14,Other,2018,3,3,1,0
D22,Other,2018,14,45,0,31
D14,Sexual Violation,2018,7,15,0,8
D22,Other,2018,1,1,1,0
D14,Other,2018,2,2,1,0
D14,Other,2018,14,23,0,9
D22,Other,2018,20,21,0,1
D14,Other,2018,1,1,1,0
D22,Other,2018,5,26,0,21
D14,Other,2018,10,19,0,9
D22,Other,2018,1,1,1,0
D14,Other,2018,29,32,0,3
D14,Other,2018,3,3,1,0
D22,Other,2018,21,72,0,51
D14,Other,2018,4,9,0,5
D22,Other,2018,19,19,1,0
D14,Other,2018,12,12,1,0
D14,Other,2018,9,9,1,0
D22,Other,2018,1,1,1,0
D14,Other,2018,14,28,0,14
D22,Other,2018,5,6,0,1
D14,Other,2018,91,91,1,0
D14,Other,2018,5,5,1,0
D22,Other,2018,25,63,0,38
D14,Other,2018,4,7,0,3
D22,Other,2018,2,2,1,0
D14,Other,2018,8,8,1,0
D14,Other,2018,12,13,0,1
D22,Other,2018,1,12,0,11
D14,Other,2018,11,35,0,24
D22,Other,2018,8,8,1,0
D14,Other,2018,14,14,1,0
D14,Other,2018,4,4,1,0
D22,Other,2018,29,86,0,57
D14,Other,2018,13,25,0,12
D22,Other,2018,3,3,1,0
D14,Other,2018,36,37,0,1
D14,Other,2018,6,6,1,0
D22,Theft Over $5000,2018,3,8,0,5
D14,Other,2018,13,20,0,7
D22,Other,2018,23,24,0,1
D14,Other,2018,33,35,0,2
D14,Other,2018,16,17,0,1
D22,Theft Over $5000,2018,1,5,0,4
D14,Other,2018,32,53,0,21
D22,Other,2018,12,12,1,0
D14,Other,2018,12,12,1,0
D14,Other,2018,8,8,1,0
D22,Theft Over $5000,2018,1,3,0,2
D14,Other,2018,15,21,0,6
D22,Other,2018,3,3,1,0
D14,Other,2018,5,5,1,0
D14,Other,2018,84,85,0,1
D22,Theft Over $5000,2018,11,49,0,38
D22,Other,2018,4,6,0,2
D14,Other,2018,14,22,0,8
D14,Other,2018,25,26,0,1
D22,Theft Over $5000,2018,0,3,0,3
D22,Auto Theft,2018,2,26,0,24
D14,Other,2018,14,16,0,2
D14,Other,2018,9,20,0,11
D14,Auto Theft,2018,1,15,0,14
D22,Theft Over $5000,2018,1,7,0,6
D22,Auto Theft,2018,0,18,0,18
D14,Other,2018,8,8,1,0
D14,Other,2018,10,25,0,15
D14,Auto Theft,2018,0,11,0,11
D22,Theft Over $5000,2018,1,5,0,4
D22,Auto Theft,2018,1,27,0,26
D14,Other,2018,49,53,0,4
D14,Robbery-Financial,2018,1,1,1,0
D14,Auto Theft,2018,0,7,0,7
D22,Theft Over $5000,2018,2,4,0,2
D22,Auto Theft,2018,15,126,0,111
D14,Other,2018,40,44,0,4
D14,Robbery-Financial,2018,0,1,0,1
D14,Auto Theft,2018,5,14,0,9
D22,Theft Over $5000,2018,0,3,0,3
D22,Auto Theft,2018,1,9,0,8
D14,Other,2018,15,16,0,1
D14,Robbery-Financial,2018,1,1,1,0
D14,Auto Theft,2018,0,1,0,1
D22,Theft Over $5000,2018,0,2,0,2
D22,Auto Theft,2018,3,9,0,6
D14,Other,2018,81,93,0,12
D14,Robbery-Financial,2018,1,1,1,0
D14,Auto Theft,2018,2,11,0,9
D22,Theft Over $5000,2018,1,6,0,5
D22,Auto Theft,2018,5,39,0,34
D14,Other,2018,20,24,0,4
D14,Robbery-Financial,2018,2,2,1,0
D14,Auto Theft,2018,2,5,0,3
D22,Theft Over $5000,2018,0,1,0,1
D22,Auto Theft,2018,2,10,0,8
D14,Other,2018,153,163,0,10
D14,Robbery-Financial,2018,1,1,1,0
D14,Auto Theft,2018,0,2,0,2
D22,Theft Over $5000,2018,3,6,0,3
D22,Theft Over $5000,2018,1,8,0,7
D22,Theft Under $5000,2018,31,99,0,68
D22,Theft Under $5000,2018,14,110,0,96
D22,Theft Under $5000,2018,9,93,0,84
D22,Theft Under $5000,2018,328,903,0,575
D22,Theft Under $5000,2018,1,39,0,38
D22,Theft Under $5000,2018,95,246,0,151
D22,Theft Under $5000,2018,90,272,0,182
D22,Theft Under $5000,2018,81,224,0,143
D22,Theft Under $5000,2018,43,161,0,118
D22,Theft Under $5000,2018,39,141,0,102
D22,Theft Under $5000,2018,19,153,0,134
D22,Theft Under $5000,2018,2,7,0,5
D22,Theft Under $5000,2018,64,213,0,149
D22,Auto Theft,2018,0,11,0,11
D14,Robbery-Financial,2018,1,1,1,0
D14,Auto Theft,2018,2,23,0,21
D14,Other,2018,39,46,0,7
D22,Auto Theft,2018,3,20,0,17
D14,Robbery-Financial,2018,2,2,1,0
D14,Auto Theft,2018,1,13,0,12
D14,Other,2018,1,1,1,0
D22,Auto Theft,2018,3,13,0,10
D14,Robbery-Other,2018,10,16,0,6
D14,Auto Theft,2018,4,23,0,19
D14,Other,2018,51,56,0,5
D22,Auto Theft,2018,0,1,0,1
D14,Robbery-Other,2018,17,28,0,11
D14,Auto Theft,2018,3,10,0,7
D14,Other,2018,113,130,0,17
D22,Auto Theft,2018,2,17,0,15
D14,Robbery-Other,2018,5,11,0,6
D14,Auto Theft,2018,6,20,0,14
D14,Other,2018,63,72,0,9
D22,Auto Theft,2018,0,21,0,21
D14,Robbery-Other,2018,3,5,0,2
D14,Auto Theft,2018,0,7,0,7
D14,Other,2018,20,26,0,6
D22,Auto Theft,2018,4,35,0,31
D14,Robbery-Other,2018,1,9,0,8
D14,Break & Enter-Apartment,2018,4,14,0,10
D14,Other,2018,130,139,0,9
D22,Break & Enter-Apartment,2018,0,4,0,4
D14,Robbery-Other,2018,28,45,0,17
D14,Break & Enter-Apartment,2018,1,4,0,3
D14,Other,2018,66,73,0,7
D22,Break & Enter-Apartment,2018,4,10,0,6
D14,Robbery-Other,2018,2,7,0,5
D14,Break & Enter-Apartment,2018,0,6,0,6
D22,Break & Enter-Apartment,2018,1,13,0,12
D14,Other Criminal Violations - Offensive Weapons,2018,7,7,1,0
D14,Robbery-Other,2018,0,1,0,1
D14,Break & Enter-Apartment,2018,9,25,0,16
D22,Break & Enter-Apartment,2018,1,3,0,2
D14,Other Criminal Violations - Offensive Weapons,2018,6,6,1,0
D14,Robbery-Other,2018,4,19,0,15
D14,Break & Enter-Apartment,2018,1,30,0,29
D22,Break & Enter-Apartment,2018,4,11,0,7
D14,Other Criminal Violations - Offensive Weapons,2018,6,7,0,1
D14,Robbery-Other,2018,14,30,0,16
D22,Break & Enter-Apartment,2018,1,8,0,7
D14,Other Criminal Violations - Offensive Weapons,2018,6,6,1,0
D14,Robbery-Other,2018,4,11,0,7
D22,Break & Enter-Apartment,2018,1,2,0,1
D14,Other Criminal Violations - Offensive Weapons,2018,4,4,1,0
D14,Robbery-Other,2018,3,12,0,9
D22,Break & Enter-Apartment,2018,6,17,0,11
D14,Other Criminal Violations - Offensive Weapons,2018,18,19,0,1
D14,Other Criminal Violations - Offensive Weapons,2018,2,2,1,0
D14,Other Criminal Violations - Offensive Weapons,2018,7,7,1,0
D22,Other,2018,17,18,0,1
D22,Other,2018,69,72,0,3
D22,Other,2018,11,12,0,1
D22,Other,2018,38,47,0,9
D22,Other Criminal Violations - Offensive Weapons,2018,5,6,0,1
D22,Other Criminal Violations - Offensive Weapons,2018,1,1,1,0
D22,Other Criminal Violations - Offensive Weapons,2018,1,1,1,0
D22,Other Criminal Violations - Offensive Weapons,2018,12,13,0,1
D22,Other Criminal Violations - Offensive Weapons,2018,6,6,1,0
D31,Fraud,2018,1,6,0,5
D22,Other Criminal Violations - Offensive Weapons,2018,6,6,1,0
D22,Other Criminal Violations - Offensive Weapons,2018,4,4,1,0
D22,Other Criminal Violations - Offensive Weapons,2018,1,1,1,0
D22,Other Criminal Violations - Offensive Weapons,2018,8,9,0,1
D22,Other Criminal Violations - Offensive Weapons,2018,1,1,1,0
D22,Other Criminal Violations - Offensive Weapons,2018,23,24,0,1
D22,Other Criminal Violations - Offensive Weapons,2018,9,9,1,0
D22,Other Criminal Violations - Offensive Weapons,2018,2,2,1,0
D22,Other Criminal Violations - Offensive Weapons,2018,5,5,1,0
D22,Other,2018,0,1,0,1
D22,Other,2018,3,3,1,0
D22,Other,2018,1,1,1,0
D22,Other,2018,1,1,1,0
D22,Other,2018,2,2,1,0
D23,Other,2018,3,3,1,0
D23,Other,2018,1,1,1,0
D23,Other,2018,11,12,0,1
D23,Other,2018,22,22,1,0
D23,Other,2018,1,2,0,1
D23,Other,2018,4,4,1,0
D23,Other,2018,1,1,1,0
D23,Other,2018,47,51,0,4
D23,Other,2018,9,10,0,1
D23,Auto Theft,2018,0,34,0,34
D23,Auto Theft,2018,2,15,0,13
D23,Auto Theft,2018,0,1,0,1
D23,Auto Theft,2018,8,55,0,47
D23,Auto Theft,2018,7,77,0,70
D23,Auto Theft,2018,0,1,0,1
D23,Auto Theft,2018,5,57,0,52
D23,Auto Theft,2018,6,44,0,38
D23,Auto Theft,2018,45,507,0,462
D23,Auto Theft,2018,4,53,0,49
D23,Break & Enter-Apartment,2018,0,1,0,1
D23,Break & Enter-Apartment,2018,0,1,0,1
D23,Break & Enter-Apartment,2018,1,12,0,11
D23,Break & Enter-Apartment,2018,2,21,0,19
D23,Break & Enter-Apartment,2018,1,9,0,8
D23,Break & Enter-Apartment,2018,1,5,0,4
D23,Break & Enter-Apartment,2018,0,2,0,2
D23,Break & Enter-Apartment,2018,1,13,0,12
D23,Break & Enter-Apartment,2018,0,13,0,13
D23,Theft Over $5000,2018,11,52,0,41
D23,Robbery-Other,2018,27,73,0,46
D22,Robbery-Other,2018,5,14,0,9
D23,Theft Over $5000,2018,0,4,0,4
D31,Fraud,2018,17,97,0,80
D23,Robbery-Other,2018,5,14,0,9
D22,Robbery-Other,2018,2,10,0,8
D22,Theft Under $5000,2018,8,87,0,79
D23,Theft Under $5000,2018,0,5,0,5
D23,Break & Enter-Commercial,2018,0,3,0,3
D31,Fraud,2018,1,22,0,21
D23,Sexual Violation,2018,3,6,0,3
D22,Robbery-Other,2018,8,14,0,6
D22,Theft Under $5000,2018,77,263,0,186
D23,Theft Under $5000,2018,54,116,0,62
D23,Break & Enter-Commercial,2018,0,4,0,4
D31,Fraud,2018,21,156,0,135
D23,Sexual Violation,2018,3,5,0,2
D22,Robbery-Other,2018,5,9,0,4
D22,Assault,2018,22,25,0,3
D23,Theft Under $5000,2018,2,52,0,50
D23,Break & Enter-Commercial,2018,0,5,0,5
D31,Other,2018,41,96,0,55
D23,Sexual Violation,2018,6,10,0,4
D22,Robbery-Other,2018,1,3,0,2
D22,Assault,2018,13,18,0,5
D23,Theft Under $5000,2018,21,160,0,139
D23,Break & Enter-Commercial,2018,2,6,0,4
D31,Other,2018,16,64,0,48
D23,Sexual Violation,2018,18,35,0,17
D22,Robbery-Other,2018,4,13,0,9
D22,Assault,2018,25,33,0,8
D23,Theft Under $5000,2018,98,330,0,232
D23,Break & Enter-Commercial,2018,3,8,0,5
D31,Other,2018,45,131,0,86
D23,Sexual Violation,2018,1,3,0,2
D22,Robbery-Other,2018,12,20,0,8
D22,Assault,2018,91,142,0,51
D23,Theft Under $5000,2018,0,8,0,8
D23,Break & Enter-Commercial,2018,5,10,0,5
D31,Other,2018,22,78,0,56
D23,Sexual Violation,2018,1,4,0,3
D22,Robbery-Other,2018,0,1,0,1
D22,Assault,2018,21,39,0,18
D23,Theft Under $5000,2018,8,85,0,77
D23,Break & Enter-Commercial,2018,28,125,0,97
D23,Break & Enter-Commercial,2018,2,21,0,19
D23,Break & Enter-House,2018,1,3,0,2
D23,Break & Enter-House,2018,0,13,0,13
D23,Break & Enter-House,2018,0,13,0,13
D23,Break & Enter-House,2018,0,10,0,10
D23,Break & Enter-House,2018,0,5,0,5
D23,Break & Enter-House,2018,2,4,0,2
D23,Break & Enter-House,2018,1,28,0,27
D23,Break & Enter-House,2018,4,28,0,24
D23,Break & Enter-Other,2018,0,1,0,1
D23,Break & Enter-Other,2018,2,2,1,0
D23,Break & Enter-Other,2018,0,5,0,5
D23,Break & Enter-Other,2018,1,6,0,5
D23,Fraud,2018,1,7,0,6
D23,Fraud,2018,8,41,0,33
D23,Fraud,2018,0,8,0,8
D23,Fraud,2018,10,67,0,57
D23,Fraud,2018,40,168,0,128
D23,Fraud,2018,1,7,0,6
D23,Fraud,2018,6,34,0,28
D23,Fraud,2018,6,34,0,28
D23,Fraud,2018,45,237,0,192
D23,Fraud,2018,9,52,0,43
D23,Other,2018,1,1,1,0
D23,Other,2018,7,25,0,18
D23,Other,2018,5,24,0,19
D23,Other,2018,0,2,0,2
D23,Other,2018,22,77,0,55
D23,Other,2018,41,116,0,75
D23,Other,2018,1,2,0,1
D23,Other,2018,0,3,0,3
D23,Other,2018,16,45,0,29
D23,Other,2018,9,30,0,21
D23,Other,2018,62,233,0,171
D23,Other,2018,17,55,0,38
D23,Theft Over $5000,2018,0,1,0,1
D23,Theft Over $5000,2018,0,1,0,1
D23,Theft Over $5000,2018,0,3,0,3
D23,Theft Over $5000,2018,0,3,0,3
D23,Theft Over $5000,2018,1,3,0,2
D23,Theft Over $5000,2018,0,3,0,3
D23,Theft Over $5000,2018,0,2,0,2
D31,Other,2018,56,57,0,1
D31,Other,2018,14,44,0,30
D23,Sexual Violation,2018,5,8,0,3
D31,Other,2018,4,7,0,3
D23,Theft Under $5000,2018,0,1,0,1
D22,Robbery-Other,2018,10,22,0,12
D22,Assault,2018,44,69,0,25
D23,Theft Under $5000,2018,10,71,0,61
D22,Sexual Violation,2018,7,13,0,6
D23,Sexual Violation,2018,33,48,0,15
D31,Other,2018,42,141,0,99
D22,Assault,2018,48,75,0,27
D23,Theft Under $5000,2018,150,947,0,797
D22,Sexual Violation,2018,2,3,0,1
D23,Sexual Violation,2018,7,11,0,4
D31,Other,2018,11,28,0,17
D22,Assault,2018,16,29,0,13
D23,Theft Under $5000,2018,32,161,0,129
D22,Sexual Violation,2018,6,11,0,5
D23,Other,2018,3,3,1,0
D31,Other,2018,48,159,0,111
D22,Assault,2018,40,49,0,9
D23,Assault,2018,2,2,1,0
D22,Sexual Violation,2018,12,21,0,9
D23,Other,2018,2,2,1,0
D31,Theft Over $5000,2018,0,8,0,8
D22,Assault,2018,13,23,0,10
D23,Assault,2018,30,50,0,20
D22,Sexual Violation,2018,3,6,0,3
D23,Other,2018,8,8,1,0
D31,Theft Over $5000,2018,0,1,0,1
D22,Assault,2018,102,385,0,283
D23,Assault,2018,24,36,0,12
D22,Sexual Violation,2018,4,8,0,4
D23,Other,2018,4,4,1,0
D31,Theft Over $5000,2018,2,11,0,9
D22,Assault,2018,2,3,0,1
D23,Assault,2018,1,1,1,0
D22,Sexual Violation,2018,3,5,0,2
D23,Other,2018,18,19,0,1
D31,Theft Over $5000,2018,3,15,0,12
D22,Assault,2018,57,94,0,37
D23,Assault,2018,62,88,0,26
D22,Sexual Violation,2018,1,1,1,0
D23,Other,2018,2,2,1,0
D31,Theft Over $5000,2018,0,11,0,11
D22,Assault,2018,9,16,0,7
D23,Assault,2018,125,227,0,102
D22,Sexual Violation,2018,6,7,0,1
D23,Other,2018,2,2,1,0
D31,Theft Over $5000,2018,1,11,0,10
D22,Assault,2018,60,84,0,24
D22,Attempt Murder,2018,1,1,1,0
D22,Attempt Murder,2018,2,2,1,0
D22,Attempt Murder,2018,3,3,1,0
D22,Attempt Murder,2018,1,4,0,3
D22,Attempt Murder,2018,0,1,0,1
D22,Attempt Murder,2018,1,1,1,0
D22,Attempt Murder,2018,1,1,1,0
D22,Other,2018,3,10,0,7
D22,Other,2018,4,9,0,5
D22,Other,2018,6,11,0,5
D22,Other,2018,30,56,0,26
D22,Other,2018,2,8,0,6
D22,Other,2018,8,23,0,15
D22,Other,2018,10,21,0,11
D22,Other,2018,1,5,0,4
D22,Other,2018,11,18,0,7
D22,Other,2018,2,4,0,2
D22,Other,2018,22,49,0,27
D22,Other,2018,0,2,0,2
D22,Other,2018,18,33,0,15
D22,Other,2018,1,5,0,4
D22,Other,2018,6,11,0,5
D22,Robbery-Financial,2018,3,3,1,0
D22,Robbery-Financial,2018,2,2,1,0
D22,Robbery-Financial,2018,1,1,1,0
D22,Robbery-Financial,2018,1,1,1,0
D22,Robbery-Financial,2018,2,2,1,0
D22,Robbery-Financial,2018,1,3,0,2
D22,Robbery-Other,2018,3,6,0,3
D22,Robbery-Other,2018,0,2,0,2
D22,Robbery-Other,2018,2,7,0,5
D22,Robbery-Other,2018,4,18,0,14
D22,Robbery-Other,2018,0,3,0,3
D23,Assault,2018,1,3,0,2
D23,Other,2018,1,1,1,0
D22,Sexual Violation,2018,1,1,1,0
D31,Theft Over $5000,2018,0,2,0,2
D23,Assault,2018,0,1,0,1
D23,Other,2018,6,6,1,0
D22,Sexual Violation,2018,4,12,0,8
D31,Theft Over $5000,2018,2,13,0,11
D23,Assault,2018,49,66,0,17
D23,Other,2018,28,30,0,2
D22,Sexual Violation,2018,0,1,0,1
D31,Theft Under $5000,2018,37,224,0,187
D23,Other,2018,8,8,1,0
D23,Assault,2018,35,51,0,16
D31,Theft Under $5000,2018,48,197,0,149
D22,Sexual Violation,2018,7,18,0,11
D31,Theft Under $5000,2018,74,288,0,214
D23,Assault,2018,164,282,0,118
D23,Other,2018,5,5,1,0
D22,Sexual Violation,2018,0,3,0,3
D31,Theft Under $5000,2018,19,206,0,187
D23,Assault,2018,46,68,0,22
D23,Other,2018,21,26,0,5
D22,Sexual Violation,2018,5,15,0,10
D31,Theft Under $5000,2018,6,89,0,83
D23,Attempt Murder,2018,3,3,1,0
D23,Other,2018,12,14,0,2
D22,Other,2018,3,3,1,0
D31,Theft Under $5000,2018,2,9,0,7
D23,Attempt Murder,2018,3,3,1,0
D23,Other,2018,1,1,1,0
D22,Other,2018,1,1,1,0
D31,Theft Under $5000,2018,225,512,0,287
D23,Attempt Murder,2018,0,6,0,6
D23,Other,2018,26,34,0,8
D22,Other,2018,3,3,1,0
D31,Theft Under $5000,2018,3,49,0,46
D23,Attempt Murder,2018,3,3,1,0
D23,Other,2018,101,114,0,13
D22,Other,2018,19,19,1,0
D31,Theft Under $5000,2018,112,592,0,480
D23,Other,2018,3,3,1,0
D23,Other,2018,22,26,0,4
D31,Other,2018,14,16,0,2
D23,Other,2018,15,18,0,3
D31,Assault,2018,104,165,0,61
D22,Other,2018,7,7,1,0
D23,Other,2018,5,12,0,7
D23,Other,2018,16,18,0,2
D31,Other,2018,8,8,1,0
D31,Assault,2018,43,78,0,35
D22,Other,2018,8,9,0,1
D23,Other,2018,7,11,0,4
D23,Other,2018,97,104,0,7
D31,Other,2018,13,13,1,0
D31,Assault,2018,162,263,0,101
D22,Other,2018,2,2,1,0
D31,Other,2018,38,40,0,2
D23,Other,2018,14,27,0,13
D31,Other,2018,5,5,1,0
D23,Other,2018,30,34,0,4
D31,Assault,2018,55,88,0,33
D23,Other,2018,29,63,0,34
D31,Other,2018,24,27,0,3
D22,Other,2018,1,1,1,0
D31,Assault,2018,51,103,0,52
D23,Other,2018,0,1,0,1
D23,Other,2018,2,2,1,0
D22,Other,2018,7,7,1,0
D31,Assault,2018,1,3,0,2
D23,Other,2018,7,16,0,9
D23,Other Criminal Violations - Offensive Weapons,2018,8,9,0,1
D22,Other,2018,2,2,1,0
D31,Assault,2018,163,264,0,101
D23,Other,2018,5,10,0,5
D23,Other Criminal Violations - Offensive Weapons,2018,8,9,0,1
D22,Other,2018,13,15,0,2
D31,Assault,2018,28,40,0,12
D23,Other,2018,30,70,0,40
D23,Other Criminal Violations - Offensive Weapons,2018,11,13,0,2
D22,Other,2018,10,12,0,2
D31,Auto Theft,2018,4,55,0,51
D31,Assault,2018,154,251,0,97
D23,Other,2018,8,23,0,15
D23,Other Criminal Violations - Offensive Weapons,2018,3,3,1,0
D22,Other,2018,1,1,1,0
D31,Auto Theft,2018,5,20,0,15
D31,Attempt Murder,2018,5,6,0,1
D23,Robbery-Financial,2018,0,1,0,1
D23,Other Criminal Violations - Offensive Weapons,2018,2,3,0,1
D22,Other,2018,16,16,1,0
D31,Auto Theft,2018,11,68,0,57
D31,Attempt Murder,2018,3,5,0,2
D23,Robbery-Financial,2018,1,1,1,0
D23,Other Criminal Violations - Offensive Weapons,2018,20,21,0,1
D22,Other,2018,14,14,1,0
D31,Auto Theft,2018,5,109,0,104
D31,Attempt Murder,2018,8,8,1,0
D23,Robbery-Financial,2018,3,4,0,1
D22,Other,2018,11,15,0,4
D23,Other Criminal Violations - Offensive Weapons,2018,9,9,1,0
D22,Other,2018,17,19,0,2
D31,Attempt Murder,2018,1,1,1,0
D23,Robbery-Financial,2018,2,2,1,0
D23,Other,2018,1,2,0,1
D22,Other,2018,116,132,0,16
D31,Auto Theft,2018,5,56,0,51
D22,Other,2018,8,11,0,3
D23,Other,2018,3,3,1,0
D31,Attempt Murder,2018,1,4,0,3
D23,Robbery-Other,2018,0,1,0,1
D31,Auto Theft,2018,11,81,0,70
D22,Other,2018,31,36,0,5
D23,Other,2018,1,1,1,0
D31,Attempt Murder,2018,0,1,0,1
D23,Robbery-Other,2018,1,11,0,10
D31,Auto Theft,2018,6,44,0,38
D22,Other,2018,3,3,1,0
D23,Other,2018,2,2,1,0
D31,Other,2018,25,50,0,25
D23,Robbery-Other,2018,2,4,0,2
D31,Auto Theft,2018,8,55,0,47
D22,Other,2018,44,51,0,7
D23,Other,2018,1,1,1,0
D31,Other,2018,15,26,0,11
D23,Robbery-Other,2018,10,17,0,7
D31,Break & Enter-Apartment,2018,5,20,0,15
D22,Other,2018,32,34,0,2
D23,Other,2018,4,4,1,0
D31,Other,2018,35,62,0,27
D23,Robbery-Other,2018,13,57,0,44
D31,Break & Enter-Apartment,2018,4,14,0,10
D22,Other,2018,34,36,0,2
D23,Other,2018,2,2,1,0
D31,Other,2018,6,22,0,16
D23,Robbery-Other,2018,7,21,0,14
D31,Break & Enter-Apartment,2018,11,19,0,8
D22,Other,2018,12,15,0,3
D31,Other,2018,21,23,0,2
D31,Other,2018,19,40,0,21
D23,Robbery-Other,2018,2,8,0,6
D22,Other,2018,651,692,0,41
D31,Break & Enter-Apartment,2018,1,15,0,14
D31,Other,2018,11,12,0,1
D31,Break & Enter-Apartment,2018,4,7,0,3
D31,Break & Enter-Apartment,2018,4,14,0,10
D31,Break & Enter-Apartment,2018,1,1,1,0
D31,Break & Enter-Apartment,2018,6,16,0,10
D31,Break & Enter-Commercial,2018,1,2,0,1
D31,Break & Enter-Commercial,2018,0,4,0,4
D31,Break & Enter-Commercial,2018,1,7,0,6
D31,Break & Enter-Commercial,2018,4,29,0,25
D31,Break & Enter-Commercial,2018,3,22,0,19
D31,Break & Enter-Commercial,2018,4,14,0,10
D31,Break & Enter-Commercial,2018,1,2,0,1
D31,Break & Enter-Commercial,2018,4,23,0,19
D31,Break & Enter-House,2018,3,6,0,3
D31,Break & Enter-House,2018,1,5,0,4
D31,Break & Enter-House,2018,3,10,0,7
D31,Break & Enter-House,2018,1,10,0,9
D31,Break & Enter-House,2018,0,12,0,12
D31,Break & Enter-House,2018,3,15,0,12
D31,Break & Enter-House,2018,1,10,0,9
D31,Break & Enter-House,2018,1,8,0,7
D31,Break & Enter-Other,2018,2,2,1,0
D31,Break & Enter-Other,2018,1,2,0,1
D31,Break & Enter-Other,2018,0,2,0,2
D31,Break & Enter-Other,2018,1,2,0,1
D31,Break & Enter-Other,2018,1,3,0,2
D31,Break & Enter-Other,2018,0,6,0,6
D31,Fraud,2018,7,76,0,69
D31,Fraud,2018,4,45,0,41
D31,Fraud,2018,23,136,0,113
D31,Fraud,2018,13,61,0,48
D31,Fraud,2018,6,43,0,37
D32,Theft Over $5000,2018,0,1,0,1
D31,Other Criminal Violations - Offensive Weapons,2018,10,11,0,1
D32,Theft Over $5000,2018,1,9,0,8
D31,Other Criminal Violations - Offensive Weapons,2018,23,24,0,1
D32,Theft Over $5000,2018,0,2,0,2
D32,Break & Enter-Apartment,2018,0,1,0,1
D32,Break & Enter-Other,2018,0,4,0,4
D32,Robbery-Other,2018,12,27,0,15
D31,Other,2018,6,7,0,1
D31,Other,2018,2,2,1,0
D31,Other,2018,6,6,1,0
D31,Other,2018,2,2,1,0
D31,Other,2018,1,1,1,0
D31,Other,2018,2,3,0,1
D31,Other,2018,1,1,1,0
D31,Other,2018,3,3,1,0
D32,Other,2018,2,2,1,0
D32,Other,2018,2,2,1,0
D32,Other,2018,1,1,1,0
D32,Other,2018,11,11,1,0
D32,Other,2018,2,2,1,0
D32,Other,2018,3,4,0,1
D32,Other,2018,5,6,0,1
D32,Other,2018,8,8,1,0
D32,Other,2018,1,1,1,0
D32,Other,2018,1,1,1,0
D32,Other,2018,7,7,1,0
D32,Other,2018,3,3,1,0
D32,Other,2018,8,10,0,2
D32,Other,2018,5,5,1,0
D32,Other,2018,12,13,0,1
D32,Other,2018,7,7,1,0
D32,Other,2018,13,13,1,0
D32,Auto Theft,2018,1,8,0,7
D32,Auto Theft,2018,3,39,0,36
D32,Auto Theft,2018,7,39,0,32
D32,Auto Theft,2018,0,2,0,2
D32,Auto Theft,2018,6,43,0,37
D32,Auto Theft,2018,1,14,0,13
D32,Auto Theft,2018,3,15,0,12
D32,Auto Theft,2018,5,23,0,18
D32,Auto Theft,2018,1,18,0,17
D32,Auto Theft,2018,7,41,0,34
D32,Auto Theft,2018,0,2,0,2
D32,Auto Theft,2018,1,14,0,13
D32,Auto Theft,2018,3,55,0,52
D32,Auto Theft,2018,0,15,0,15
D32,Auto Theft,2018,5,36,0,31
D32,Auto Theft,2018,4,14,0,10
D32,Auto Theft,2018,3,24,0,21
D32,Auto Theft,2018,6,40,0,34
D32,Auto Theft,2018,4,42,0,38
D32,Break & Enter-Apartment,2018,3,7,0,4
D32,Assault,2018,97,156,0,59
D32,Other,2018,33,40,0,7
D32,Break & Enter-Apartment,2018,1,10,0,9
D32,Break & Enter-Apartment,2018,1,16,0,15
D32,Break & Enter-Apartment,2018,3,11,0,8
D32,Other,2018,1,1,1,0
D32,Assault,2018,14,21,0,7
D32,Assault,2018,57,87,0,30
D32,Break & Enter-Apartment,2018,1,3,0,2
D32,Break & Enter-Other,2018,0,2,0,2
D32,Other,2018,32,38,0,6
D32,Robbery-Other,2018,6,24,0,18
D32,Theft Over $5000,2018,0,3,0,3
D32,Break & Enter-Apartment,2018,0,5,0,5
D32,Assault,2018,48,87,0,39
D32,Robbery-Other,2018,6,15,0,9
D32,Break & Enter-Other,2018,2,6,0,4
D32,Theft Over $5000,2018,0,3,0,3
D32,Other,2018,10,12,0,2
D32,Break & Enter-Apartment,2018,0,5,0,5
D32,Assault,2018,46,81,0,35
D32,Robbery-Other,2018,5,17,0,12
D32,Break & Enter-Other,2018,0,3,0,3
D32,Theft Over $5000,2018,0,7,0,7
D32,Other,2018,7,7,1,0
D32,Break & Enter-Apartment,2018,0,16,0,16
D32,Assault,2018,31,57,0,26
D32,Sexual Violation,2018,2,4,0,2
D32,Break & Enter-Other,2018,1,3,0,2
D32,Theft Over $5000,2018,0,4,0,4
D32,Other,2018,16,21,0,5
D32,Break & Enter-Apartment,2018,2,18,0,16
D32,Assault,2018,77,114,0,37
D32,Sexual Violation,2018,6,14,0,8
D32,Break & Enter-Other,2018,1,3,0,2
D32,Theft Over $5000,2018,2,4,0,2
D32,Other,2018,37,44,0,7
D32,Break & Enter-Apartment,2018,0,7,0,7
D32,Attempt Murder,2018,1,2,0,1
D32,Sexual Violation,2018,1,4,0,3
D32,Break & Enter-Other,2018,0,2,0,2
D32,Theft Over $5000,2018,1,9,0,8
D32,Other,2018,3,4,0,1
D32,Break & Enter-Apartment,2018,0,15,0,15
D32,Attempt Murder,2018,1,1,1,0
D32,Sexual Violation,2018,2,2,1,0
D32,Fraud,2018,3,59,0,56
D32,Theft Over $5000,2018,0,1,0,1
D32,Other,2018,27,33,0,6
D32,Attempt Murder,2018,0,1,0,1
D32,Break & Enter-Apartment,2018,0,3,0,3
D32,Fraud,2018,3,54,0,51
D32,Theft Over $5000,2018,0,4,0,4
D32,Other,2018,46,51,0,5
D32,Sexual Violation,2018,6,13,0,7
D32,Fraud,2018,7,57,0,50
D32,Theft Over $5000,2018,0,6,0,6
D32,Attempt Murder,2018,1,1,1,0
D32,Other,2018,28,35,0,7
D32,Break & Enter-Apartment,2018,1,4,0,3
D32,Sexual Violation,2018,2,6,0,4
D31,Other,2018,0,1,0,1
D32,Fraud,2018,1,7,0,6
D32,Theft Over $5000,2018,3,6,0,3
D32,Attempt Murder,2018,4,4,1,0
D32,Other,2018,281,299,0,18
D32,Break & Enter-Apartment,2018,0,1,0,1
D32,Sexual Violation,2018,1,2,0,1
D31,Other,2018,34,66,0,32
D32,Fraud,2018,8,57,0,49
D32,Theft Over $5000,2018,3,24,0,21
D32,Other,2018,8,15,0,7
D32,Other,2018,121,126,0,5
D32,Break & Enter-Apartment,2018,2,2,1,0
D32,Sexual Violation,2018,1,6,0,5
D31,Other,2018,6,10,0,4
D32,Fraud,2018,0,24,0,24
D32,Theft Over $5000,2018,7,18,0,11
D32,Other,2018,14,23,0,9
D32,Other Criminal Violations - Offensive Weapons,2018,1,1,1,0
D32,Break & Enter-Commercial,2018,0,2,0,2
D32,Sexual Violation,2018,7,12,0,5
D31,Other,2018,36,61,0,25
D32,Fraud,2018,1,40,0,39
D32,Theft Under $5000,2018,29,94,0,65
D32,Other,2018,1,1,1,0
D32,Other Criminal Violations - Offensive Weapons,2018,3,3,1,0
D32,Break & Enter-Commercial,2018,1,8,0,7
D32,Sexual Violation,2018,3,4,0,1
D31,Robbery-Financial,2018,2,2,1,0
D32,Fraud,2018,0,35,0,35
D32,Theft Under $5000,2018,5,105,0,100
D32,Other,2018,11,25,0,14
D32,Other Criminal Violations - Offensive Weapons,2018,1,1,1,0
D32,Break & Enter-Commercial,2018,1,18,0,17
D32,Sexual Violation,2018,0,1,0,1
D32,Sexual Violation,2018,0,2,0,2
D32,Sexual Violation,2018,5,16,0,11
D32,Sexual Violation,2018,18,29,0,11
D32,Sexual Violation,2018,0,1,0,1
D32,Sexual Violation,2018,12,16,0,4
D32,Sexual Violation,2018,5,15,0,10
D32,Sexual Violation,2018,3,6,0,3
D32,Sexual Violation,2018,2,2,1,0
D32,Sexual Violation,2018,5,16,0,11
D32,Other,2018,4,4,1,0
D32,Other,2018,7,7,1,0
D32,Other,2018,3,3,1,0
D32,Other,2018,1,1,1,0
D32,Other,2018,9,9,1,0
D32,Other,2018,1,1,1,0
D32,Other,2018,9,10,0,1
D32,Other,2018,5,5,1,0
D32,Other,2018,5,6,0,1
D32,Other,2018,5,5,1,0
D32,Other,2018,2,2,1,0
D32,Other,2018,2,2,1,0
D32,Other,2018,6,6,1,0
D32,Other,2018,6,7,0,1
D32,Other,2018,2,2,1,0
D32,Other,2018,7,7,1,0
D32,Other,2018,6,6,1,0
D32,Other,2018,16,17,0,1
D32,Other,2018,19,30,0,11
D32,Other,2018,15,18,0,3
D32,Other,2018,2,2,1,0
D32,Other,2018,27,35,0,8
D32,Other,2018,4,4,1,0
D32,Other,2018,41,47,0,6
D32,Other,2018,7,11,0,4
D32,Other,2018,8,11,0,3
D32,Other Criminal Violations - Offensive Weapons,2018,2,2,1,0
D32,Fraud,2018,9,73,0,64
D32,Theft Under $5000,2018,1,2,0,1
D32,Other,2018,1,2,0,1
D32,Break & Enter-Commercial,2018,3,13,0,10
D31,Robbery-Financial,2018,3,3,1,0
D32,Other Criminal Violations - Offensive Weapons,2018,1,1,1,0
D32,Theft Under $5000,2018,15,170,0,155
D32,Other,2018,7,15,0,8
D32,Fraud,2018,5,36,0,31
D32,Break & Enter-Commercial,2018,1,8,0,7
D32,Theft Under $5000,2018,2,19,0,17
D32,Other,2018,3,4,0,1
D32,Fraud,2018,0,1,0,1
D32,Break & Enter-Commercial,2018,0,2,0,2
D32,Other Criminal Violations - Offensive Weapons,2018,8,8,1,0
D31,Robbery-Other,2018,8,23,0,15
D32,Other Criminal Violations - Offensive Weapons,2018,3,3,1,0
D32,Break & Enter-Commercial,2018,0,1,0,1
D32,Fraud,2018,3,6,0,3
D32,Other,2018,2,18,0,16
D31,Robbery-Other,2018,11,19,0,8
D32,Other Criminal Violations - Offensive Weapons,2018,1,2,0,1
D32,Break & Enter-Commercial,2018,0,9,0,9
D32,Theft Under $5000,2018,68,335,0,267
D32,Fraud,2018,7,48,0,41
D32,Other,2018,4,17,0,13
D31,Robbery-Other,2018,20,45,0,25
D32,Other Criminal Violations - Offensive Weapons,2018,4,5,0,1
D32,Break & Enter-Commercial,2018,0,1,0,1
D32,Theft Under $5000,2018,1,52,0,51
D32,Theft Under $5000,2018,4,76,0,72
D32,Theft Under $5000,2018,49,199,0,150
D32,Theft Under $5000,2018,34,202,0,168
D32,Theft Under $5000,2018,4,70,0,66
D32,Theft Under $5000,2018,0,1,0,1
D32,Theft Under $5000,2018,2,9,0,7
D32,Theft Under $5000,2018,4,76,0,72
D32,Theft Under $5000,2018,47,218,0,171
D32,Theft Under $5000,2018,6,49,0,43
D32,Theft Under $5000,2018,11,123,0,112
D32,Theft Under $5000,2018,9,136,0,127
D32,Theft Under $5000,2018,59,230,0,171
D32,Theft Under $5000,2018,140,403,0,263
D32,Theft Under $5000,2018,547,952,0,405
D32,Assault,2018,43,65,0,22
D32,Assault,2018,39,62,0,23
D32,Assault,2018,2,2,1,0
D32,Assault,2018,2,2,1,0
D32,Assault,2018,18,33,0,15
D32,Assault,2018,8,12,0,4
D32,Assault,2018,43,77,0,34
D32,Assault,2018,25,41,0,16
D32,Assault,2018,29,46,0,17
D32,Assault,2018,41,74,0,33
D32,Assault,2018,42,59,0,17
D32,Assault,2018,15,23,0,8
D32,Assault,2018,1,3,0,2
D32,Assault,2018,39,73,0,34
D32,Other Criminal Violations - Offensive Weapons,2018,10,10,1,0
D32,Fraud,2018,8,105,0,97
D32,Break & Enter-Commercial,2018,1,4,0,3
D32,Other,2018,6,24,0,18
D31,Robbery-Other,2018,15,25,0,10
D31,Robbery-Other,2018,13,26,0,13
D31,Robbery-Other,2018,1,1,1,0
D31,Robbery-Other,2018,15,34,0,19
D31,Robbery-Other,2018,6,11,0,5
D31,Robbery-Other,2018,27,62,0,35
D31,Sexual Violation,2018,21,36,0,15
D31,Sexual Violation,2018,7,19,0,12
D31,Sexual Violation,2018,21,31,0,10
D31,Sexual Violation,2018,8,13,0,5
D31,Sexual Violation,2018,11,15,0,4
D31,Sexual Violation,2018,18,25,0,7
D31,Sexual Violation,2018,2,4,0,2
D31,Sexual Violation,2018,27,49,0,22
D31,Other,2018,8,8,1,0
D31,Other,2018,10,10,1,0
D31,Other,2018,26,29,0,3
D31,Other,2018,9,9,1,0
D31,Other,2018,19,20,0,1
D31,Other,2018,1,1,1,0
D31,Other,2018,1,1,1,0
D31,Other,2018,17,20,0,3
D31,Other,2018,6,6,1,0
D31,Other,2018,28,30,0,2
D31,Other,2018,95,111,0,16
D31,Other,2018,1,1,1,0
D31,Other,2018,20,24,0,4
D31,Other,2018,116,138,0,22
D31,Other,2018,25,31,0,6
D31,Other,2018,163,173,0,10
D31,Other,2018,18,19,0,1
D31,Other,2018,122,133,0,11
D31,Other,2018,17,19,0,2
D31,Other,2018,97,112,0,15
D31,Other Criminal Violations - Offensive Weapons,2018,19,23,0,4
D31,Other Criminal Violations - Offensive Weapons,2018,5,8,0,3
D31,Other Criminal Violations - Offensive Weapons,2018,32,43,0,11
D31,Other Criminal Violations - Offensive Weapons,2018,11,12,0,1
D31,Other Criminal Violations - Offensive Weapons,2018,8,12,0,4
D31,Other Criminal Violations - Offensive Weapons,2018,1,2,0,1
D31,Other Criminal Violations - Offensive Weapons,2018,28,31,0,3
D32,Break & Enter-Commercial,2018,1,3,0,2
D32,Other Criminal Violations - Offensive Weapons,2018,0,1,0,1
D32,Fraud,2018,0,29,0,29
D32,Other,2018,3,10,0,7
D32,Other Criminal Violations - Offensive Weapons,2018,5,6,0,1
D32,Other,2018,0,1,0,1
D32,Break & Enter-Commercial,2018,1,7,0,6
D32,Other Criminal Violations - Offensive Weapons,2018,9,9,1,0
D32,Fraud,2018,6,62,0,56
D32,Other,2018,11,29,0,18
D32,Break & Enter-Commercial,2018,1,1,1,0
D32,Other Criminal Violations - Offensive Weapons,2018,4,4,1,0
D32,Fraud,2018,10,68,0,58
D32,Other,2018,20,41,0,21
D32,Break & Enter-Commercial,2018,0,1,0,1
D32,Fraud,2018,8,70,0,62
D32,Other Criminal Violations - Offensive Weapons,2018,6,6,1,0
D32,Other Criminal Violations - Offensive Weapons,2018,4,5,0,1
D32,Fraud,2018,16,78,0,62
D32,Other,2018,3,7,0,4
D32,Other Criminal Violations - Offensive Weapons,2018,11,12,0,1
D32,Break & Enter-Commercial,2018,2,5,0,3
D32,Break & Enter-Commercial,2018,0,3,0,3
D32,Break & Enter-Commercial,2018,7,66,0,59
D32,Break & Enter-Commercial,2018,7,33,0,26
D32,Break & Enter-House,2018,2,3,0,1
D32,Break & Enter-House,2018,1,9,0,8
D32,Break & Enter-House,2018,0,42,0,42
D32,Break & Enter-House,2018,1,25,0,24
D32,Break & Enter-House,2018,2,25,0,23
D32,Break & Enter-House,2018,0,8,0,8
D32,Break & Enter-House,2018,3,51,0,48
D32,Break & Enter-House,2018,1,17,0,16
D32,Break & Enter-House,2018,3,30,0,27
D32,Other,2018,11,20,0,9
D32,Other Criminal Violations - Offensive Weapons,2018,0,1,0,1
D32,Break & Enter-House,2018,1,12,0,11
D32,Fraud,2018,39,157,0,118
D32,Other,2018,18,38,0,20
D32,Other Criminal Violations - Offensive Weapons,2018,16,21,0,5
D32,Break & Enter-House,2018,0,45,0,45
D32,Other,2018,13,31,0,18
D32,Other,2018,16,27,0,11
D32,Other,2018,0,1,0,1
D32,Break & Enter-House,2018,2,27,0,25
D32,Other,2018,15,51,0,36
D32,Other,2018,6,12,0,6
D32,Other,2018,0,1,0,1
D32,Break & Enter-House,2018,0,40,0,40
D32,Other,2018,1,1,1,0
D32,Other,2018,12,26,0,14
D32,Other,2018,0,1,0,1
D32,Break & Enter-House,2018,1,21,0,20
D32,Other,2018,13,72,0,59
D32,Robbery-Financial,2018,1,1,1,0
D32,Other,2018,2,2,1,0
D32,Break & Enter-House,2018,2,27,0,25
D32,Other,2018,1,14,0,13
D32,Robbery-Financial,2018,1,1,1,0
D32,Other,2018,3,3,1,0
D32,Robbery-Financial,2018,1,1,1,0
D32,Break & Enter-House,2018,1,5,0,4
D32,Other,2018,0,1,0,1
D32,Other,2018,33,81,0,48
D32,Robbery-Financial,2018,1,1,1,0
D32,Break & Enter-Other,2018,0,1,0,1
D32,Other,2018,1,2,0,1
D32,Other,2018,7,18,0,11
D32,Robbery-Financial,2018,2,2,1,0
D32,Break & Enter-Other,2018,0,5,0,5
D32,Other,2018,1,1,1,0
D32,Other,2018,4,36,0,32
D32,Robbery-Other,2018,2,9,0,7
D32,Break & Enter-Other,2018,0,3,0,3
D33,Other,2018,4,6,0,2
D32,Other,2018,14,43,0,29
D32,Robbery-Other,2018,2,8,0,6
D32,Break & Enter-Other,2018,0,1,0,1
D33,Other,2018,6,7,0,1
D32,Other,2018,13,52,0,39
D32,Robbery-Other,2018,1,10,0,9
D33,Other,2018,1,1,1,0
D32,Other,2018,10,56,0,46
D32,Robbery-Other,2018,1,8,0,7
D33,Other,2018,13,17,0,4
D32,Other,2018,2,5,0,3
D32,Robbery-Other,2018,2,8,0,6
D33,Other,2018,12,12,1,0
D32,Other,2018,13,45,0,32
D32,Robbery-Other,2018,11,29,0,18
D33,Other,2018,1,1,1,0
D32,Other,2018,24,80,0,56
D32,Robbery-Other,2018,0,8,0,8
D33,Other,2018,13,14,0,1
D32,Other,2018,5,18,0,13
D32,Robbery-Other,2018,8,30,0,22
D33,Other,2018,5,5,1,0
D32,Other,2018,24,62,0,38
D32,Robbery-Other,2018,2,2,1,0
D33,Other,2018,3,3,1,0
D32,Other,2018,12,54,0,42
D32,Robbery-Other,2018,0,6,0,6
D32,Other,2018,17,47,0,30
D33,Other,2018,1,1,1,0
D32,Robbery-Other,2018,7,21,0,14
D32,Robbery-Other,2018,1,4,0,3
D32,Robbery-Other,2018,4,14,0,10
D32,Other,2018,19,57,0,38
D32,Other,2018,262,325,0,63
D32,Theft Over $5000,2018,1,5,0,4
D32,Theft Over $5000,2018,1,4,0,3
D32,Theft Over $5000,2018,1,5,0,4
D33,Other,2018,1,1,1,0
D33,Theft Under $5000,2018,82,368,0,286
D33,Other,2018,2,2,1,0
D33,Theft Under $5000,2018,100,328,0,228
D33,Auto Theft,2018,2,31,0,29
D33,Theft Under $5000,2018,8,89,0,81
D33,Auto Theft,2018,2,12,0,10
D33,Theft Under $5000,2018,0,5,0,5
D33,Auto Theft,2018,1,7,0,6
D33,Theft Under $5000,2018,246,500,0,254
D33,Auto Theft,2018,0,2,0,2
D33,Theft Under $5000,2018,13,86,0,73
D33,Auto Theft,2018,0,1,0,1
D33,Other,2018,37,43,0,6
D33,Theft Under $5000,2018,0,3,0,3
D33,Auto Theft,2018,3,26,0,23
D33,Other,2018,29,33,0,4
D33,Theft Under $5000,2018,8,72,0,64
D33,Auto Theft,2018,0,11,0,11
D33,Break & Enter-House,2018,1,27,0,26
D33,Other,2018,15,18,0,3
D33,Theft Under $5000,2018,15,103,0,88
D33,Auto Theft,2018,3,16,0,13
D33,Other,2018,3,5,0,2
D33,Break & Enter-House,2018,1,7,0,6
D33,Other,2018,2,2,1,0
D41,Assault,2018,125,196,0,71
D33,Theft Under $5000,2018,0,1,0,1
D33,Auto Theft,2018,3,26,0,23
D41,Auto Theft,2018,1,3,0,2
D41,Fraud,2018,12,99,0,87
D33,Other,2018,6,15,0,9
D33,Break & Enter-Other,2018,0,2,0,2
D33,Other,2018,33,42,0,9
D33,Theft Under $5000,2018,0,6,0,6
D41,Assault,2018,7,9,0,2
D33,Auto Theft,2018,0,9,0,9
D41,Auto Theft,2018,7,33,0,26
D41,Assault,2018,105,135,0,30
D41,Fraud,2018,0,11,0,11
D41,Assault,2018,116,183,0,67
D33,Other,2018,44,48,0,4
D33,Break & Enter-Other,2018,0,2,0,2
D33,Auto Theft,2018,1,13,0,12
D33,Theft Under $5000,2018,11,70,0,59
D41,Auto Theft,2018,1,4,0,3
D33,Other,2018,1,1,1,0
D41,Attempt Murder,2018,3,3,1,0
D33,Auto Theft,2018,2,10,0,8
D33,Break & Enter-Other,2018,0,1,0,1
D41,Fraud,2018,12,91,0,79
D33,Other,2018,1,1,1,0
D33,Other,2018,20,26,0,6
D33,Auto Theft,2018,0,7,0,7
D33,Break & Enter-Other,2018,0,2,0,2
D41,Attempt Murder,2018,1,1,1,0
D41,Fraud,2018,2,25,0,23
D33,Theft Under $5000,2018,26,108,0,82
D33,Other,2018,8,15,0,7
D33,Other,2018,13,13,1,0
D33,Auto Theft,2018,0,2,0,2
D33,Break & Enter-Other,2018,0,1,0,1
D41,Attempt Murder,2018,1,2,0,1
D41,Fraud,2018,11,47,0,36
D33,Theft Under $5000,2018,29,171,0,142
D33,Other,2018,1,2,0,1
D33,Other,2018,1,1,1,0
D33,Break & Enter-Apartment,2018,6,18,0,12
D33,Fraud,2018,12,110,0,98
D41,Attempt Murder,2018,2,2,1,0
D41,Fraud,2018,2,57,0,55
D33,Theft Under $5000,2018,0,1,0,1
D33,Robbery-Financial,2018,1,1,1,0
D33,Other,2018,12,15,0,3
D33,Break & Enter-Apartment,2018,0,7,0,7
D33,Fraud,2018,6,87,0,81
D41,Attempt Murder,2018,2,2,1,0
D41,Fraud,2018,2,8,0,6
D33,Theft Under $5000,2018,21,91,0,70
D33,Robbery-Financial,2018,1,1,1,0
D33,Other,2018,7,12,0,5
D33,Break & Enter-Apartment,2018,0,4,0,4
D33,Fraud,2018,1,37,0,36
D41,Attempt Murder,2018,1,1,1,0
D33,Robbery-Other,2018,0,8,0,8
D33,Theft Under $5000,2018,0,1,0,1
D41,Fraud,2018,8,46,0,38
D33,Other,2018,11,12,0,1
D33,Break & Enter-Apartment,2018,1,10,0,9
D33,Fraud,2018,0,5,0,5
D41,Other,2018,2,5,0,3
D41,Auto Theft,2018,3,18,0,15
D33,Theft Under $5000,2018,0,2,0,2
D33,Break & Enter-Apartment,2018,4,22,0,18
D33,Fraud,2018,12,114,0,102
D33,Other,2018,2,2,1,0
D41,Other,2018,18,25,0,7
D33,Assault,2018,44,71,0,27
D41,Auto Theft,2018,13,87,0,74
D33,Robbery-Other,2018,1,5,0,4
D33,Break & Enter-Apartment,2018,2,10,0,8
D33,Fraud,2018,0,41,0,41
D33,Other,2018,12,14,0,2
D41,Other,2018,26,42,0,16
D33,Assault,2018,45,56,0,11
D41,Fraud,2018,28,142,0,114
D41,Break & Enter-Apartment,2018,0,1,0,1
D33,Robbery-Other,2018,2,6,0,4
D33,Break & Enter-Apartment,2018,0,3,0,3
D33,Fraud,2018,0,1,0,1
D33,Other,2018,3,4,0,1
D41,Other,2018,36,58,0,22
D33,Assault,2018,23,36,0,13
D41,Other,2018,9,20,0,11
D41,Break & Enter-Apartment,2018,1,3,0,2
D33,Robbery-Other,2018,0,1,0,1
D33,Break & Enter-Apartment,2018,0,16,0,16
D33,Fraud,2018,8,63,0,55
D33,Other,2018,2,2,1,0
D41,Other,2018,3,8,0,5
D33,Assault,2018,2,6,0,4
D41,Other,2018,16,41,0,25
D41,Break & Enter-Apartment,2018,6,19,0,13
D33,Robbery-Other,2018,10,30,0,20
D33,Break & Enter-Apartment,2018,3,4,0,1
D33,Fraud,2018,4,46,0,42
D33,Other Criminal Violations - Offensive Weapons,2018,4,4,1,0
D41,Other,2018,14,29,0,15
D33,Assault,2018,0,1,0,1
D41,Other,2018,42,131,0,89
D33,Fraud,2018,0,2,0,2
D41,Break & Enter-Apartment,2018,7,12,0,5
D33,Fraud,2018,3,37,0,34
D33,Break & Enter-Apartment,2018,0,1,0,1
D33,Robbery-Other,2018,4,15,0,11
D33,Other Criminal Violations - Offensive Weapons,2018,2,2,1,0
D33,Assault,2018,69,108,0,39
D33,Robbery-Other,2018,4,8,0,4
D33,Fraud,2018,2,40,0,38
D33,Break & Enter-Apartment,2018,0,11,0,11
D41,Break & Enter-Apartment,2018,0,1,0,1
D41,Other,2018,5,8,0,3
D41,Other,2018,57,141,0,84
D33,Break & Enter-Commercial,2018,6,12,0,6
D41,Other,2018,23,28,0,5
D41,Break & Enter-Apartment,2018,4,15,0,11
D33,Fraud,2018,4,36,0,32
D33,Other Criminal Violations - Offensive Weapons,2018,2,3,0,1
D33,Assault,2018,59,83,0,24
D41,Other,2018,6,17,0,11
D33,Break & Enter-Commercial,2018,0,4,0,4
D41,Other,2018,30,52,0,22
D41,Break & Enter-Apartment,2018,1,10,0,9
D33,Fraud,2018,0,1,0,1
D33,Other Criminal Violations - Offensive Weapons,2018,8,12,0,4
D33,Assault,2018,2,3,0,1
D41,Other,2018,51,111,0,60
D33,Break & Enter-Commercial,2018,0,3,0,3
D41,Other,2018,19,32,0,13
D41,Break & Enter-Apartment,2018,3,8,0,5
D33,Fraud,2018,3,47,0,44
D33,Other Criminal Violations - Offensive Weapons,2018,13,15,0,2
D33,Assault,2018,47,70,0,23
D41,Other,2018,17,39,0,22
D33,Break & Enter-Commercial,2018,2,10,0,8
D41,Other,2018,25,43,0,18
D41,Break & Enter-Apartment,2018,8,20,0,12
D33,Fraud,2018,0,1,0,1
D33,Other Criminal Violations - Offensive Weapons,2018,3,5,0,2
D33,Assault,2018,39,65,0,26
D41,Other,2018,20,51,0,31
D33,Break & Enter-Commercial,2018,2,2,1,0
D41,Robbery-Financial,2018,1,1,1,0
D33,Assault,2018,0,2,0,2
D41,Break & Enter-Apartment,2018,2,25,0,23
D33,Other,2018,19,90,0,71
D33,Break & Enter-Commercial,2018,0,8,0,8
D41,Robbery-Financial,2018,1,1,1,0
D33,Robbery-Other,2018,3,14,0,11
D33,Other Criminal Violations - Offensive Weapons,2018,3,3,1,0
D41,Other,2018,72,140,0,68
D33,Other,2018,10,34,0,24
D33,Robbery-Other,2018,0,1,0,1
D41,Robbery-Financial,2018,3,3,1,0
D33,Other Criminal Violations - Offensive Weapons,2018,3,3,1,0
D41,Break & Enter-Apartment,2018,1,8,0,7
D33,Break & Enter-Commercial,2018,0,3,0,3
D33,Assault,2018,0,1,0,1
D41,Other,2018,9,16,0,7
D33,Other,2018,4,22,0,18
D33,Robbery-Other,2018,2,2,1,0
D41,Robbery-Financial,2018,1,1,1,0
D33,Other Criminal Violations - Offensive Weapons,2018,2,2,1,0
D41,Break & Enter-Commercial,2018,1,8,0,7
D33,Break & Enter-Commercial,2018,0,3,0,3
D33,Assault,2018,27,43,0,16
D41,Other,2018,41,94,0,53
D33,Other,2018,2,6,0,4
D33,Robbery-Other,2018,2,5,0,3
D41,Robbery-Financial,2018,0,1,0,1
D33,Other Criminal Violations - Offensive Weapons,2018,1,1,1,0
D41,Break & Enter-Commercial,2018,6,16,0,10
D33,Break & Enter-Commercial,2018,0,1,0,1
D33,Assault,2018,17,35,0,18
D41,Other,2018,75,144,0,69
D33,Other,2018,32,88,0,56
D33,Robbery-Other,2018,3,7,0,4
D41,Robbery-Other,2018,0,1,0,1
D33,Other Criminal Violations - Offensive Weapons,2018,1,1,1,0
D41,Break & Enter-Commercial,2018,13,30,0,17
D33,Break & Enter-Commercial,2018,0,1,0,1
D33,Assault,2018,23,34,0,11
D41,Theft Over $5000,2018,1,2,0,1
D33,Other,2018,17,48,0,31
D33,Robbery-Other,2018,2,10,0,8
D41,Robbery-Other,2018,9,10,0,1
D33,Other,2018,2,2,1,0
D33,Robbery-Other,2018,1,2,0,1
D33,Assault,2018,2,2,1,0
D41,Break & Enter-Commercial,2018,1,3,0,2
D41,Robbery-Other,2018,8,16,0,8
D41,Theft Over $5000,2018,2,8,0,6
D33,Break & Enter-Commercial,2018,0,4,0,4
D33,Other,2018,1,1,1,0
D33,Other,2018,10,36,0,26
D33,Other,2018,1,1,1,0
D41,Theft Over $5000,2018,2,12,0,10
D33,Assault,2018,2,5,0,3
D33,Break & Enter-Commercial,2018,3,5,0,2
D33,Sexual Violation,2018,6,11,0,5
D33,Other,2018,6,37,0,31
D41,Robbery-Other,2018,3,20,0,17
D41,Other,2018,2,2,1,0
D41,Theft Over $5000,2018,2,15,0,13
D33,Assault,2018,35,42,0,7
D33,Break & Enter-Commercial,2018,2,5,0,3
D33,Sexual Violation,2018,2,4,0,2
D33,Other,2018,0,1,0,1
D41,Robbery-Other,2018,0,7,0,7
D41,Other,2018,3,3,1,0
D41,Break & Enter-Commercial,2018,3,32,0,29
D41,Theft Over $5000,2018,1,3,0,2
D33,Assault,2018,1,6,0,5
D33,Break & Enter-House,2018,2,54,0,52
D33,Sexual Violation,2018,2,2,1,0
D33,Other,2018,10,27,0,17
D41,Robbery-Other,2018,13,33,0,20
D41,Other,2018,10,12,0,2
D41,Break & Enter-Commercial,2018,1,7,0,6
D41,Theft Over $5000,2018,0,1,0,1
D33,Attempt Murder,2018,0,2,0,2
D33,Break & Enter-House,2018,1,39,0,38
D33,Sexual Violation,2018,5,12,0,7
D33,Other,2018,4,28,0,24
D41,Robbery-Other,2018,4,13,0,9
D41,Other,2018,23,27,0,4
D41,Break & Enter-Commercial,2018,0,3,0,3
D41,Theft Over $5000,2018,10,20,0,10
D33,Attempt Murder,2018,0,1,0,1
D33,Break & Enter-House,2018,1,21,0,20
D33,Sexual Violation,2018,6,8,0,2
D33,Other,2018,7,31,0,24
D41,Robbery-Other,2018,2,7,0,5
D41,Robbery-Other,2018,15,29,0,14
D41,Robbery-Other,2018,3,5,0,2
D41,Robbery-Other,2018,15,33,0,18
D41,Robbery-Other,2018,17,27,0,10
D41,Sexual Violation,2018,4,9,0,5
D41,Sexual Violation,2018,14,15,0,1
D41,Sexual Violation,2018,12,20,0,8
D41,Sexual Violation,2018,14,25,0,11
D41,Sexual Violation,2018,2,6,0,4
D41,Sexual Violation,2018,14,26,0,12
D41,Sexual Violation,2018,3,5,0,2
D41,Sexual Violation,2018,10,13,0,3
D41,Sexual Violation,2018,12,24,0,12
D41,Sexual Violation,2018,1,1,1,0
D41,Sexual Violation,2018,2,4,0,2
D41,Sexual Violation,2018,9,16,0,7
D33,Break & Enter-House,2018,1,13,0,12
D33,Other,2018,14,36,0,22
D41,Other,2018,5,6,0,1
D33,Sexual Violation,2018,3,4,0,1
D41,Break & Enter-Commercial,2018,4,12,0,8
D33,Other,2018,0,1,0,1
D41,Theft Over $5000,2018,0,4,0,4
D33,Break & Enter-House,2018,0,36,0,36
D41,Other,2018,13,13,1,0
D33,Other,2018,8,28,0,20
D33,Other,2018,14,21,0,7
D41,Theft Over $5000,2018,3,13,0,10
D33,Break & Enter-House,2018,2,19,0,17
D41,Other,2018,18,18,1,0
D33,Other,2018,1,4,0,3
D33,Other,2018,5,8,0,3
D41,Theft Under $5000,2018,5,39,0,34
D33,Break & Enter-House,2018,0,4,0,4
D41,Other,2018,9,11,0,2
D33,Theft Over $5000,2018,0,8,0,8
D33,Other,2018,3,5,0,2
D41,Theft Under $5000,2018,46,103,0,57
D33,Break & Enter-House,2018,2,36,0,34
D41,Other,2018,10,10,1,0
D33,Theft Over $5000,2018,0,7,0,7
D33,Other,2018,4,14,0,10
D41,Theft Under $5000,2018,54,231,0,177
D33,Other,2018,13,34,0,21
D33,Break & Enter-House,2018,2,17,0,15
D33,Other,2018,0,1,0,1
D33,Theft Over $5000,2018,0,2,0,2
D41,Other,2018,0,1,0,1
D33,Break & Enter-House,2018,0,25,0,25
D33,Other,2018,8,21,0,13
D33,Sexual Violation,2018,6,14,0,8
D41,Theft Under $5000,2018,109,408,0,299
D33,Theft Over $5000,2018,0,1,0,1
D41,Break & Enter-Commercial,2018,4,20,0,16
D41,Other,2018,24,25,0,1
D33,Other,2018,11,21,0,10
D33,Sexual Violation,2018,0,1,0,1
D33,Theft Over $5000,2018,1,11,0,10
D41,Break & Enter-Commercial,2018,15,57,0,42
D41,Other,2018,21,22,0,1
D33,Other,2018,0,1,0,1
D33,Sexual Violation,2018,3,5,0,2
D33,Theft Over $5000,2018,0,3,0,3
D41,Theft Under $5000,2018,3,34,0,31
D41,Break & Enter-House,2018,1,5,0,4
D41,Auto Theft,2018,1,7,0,6
D33,Other,2018,4,11,0,7
D33,Sexual Violation,2018,5,5,1,0
D33,Theft Over $5000,2018,0,6,0,6
D41,Theft Under $5000,2018,84,430,0,346
D41,Break & Enter-House,2018,3,11,0,8
D41,Auto Theft,2018,3,14,0,11
D33,Sexual Violation,2018,2,12,0,10
D33,Theft Over $5000,2018,2,8,0,6
D41,Theft Under $5000,2018,11,50,0,39
D41,Break & Enter-House,2018,3,28,0,25
D41,Auto Theft,2018,1,24,0,23
D33,Sexual Violation,2018,5,10,0,5
D33,Theft Over $5000,2018,1,4,0,3
D41,Theft Under $5000,2018,18,71,0,53
D41,Break & Enter-House,2018,5,19,0,14
D41,Auto Theft,2018,5,47,0,42
D33,Sexual Violation,2018,0,3,0,3
D33,Theft Over $5000,2018,0,5,0,5
D41,Theft Under $5000,2018,63,318,0,255
D41,Break & Enter-House,2018,3,8,0,5
D41,Auto Theft,2018,1,7,0,6
D33,Theft Over $5000,2018,2,5,0,3
D41,Theft Under $5000,2018,111,138,0,27
D33,Theft Over $5000,2018,0,1,0,1
D33,Other,2018,19,22,0,3
D41,Auto Theft,2018,9,82,0,73
D41,Break & Enter-House,2018,1,13,0,12
D33,Other,2018,10,10,1,0
D41,Auto Theft,2018,0,7,0,7
D41,Break & Enter-House,2018,0,2,0,2
D33,Other,2018,4,4,1,0
D41,Break & Enter-House,2018,4,7,0,3
D33,Other,2018,9,9,1,0
D41,Break & Enter-House,2018,2,11,0,9
D33,Other,2018,4,4,1,0
D41,Break & Enter-House,2018,7,15,0,8
D33,Other,2018,9,9,1,0
D41,Break & Enter-House,2018,3,29,0,26
D33,Other,2018,7,7,1,0
D41,Break & Enter-Other,2018,0,1,0,1
D33,Other,2018,3,3,1,0
D41,Break & Enter-Other,2018,0,1,0,1
D33,Other,2018,1,1,1,0
D41,Break & Enter-Other,2018,0,7,0,7
D33,Other,2018,5,5,1,0
D41,Break & Enter-Other,2018,1,4,0,3
D33,Other,2018,3,3,1,0
D41,Break & Enter-Other,2018,2,6,0,4
D33,Other,2018,7,7,1,0
D41,Break & Enter-Other,2018,1,3,0,2
D33,Other,2018,6,6,1,0
D41,Break & Enter-Other,2018,0,1,0,1
D33,Other,2018,1,1,1,0
D41,Break & Enter-Other,2018,1,5,0,4
D33,Other,2018,8,8,1,0
D41,Break & Enter-Other,2018,2,5,0,3
D33,Other,2018,3,3,1,0
D41,Break & Enter-Other,2018,1,6,0,5
D41,Fraud,2018,4,16,0,12
D41,Fraud,2018,2,22,0,20
D41,Fraud,2018,2,39,0,37
D41,Theft Under $5000,2018,97,345,0,248
D41,Theft Under $5000,2018,317,822,0,505
D41,Assault,2018,23,34,0,11
D41,Assault,2018,25,41,0,16
D41,Assault,2018,120,186,0,66
D41,Assault,2018,153,260,0,107
D41,Assault,2018,31,38,0,7
D41,Assault,2018,115,175,0,60
D41,Assault,2018,36,58,0,22
D41,Assault,2018,48,72,0,24
D42,Robbery-Other,2018,2,5,0,3
D42,Sexual Violation,2018,4,11,0,7
D42,Sexual Violation,2018,7,17,0,10
D42,Sexual Violation,2018,6,15,0,9
D42,Sexual Violation,2018,2,9,0,7
D42,Sexual Violation,2018,11,19,0,8
D42,Sexual Violation,2018,4,10,0,6
D42,Sexual Violation,2018,7,7,1,0
D43,Other,2018,21,64,0,43
D42,Sexual Violation,2018,7,14,0,7
D42,Sexual Violation,2018,2,9,0,7
D42,Sexual Violation,2018,4,14,0,10
D42,Sexual Violation,2018,3,6,0,3
D42,Other,2018,12,13,0,1
D42,Other,2018,14,15,0,1
D43,Other,2018,3,5,0,2
D42,Other,2018,5,5,1,0
D43,Other,2018,42,92,0,50
D42,Theft Under $5000,2018,90,307,0,217
D42,Other,2018,5,5,1,0
D43,Other,2018,124,240,0,116
D42,Other,2018,13,13,1,0
D42,Theft Under $5000,2018,42,229,0,187
D43,Other,2018,7,29,0,22
D42,Other,2018,18,18,1,0
D42,Theft Under $5000,2018,1,4,0,3
D43,Other,2018,50,110,0,60
D43,Break & Enter-Commercial,2018,1,2,0,1
D42,Other,2018,12,12,1,0
D42,Theft Under $5000,2018,5,65,0,60
D43,Theft Over $5000,2018,4,11,0,7
D42,Other,2018,25,25,1,0
D43,Break & Enter-Commercial,2018,0,1,0,1
D42,Theft Under $5000,2018,115,484,0,369
D42,Other,2018,0,2,0,2
D43,Theft Over $5000,2018,2,2,1,0
D42,Other,2018,4,4,1,0
D43,Break & Enter-Commercial,2018,11,20,0,9
D42,Theft Under $5000,2018,9,119,0,110
D43,Theft Over $5000,2018,1,3,0,2
D42,Other,2018,4,5,0,1
D42,Other,2018,15,15,1,0
D42,Other,2018,12,12,1,0
D43,Break & Enter-Commercial,2018,20,33,0,13
D42,Assault,2018,49,72,0,23
D43,Theft Over $5000,2018,0,3,0,3
D42,Other,2018,1,1,1,0
D42,Other,2018,0,1,0,1
D42,Other,2018,2,2,1,0
D42,Other,2018,1,1,1,0
D42,Other,2018,2,2,1,0
D43,Other,2018,16,18,0,2
D43,Other,2018,4,4,1,0
D43,Other,2018,13,13,1,0
D43,Other,2018,18,18,1,0
D43,Other,2018,44,46,0,2
D43,Other,2018,3,4,0,1
D43,Other,2018,18,24,0,6
D43,Other,2018,17,22,0,5
D43,Other,2018,4,6,0,2
D43,Other,2018,41,43,0,2
D43,Other,2018,59,61,0,2
D43,Other,2018,5,5,1,0
D43,Other,2018,13,16,0,3
D43,Auto Theft,2018,2,8,0,6
D43,Auto Theft,2018,3,25,0,22
D43,Auto Theft,2018,2,10,0,8
D43,Auto Theft,2018,8,16,0,8
D43,Auto Theft,2018,2,4,0,2
D43,Auto Theft,2018,12,35,0,23
D43,Auto Theft,2018,0,2,0,2
D43,Auto Theft,2018,3,20,0,17
D43,Auto Theft,2018,2,12,0,10
D43,Auto Theft,2018,5,20,0,15
D43,Auto Theft,2018,6,27,0,21
D43,Auto Theft,2018,3,8,0,5
D43,Auto Theft,2018,14,25,0,11
D43,Break & Enter-Apartment,2018,2,3,0,1
D43,Break & Enter-Apartment,2018,5,7,0,2
D43,Break & Enter-Apartment,2018,6,14,0,8
D43,Break & Enter-Apartment,2018,4,13,0,9
D43,Break & Enter-Apartment,2018,0,1,0,1
D43,Break & Enter-Apartment,2018,3,4,0,1
D43,Break & Enter-Apartment,2018,3,12,0,9
D43,Break & Enter-Apartment,2018,23,42,0,19
D43,Break & Enter-Apartment,2018,3,14,0,11
D43,Break & Enter-Commercial,2018,1,3,0,2
D43,Break & Enter-Commercial,2018,0,2,0,2
D43,Break & Enter-Commercial,2018,2,8,0,6
D43,Break & Enter-Commercial,2018,12,19,0,7
D43,Break & Enter-Commercial,2018,3,6,0,3
D43,Break & Enter-Commercial,2018,5,12,0,7
D43,Break & Enter-Commercial,2018,1,7,0,6
D43,Break & Enter-Commercial,2018,1,4,0,3
D42,Break & Enter-Other,2018,1,2,0,1
D43,Theft Over $5000,2018,0,4,0,4
D42,Other,2018,5,5,1,0
D43,Break & Enter-Commercial,2018,1,4,0,3
D42,Other,2018,8,8,1,0
D43,Theft Over $5000,2018,0,1,0,1
D42,Other,2018,0,1,0,1
D42,Assault,2018,61,96,0,35
D42,Other,2018,5,5,1,0
D43,Theft Over $5000,2018,2,3,0,1
D42,Other,2018,26,32,0,6
D42,Assault,2018,39,64,0,25
D42,Other,2018,5,5,1,0
D43,Theft Over $5000,2018,0,2,0,2
D43,Break & Enter-Commercial,2018,4,21,0,17
D42,Other,2018,63,70,0,7
D42,Assault,2018,47,73,0,26
D42,Other,2018,7,8,0,1
D43,Theft Over $5000,2018,1,4,0,3
D43,Break & Enter-House,2018,4,8,0,4
D42,Other,2018,2,2,1,0
D42,Assault,2018,95,150,0,55
D42,Other,2018,3,3,1,0
D43,Theft Over $5000,2018,2,5,0,3
D43,Break & Enter-House,2018,0,5,0,5
D42,Other,2018,2,2,1,0
D42,Assault,2018,57,87,0,30
D42,Auto Theft,2018,4,42,0,38
D43,Theft Over $5000,2018,1,3,0,2
D43,Break & Enter-House,2018,2,5,0,3
D42,Other,2018,19,23,0,4
D42,Assault,2018,44,64,0,20
D42,Auto Theft,2018,5,39,0,34
D43,Theft Over $5000,2018,1,10,0,9
D43,Break & Enter-House,2018,5,14,0,9
D42,Other,2018,27,31,0,4
D42,Assault,2018,67,98,0,31
D42,Auto Theft,2018,1,13,0,12
D43,Theft Under $5000,2018,9,30,0,21
D43,Break & Enter-House,2018,1,3,0,2
D42,Other,2018,60,68,0,8
D42,Assault,2018,1,3,0,2
D42,Auto Theft,2018,2,19,0,17
D42,Break & Enter-Other,2018,0,1,0,1
D43,Theft Under $5000,2018,425,630,0,205
D43,Break & Enter-House,2018,2,11,0,9
D42,Other,2018,21,26,0,5
D42,Assault,2018,20,31,0,11
D42,Assault,2018,72,119,0,47
D42,Assault,2018,31,49,0,18
D42,Attempt Murder,2018,2,2,1,0
D42,Attempt Murder,2018,0,1,0,1
D42,Attempt Murder,2018,0,1,0,1
D42,Attempt Murder,2018,1,1,1,0
D42,Attempt Murder,2018,1,1,1,0
D42,Attempt Murder,2018,0,2,0,2
D42,Attempt Murder,2018,1,1,1,0
D42,Other,2018,7,22,0,15
D42,Other,2018,27,44,0,17
D42,Other,2018,7,11,0,4
D42,Other,2018,17,34,0,17
D42,Other,2018,38,70,0,32
D42,Other,2018,7,28,0,21
D42,Other,2018,4,17,0,13
D42,Other,2018,15,38,0,23
D42,Other,2018,4,6,0,2
D42,Other,2018,16,36,0,20
D42,Other,2018,9,15,0,6
D42,Robbery-Financial,2018,1,1,1,0
D42,Robbery-Financial,2018,2,2,1,0
D42,Robbery-Financial,2018,1,1,1,0
D42,Robbery-Financial,2018,2,2,1,0
D42,Robbery-Other,2018,10,41,0,31
D42,Robbery-Other,2018,7,28,0,21
D42,Robbery-Other,2018,6,20,0,14
D42,Robbery-Other,2018,8,17,0,9
D42,Robbery-Other,2018,8,29,0,21
D42,Robbery-Other,2018,7,19,0,12
D42,Robbery-Other,2018,3,13,0,10
D42,Robbery-Other,2018,4,18,0,14
D42,Robbery-Other,2018,2,9,0,7
D42,Robbery-Other,2018,4,15,0,11
D42,Other,2018,47,52,0,5
D42,Auto Theft,2018,5,35,0,30
D43,Theft Under $5000,2018,14,75,0,61
D43,Break & Enter-House,2018,1,8,0,7
D42,Other,2018,36,40,0,4
D42,Auto Theft,2018,2,27,0,25
D43,Theft Under $5000,2018,65,180,0,115
D43,Break & Enter-House,2018,2,24,0,22
D42,Other,2018,11,14,0,3
D42,Auto Theft,2018,2,94,0,92
D43,Theft Under $5000,2018,57,157,0,100
D43,Break & Enter-House,2018,1,12,0,11
D42,Other,2018,42,49,0,7
D42,Auto Theft,2018,5,47,0,42
D43,Theft Under $5000,2018,160,356,0,196
D43,Break & Enter-House,2018,1,9,0,8
D42,Other,2018,23,26,0,3
D42,Auto Theft,2018,1,24,0,23
D43,Theft Under $5000,2018,6,38,0,32
D43,Break & Enter-House,2018,8,21,0,13
D42,Other,2018,1,1,1,0
D42,Auto Theft,2018,2,32,0,30
D43,Theft Under $5000,2018,19,119,0,100
D43,Break & Enter-House,2018,2,15,0,13
D42,Other Criminal Violations - Offensive Weapons,2018,4,5,0,1
D42,Auto Theft,2018,1,6,0,5
D43,Theft Under $5000,2018,27,120,0,93
D43,Break & Enter-House,2018,3,22,0,19
D42,Other Criminal Violations - Offensive Weapons,2018,10,10,1,0
D42,Break & Enter-Apartment,2018,0,7,0,7
D43,Theft Under $5000,2018,10,20,0,10
D43,Break & Enter-Other,2018,0,3,0,3
D42,Other Criminal Violations - Offensive Weapons,2018,4,4,1,0
D42,Break & Enter-Apartment,2018,3,9,0,6
D43,Theft Under $5000,2018,79,197,0,118
D43,Break & Enter-Other,2018,1,1,1,0
D42,Other Criminal Violations - Offensive Weapons,2018,5,7,0,2
D42,Break & Enter-Apartment,2018,0,5,0,5
D43,Theft Under $5000,2018,152,395,0,243
D43,Break & Enter-Other,2018,1,2,0,1
D42,Other Criminal Violations - Offensive Weapons,2018,14,14,1,0
D42,Break & Enter-Apartment,2018,0,8,0,8
D43,Theft Under $5000,2018,22,65,0,43
D43,Break & Enter-Other,2018,1,1,1,0
D42,Other Criminal Violations - Offensive Weapons,2018,9,9,1,0
D42,Break & Enter-Apartment,2018,2,5,0,3
D43,Theft Under $5000,2018,55,231,0,176
D43,Break & Enter-Other,2018,1,1,1,0
D42,Break & Enter-Other,2018,0,2,0,2
D42,Break & Enter-Apartment,2018,0,1,0,1
D43,Break & Enter-Other,2018,0,1,0,1
D42,Break & Enter-Other,2018,0,1,0,1
D42,Other Criminal Violations - Offensive Weapons,2018,3,4,0,1
D43,Assault,2018,27,39,0,12
D42,Break & Enter-Apartment,2018,0,10,0,10
D43,Break & Enter-Other,2018,1,4,0,3
D42,Other Criminal Violations - Offensive Weapons,2018,7,9,0,2
D43,Assault,2018,75,128,0,53
D42,Break & Enter-Apartment,2018,1,9,0,8
D42,Break & Enter-Other,2018,0,1,0,1
D43,Assault,2018,32,42,0,10
D42,Break & Enter-Apartment,2018,0,14,0,14
D42,Other Criminal Violations - Offensive Weapons,2018,2,2,1,0
D43,Break & Enter-Other,2018,1,7,0,6
D42,Break & Enter-Other,2018,0,3,0,3
D43,Assault,2018,59,90,0,31
D42,Break & Enter-Apartment,2018,0,4,0,4
D42,Other Criminal Violations - Offensive Weapons,2018,6,10,0,4
D43,Break & Enter-Other,2018,1,4,0,3
D42,Break & Enter-Other,2018,0,2,0,2
D43,Assault,2018,65,98,0,33
D42,Break & Enter-Commercial,2018,1,13,0,12
D42,Other Criminal Violations - Offensive Weapons,2018,4,4,1,0
D43,Fraud,2018,1,9,0,8
D43,Fraud,2018,11,101,0,90
D43,Fraud,2018,4,25,0,21
D43,Fraud,2018,5,38,0,33
D43,Fraud,2018,11,57,0,46
D43,Fraud,2018,15,94,0,79
D43,Fraud,2018,1,18,0,17
D43,Fraud,2018,2,36,0,34
D43,Fraud,2018,4,43,0,39
D43,Fraud,2018,0,3,0,3
D43,Fraud,2018,7,45,0,38
D43,Fraud,2018,24,126,0,102
D43,Fraud,2018,5,27,0,22
D43,Fraud,2018,14,110,0,96
D43,Other,2018,3,18,0,15
D43,Other,2018,35,74,0,39
D43,Other,2018,16,34,0,18
D43,Other,2018,49,97,0,48
D43,Other,2018,36,73,0,37
D43,Other,2018,67,129,0,62
D43,Other,2018,24,37,0,13
D43,Other,2018,12,42,0,30
D42,Break & Enter-Commercial,2018,3,43,0,40
D43,Assault,2018,107,164,0,57
D42,Other,2018,2,2,1,0
D42,Fraud,2018,6,62,0,56
D42,Break & Enter-Commercial,2018,0,1,0,1
D43,Assault,2018,30,44,0,14
D42,Fraud,2018,12,70,0,58
D42,Break & Enter-Commercial,2018,0,1,0,1
D43,Assault,2018,27,43,0,16
D42,Fraud,2018,2,37,0,35
D42,Break & Enter-Commercial,2018,3,10,0,7
D43,Assault,2018,82,126,0,44
D42,Fraud,2018,1,59,0,58
D42,Break & Enter-Commercial,2018,3,15,0,12
D43,Assault,2018,2,5,0,3
D42,Fraud,2018,6,72,0,66
D42,Break & Enter-Commercial,2018,6,78,0,72
D43,Assault,2018,103,154,0,51
D42,Fraud,2018,6,45,0,39
D42,Break & Enter-Commercial,2018,2,18,0,16
D43,Assault,2018,254,363,0,109
D42,Fraud,2018,22,93,0,71
D42,Break & Enter-Commercial,2018,1,2,0,1
D43,Assault,2018,17,26,0,9
D42,Fraud,2018,3,50,0,47
D42,Break & Enter-Commercial,2018,4,10,0,6
D43,Assault,2018,106,155,0,49
D42,Fraud,2018,0,1,0,1
D42,Break & Enter-Commercial,2018,0,3,0,3
D43,Attempt Murder,2018,3,3,1,0
D42,Fraud,2018,1,37,0,36
D42,Break & Enter-House,2018,2,48,0,46
D43,Attempt Murder,2018,3,3,1,0
D42,Fraud,2018,12,74,0,62
D42,Break & Enter-House,2018,2,39,0,37
D43,Attempt Murder,2018,0,1,0,1
D42,Fraud,2018,3,22,0,19
D42,Break & Enter-House,2018,1,29,0,28
D43,Attempt Murder,2018,1,1,1,0
D42,Other,2018,10,44,0,34
D42,Break & Enter-House,2018,4,32,0,28
D42,Other,2018,26,76,0,50
D42,Break & Enter-House,2018,1,17,0,16
D42,Other,2018,2,2,1,0
D42,Break & Enter-House,2018,4,15,0,11
D42,Other,2018,8,41,0,33
D42,Break & Enter-House,2018,1,30,0,29
D42,Other,2018,14,44,0,30
D42,Break & Enter-House,2018,2,26,0,24
D42,Other,2018,20,85,0,65
D42,Break & Enter-House,2018,2,50,0,48
D42,Other,2018,14,41,0,27
D42,Break & Enter-House,2018,3,50,0,47
D42,Other,2018,17,66,0,49
D42,Break & Enter-House,2018,1,8,0,7
D42,Other,2018,16,62,0,46
D42,Break & Enter-Other,2018,0,1,0,1
D42,Other,2018,0,3,0,3
D42,Other,2018,4,28,0,24
D42,Other,2018,13,61,0,48
D42,Other,2018,5,29,0,24
D42,Theft Over $5000,2018,0,4,0,4
D42,Theft Over $5000,2018,1,10,0,9
D42,Theft Over $5000,2018,0,6,0,6
D42,Theft Over $5000,2018,0,3,0,3
D42,Theft Over $5000,2018,2,5,0,3
D42,Theft Over $5000,2018,4,11,0,7
D42,Theft Over $5000,2018,1,18,0,17
D42,Theft Over $5000,2018,4,11,0,7
D42,Theft Over $5000,2018,0,3,0,3
D42,Theft Over $5000,2018,0,3,0,3
D42,Theft Over $5000,2018,0,2,0,2
D42,Theft Under $5000,2018,20,165,0,145
D42,Theft Under $5000,2018,58,272,0,214
D42,Theft Under $5000,2018,1,3,0,2
D42,Theft Under $5000,2018,7,91,0,84
D42,Theft Under $5000,2018,34,171,0,137
D42,Theft Under $5000,2018,101,267,0,166
D42,Theft Under $5000,2018,42,151,0,109
D41,Sexual Violation,2018,20,27,0,7
D41,Other,2018,1,1,1,0
D41,Other,2018,7,7,1,0
D41,Other,2018,13,14,0,1
D41,Other,2018,25,26,0,1
D41,Other,2018,5,6,0,1
D41,Other,2018,17,17,1,0
D41,Other,2018,2,2,1,0
D41,Other,2018,8,8,1,0
D41,Other,2018,9,9,1,0
D41,Other,2018,1,1,1,0
D41,Other,2018,8,8,1,0
D41,Other,2018,22,24,0,2
D41,Other,2018,14,15,0,1
D41,Other,2018,11,13,0,2
D41,Other,2018,86,93,0,7
D41,Other,2018,485,538,0,53
D41,Other,2018,19,20,0,1
D41,Other,2018,153,170,0,17
D41,Other,2018,26,29,0,3
D41,Other,2018,1,1,1,0
D41,Other,2018,77,84,0,7
D41,Other,2018,130,145,0,15
D41,Other,2018,11,13,0,2
D41,Other,2018,113,127,0,14
D41,Other,2018,123,136,0,13
D41,Other,2018,1,1,1,0
D41,Other Criminal Violations - Offensive Weapons,2018,3,3,1,0
D41,Other Criminal Violations - Offensive Weapons,2018,3,3,1,0
D41,Other Criminal Violations - Offensive Weapons,2018,13,15,0,2
D41,Other Criminal Violations - Offensive Weapons,2018,27,27,1,0
D41,Other Criminal Violations - Offensive Weapons,2018,2,2,1,0
D41,Other Criminal Violations - Offensive Weapons,2018,14,16,0,2
D41,Other Criminal Violations - Offensive Weapons,2018,4,5,0,1
D41,Other Criminal Violations - Offensive Weapons,2018,8,9,0,1
D41,Other Criminal Violations - Offensive Weapons,2018,19,20,0,1
D41,Other Criminal Violations - Offensive Weapons,2018,1,1,1,0
D41,Other Criminal Violations - Offensive Weapons,2018,25,27,0,2
D41,Other Criminal Violations - Offensive Weapons,2018,17,21,0,4
D41,Other,2018,5,5,1,0
D41,Other,2018,1,1,1,0
D41,Other,2018,1,1,1,0
D41,Other,2018,1,1,1,0
D41,Other,2018,4,4,1,0
D41,Other,2018,2,2,1,0
D42,Other,2018,7,7,1,0
D42,Other,2018,9,11,0,2
D42,Other,2018,3,4,0,1
D42,Other,2018,6,6,1,0
D42,Other,2018,9,11,0,2
D51,Other,2018,16,30,0,14
D51,Other,2018,37,69,0,32
D43,Other,2018,5,5,1,0
D51,Other,2018,27,65,0,38
D43,Other,2018,8,13,0,5
D51,Other,2018,60,102,0,42
D51,Other,2018,17,39,0,22
D51,Other,2018,12,30,0,18
D43,Other,2018,9,11,0,2
D51,Other,2018,2,2,1,0
D43,Other,2018,15,29,0,14
D43,Other,2018,18,18,1,0
D51,Other,2018,17,31,0,14
D43,Other,2018,17,19,0,2
D43,Other,2018,28,31,0,3
D51,Robbery-Financial,2018,1,1,1,0
D43,Other,2018,21,27,0,6
D43,Other,2018,6,6,1,0
D51,Robbery-Financial,2018,1,1,1,0
D43,Other,2018,21,32,0,11
D43,Other,2018,9,9,1,0
D51,Robbery-Financial,2018,3,3,1,0
D43,Other,2018,36,56,0,20
D43,Other,2018,4,4,1,0
D51,Robbery-Financial,2018,1,1,1,0
D43,Other,2018,11,21,0,10
D43,Other,2018,1,1,1,0
D51,Robbery-Financial,2018,1,1,1,0
D43,Other,2018,11,24,0,13
D43,Other,2018,21,21,1,0
D51,Robbery-Other,2018,10,29,0,19
D43,Other,2018,24,37,0,13
D52,Assault,2018,102,153,0,51
D52,Break & Enter-Other,2018,5,15,0,10
D51,Fraud,2018,0,4,0,4
D43,Other,2018,30,33,0,3
D43,Other,2018,5,5,1,0
D43,Other,2018,25,28,0,3
D43,Other,2018,10,11,0,1
D43,Other,2018,80,88,0,8
D43,Other,2018,31,37,0,6
D43,Other,2018,7,8,0,1
D43,Other,2018,51,62,0,11
D43,Other,2018,61,65,0,4
D43,Other,2018,154,171,0,17
D43,Other,2018,14,15,0,1
D43,Other,2018,23,27,0,4
D43,Other,2018,58,68,0,10
D43,Other,2018,9,10,0,1
D43,Other,2018,147,156,0,9
D43,Other,2018,424,457,0,33
D43,Other,2018,21,21,1,0
D43,Other,2018,121,133,0,12
D43,Other,2018,1,1,1,0
D43,Other Criminal Violations - Offensive Weapons,2018,4,4,1,0
D43,Other Criminal Violations - Offensive Weapons,2018,8,9,0,1
D43,Other Criminal Violations - Offensive Weapons,2018,8,8,1,0
D43,Other Criminal Violations - Offensive Weapons,2018,22,26,0,4
D43,Other Criminal Violations - Offensive Weapons,2018,14,15,0,1
D43,Other Criminal Violations - Offensive Weapons,2018,42,46,0,4
D43,Other Criminal Violations - Offensive Weapons,2018,3,5,0,2
D43,Other Criminal Violations - Offensive Weapons,2018,7,8,0,1
D43,Other Criminal Violations - Offensive Weapons,2018,9,12,0,3
D43,Other Criminal Violations - Offensive Weapons,2018,1,1,1,0
D43,Other Criminal Violations - Offensive Weapons,2018,24,26,0,2
D43,Other Criminal Violations - Offensive Weapons,2018,78,80,0,2
D43,Other Criminal Violations - Offensive Weapons,2018,20,21,0,1
D43,Other,2018,0,1,0,1
D43,Other,2018,1,1,1,0
D43,Other,2018,1,1,1,0
D43,Other,2018,1,1,1,0
D43,Other,2018,1,1,1,0
D43,Other,2018,1,1,1,0
D43,Other,2018,6,6,1,0
D43,Other,2018,0,1,0,1
D51,Other,2018,19,20,0,1
D51,Other Criminal Violations - Offensive Weapons,2018,9,9,1,0
D52,Break & Enter-Other,2018,0,3,0,3
D51,Robbery-Other,2018,18,45,0,27
D52,Break & Enter-Other,2018,4,9,0,5
D52,Break & Enter-Other,2018,3,13,0,10
D43,Other,2018,2,4,0,2
D51,Robbery-Other,2018,32,108,0,76
D52,Assault,2018,27,46,0,19
D52,Break & Enter-Other,2018,0,2,0,2
D51,Other Criminal Violations - Offensive Weapons,2018,28,31,0,3
D43,Other,2018,19,46,0,27
D51,Robbery-Other,2018,40,135,0,95
D52,Assault,2018,145,230,0,85
D52,Break & Enter-Other,2018,5,12,0,7
D51,Other Criminal Violations - Offensive Weapons,2018,44,51,0,7
D43,Other,2018,58,106,0,48
D51,Robbery-Other,2018,1,1,1,0
D52,Assault,2018,365,533,0,168
D52,Fraud,2018,36,127,0,91
D51,Other Criminal Violations - Offensive Weapons,2018,61,68,0,7
D43,Other,2018,3,8,0,5
D51,Robbery-Other,2018,11,22,0,11
D52,Attempt Murder,2018,1,1,1,0
D52,Fraud,2018,1,2,0,1
D51,Other Criminal Violations - Offensive Weapons,2018,19,26,0,7
D43,Other,2018,34,50,0,16
D51,Robbery-Other,2018,11,26,0,15
D52,Attempt Murder,2018,2,2,1,0
D52,Fraud,2018,10,32,0,22
D51,Other Criminal Violations - Offensive Weapons,2018,16,19,0,3
D43,Robbery-Financial,2018,2,2,1,0
D51,Robbery-Other,2018,0,2,0,2
D52,Attempt Murder,2018,1,1,1,0
D52,Fraud,2018,38,106,0,68
D51,Other Criminal Violations - Offensive Weapons,2018,1,1,1,0
D43,Robbery-Financial,2018,1,1,1,0
D51,Robbery-Other,2018,9,21,0,12
D52,Other,2018,0,1,0,1
D52,Fraud,2018,34,104,0,70
D51,Other Criminal Violations - Offensive Weapons,2018,5,9,0,4
D43,Robbery-Financial,2018,0,1,0,1
D51,Sexual Violation,2018,3,12,0,9
D52,Other,2018,15,31,0,16
D52,Fraud,2018,2,2,1,0
D51,Other,2018,1,1,1,0
D43,Robbery-Financial,2018,1,1,1,0
D52,Other,2018,2,2,1,0
D51,Sexual Violation,2018,9,37,0,28
D52,Fraud,2018,64,129,0,65
D51,Other,2018,4,4,1,0
D43,Robbery-Financial,2018,1,1,1,0
D52,Fraud,2018,17,39,0,22
D51,Other,2018,2,7,0,5
D52,Other,2018,3,4,0,1
D43,Robbery-Financial,2018,1,1,1,0
D51,Sexual Violation,2018,16,55,0,39
D52,Fraud,2018,67,162,0,95
D51,Other,2018,18,20,0,2
D52,Other,2018,5,14,0,9
D43,Robbery-Other,2018,0,1,0,1
D51,Sexual Violation,2018,25,78,0,53
D52,Fraud,2018,153,468,0,315
D51,Other,2018,2,2,1,0
D52,Other,2018,18,43,0,25
D43,Robbery-Other,2018,17,27,0,10
D51,Sexual Violation,2018,1,2,0,1
D52,Other,2018,65,134,0,69
D52,Other,2018,36,40,0,4
D52,Other,2018,11,17,0,6
D51,Fraud,2018,9,82,0,73
D43,Robbery-Other,2018,2,4,0,2
D51,Sexual Violation,2018,4,16,0,12
D52,Other,2018,5,8,0,3
D52,Other,2018,10,10,1,0
D52,Other,2018,11,23,0,12
D51,Fraud,2018,6,39,0,33
D43,Robbery-Other,2018,5,8,0,3
D51,Sexual Violation,2018,12,22,0,10
D52,Other,2018,11,22,0,11
D52,Other,2018,23,25,0,2
D52,Other,2018,18,44,0,26
D51,Fraud,2018,3,39,0,36
D43,Robbery-Other,2018,5,18,0,13
D51,Sexual Violation,2018,3,7,0,4
D52,Other,2018,25,70,0,45
D52,Other,2018,5,5,1,0
D52,Other,2018,51,113,0,62
D51,Other,2018,61,66,0,5
D51,Fraud,2018,12,110,0,98
D43,Robbery-Other,2018,24,36,0,12
D51,Sexual Violation,2018,6,8,0,2
D52,Other,2018,67,184,0,117
D52,Other,2018,24,24,1,0
D52,Robbery-Financial,2018,2,3,0,1
D51,Other,2018,91,96,0,5
D51,Other,2018,172,184,0,12
D51,Other,2018,2,2,1,0
D51,Other,2018,26,28,0,2
D51,Other,2018,9,11,0,2
D51,Other,2018,3,3,1,0
D51,Other,2018,15,15,1,0
D51,Auto Theft,2018,2,19,0,17
D51,Auto Theft,2018,9,30,0,21
D51,Auto Theft,2018,8,50,0,42
D51,Auto Theft,2018,10,55,0,45
D51,Auto Theft,2018,0,1,0,1
D51,Auto Theft,2018,2,9,0,7
D51,Auto Theft,2018,2,10,0,8
D51,Auto Theft,2018,0,7,0,7
D51,Auto Theft,2018,2,19,0,17
D51,Break & Enter-Apartment,2018,4,15,0,11
D51,Break & Enter-Apartment,2018,4,45,0,41
D51,Break & Enter-Apartment,2018,6,35,0,29
D51,Break & Enter-Apartment,2018,12,62,0,50
D51,Break & Enter-Apartment,2018,11,58,0,47
D51,Break & Enter-Apartment,2018,3,9,0,6
D51,Break & Enter-Apartment,2018,8,31,0,23
D51,Break & Enter-Commercial,2018,3,9,0,6
D51,Break & Enter-Commercial,2018,7,23,0,16
D51,Break & Enter-Commercial,2018,16,71,0,55
D51,Break & Enter-Commercial,2018,8,45,0,37
D51,Break & Enter-Commercial,2018,3,4,0,1
D51,Break & Enter-Commercial,2018,3,10,0,7
D51,Break & Enter-Commercial,2018,0,1,0,1
D51,Break & Enter-Commercial,2018,3,29,0,26
D51,Break & Enter-House,2018,2,13,0,11
D51,Break & Enter-House,2018,1,3,0,2
D51,Break & Enter-House,2018,2,3,0,1
D51,Break & Enter-House,2018,4,16,0,12
D51,Break & Enter-House,2018,0,2,0,2
D51,Break & Enter-House,2018,0,5,0,5
D51,Break & Enter-Other,2018,0,4,0,4
D51,Break & Enter-Other,2018,1,8,0,7
D51,Break & Enter-Other,2018,8,14,0,6
D51,Break & Enter-Other,2018,0,14,0,14
D51,Break & Enter-Other,2018,0,2,0,2
D51,Break & Enter-Other,2018,1,7,0,6
D51,Break & Enter-Other,2018,0,3,0,3
D51,Break & Enter-Other,2018,1,6,0,5
D51,Fraud,2018,9,72,0,63
D51,Fraud,2018,35,220,0,185
D51,Fraud,2018,49,248,0,199
D51,Fraud,2018,33,193,0,160
D43,Robbery-Other,2018,0,3,0,3
D51,Other,2018,35,250,0,215
D52,Other,2018,1,1,1,0
D52,Other,2018,2,7,0,5
D43,Robbery-Other,2018,1,5,0,4
D52,Robbery-Financial,2018,1,1,1,0
D51,Other,2018,72,200,0,128
D51,Sexual Violation,2018,0,1,0,1
D51,Other,2018,121,367,0,246
D52,Robbery-Financial,2018,2,2,1,0
D52,Other,2018,40,186,0,146
D43,Robbery-Other,2018,7,13,0,6
D51,Other,2018,161,581,0,420
D51,Other,2018,7,7,1,0
D52,Other,2018,15,16,0,1
D52,Robbery-Financial,2018,1,1,1,0
D52,Other,2018,18,93,0,75
D43,Robbery-Other,2018,5,5,1,0
D51,Other,2018,1,5,0,4
D51,Other,2018,5,6,0,1
D52,Other,2018,2,2,1,0
D52,Robbery-Financial,2018,3,4,0,1
D52,Other,2018,51,134,0,83
D43,Robbery-Other,2018,7,9,0,2
D51,Other,2018,29,142,0,113
D51,Other,2018,19,20,0,1
D52,Other,2018,28,31,0,3
D52,Robbery-Other,2018,0,1,0,1
D52,Other,2018,206,393,0,187
D43,Robbery-Other,2018,27,45,0,18
D51,Other,2018,31,127,0,96
D51,Other,2018,18,19,0,1
D52,Other,2018,51,52,0,1
D52,Robbery-Other,2018,12,22,0,10
D52,Theft Over $5000,2018,3,9,0,6
D43,Robbery-Other,2018,0,3,0,3
D51,Other,2018,5,20,0,15
D51,Other,2018,3,3,1,0
D52,Auto Theft,2018,4,17,0,13
D52,Robbery-Other,2018,2,4,0,2
D52,Theft Over $5000,2018,4,14,0,10
D43,Robbery-Other,2018,13,33,0,20
D51,Other,2018,44,148,0,104
D51,Other,2018,2,2,1,0
D52,Auto Theft,2018,0,2,0,2
D52,Robbery-Other,2018,7,14,0,7
D52,Robbery-Other,2018,8,15,0,7
D52,Robbery-Other,2018,9,24,0,15
D52,Robbery-Other,2018,1,2,0,1
D52,Robbery-Other,2018,7,9,0,2
D52,Robbery-Other,2018,0,5,0,5
D52,Robbery-Other,2018,15,32,0,17
D52,Robbery-Other,2018,50,71,0,21
D52,Sexual Violation,2018,11,30,0,19
D52,Sexual Violation,2018,0,2,0,2
D52,Sexual Violation,2018,1,4,0,3
D52,Sexual Violation,2018,7,10,0,3
D52,Sexual Violation,2018,13,24,0,11
D52,Sexual Violation,2018,1,3,0,2
D52,Sexual Violation,2018,13,32,0,19
D52,Sexual Violation,2018,2,7,0,5
D52,Sexual Violation,2018,13,27,0,14
D52,Sexual Violation,2018,30,69,0,39
D52,Other,2018,6,6,1,0
D52,Other,2018,2,2,1,0
D52,Other,2018,1,2,0,1
D52,Other,2018,12,12,1,0
D52,Other,2018,10,10,1,0
D52,Other,2018,8,8,1,0
D52,Other,2018,13,15,0,2
D52,Theft Over $5000,2018,1,15,0,14
D52,Auto Theft,2018,1,1,1,0
D51,Other,2018,5,5,1,0
D52,Theft Over $5000,2018,1,3,0,2
D52,Auto Theft,2018,1,9,0,8
D51,Other,2018,8,8,1,0
D52,Theft Over $5000,2018,2,6,0,4
D52,Auto Theft,2018,0,13,0,13
D51,Other,2018,73,84,0,11
D52,Theft Over $5000,2018,1,7,0,6
D52,Auto Theft,2018,2,4,0,2
D51,Other,2018,155,179,0,24
D52,Theft Over $5000,2018,3,14,0,11
D52,Auto Theft,2018,0,1,0,1
D51,Other,2018,260,300,0,40
D52,Theft Over $5000,2018,18,44,0,26
D52,Auto Theft,2018,5,23,0,18
D51,Other,2018,398,458,0,60
D52,Theft Under $5000,2018,74,488,0,414
D52,Auto Theft,2018,6,28,0,22
D52,Break & Enter-Apartment,2018,11,27,0,16
D52,Break & Enter-Apartment,2018,3,21,0,18
D52,Break & Enter-Apartment,2018,7,33,0,26
D52,Break & Enter-Apartment,2018,2,4,0,2
D52,Break & Enter-Apartment,2018,1,4,0,3
D52,Break & Enter-Apartment,2018,12,31,0,19
D52,Break & Enter-Apartment,2018,7,18,0,11
D52,Break & Enter-Commercial,2018,9,27,0,18
D52,Break & Enter-Commercial,2018,13,20,0,7
D52,Break & Enter-Commercial,2018,40,99,0,59
D52,Break & Enter-Commercial,2018,0,1,0,1
D52,Break & Enter-Commercial,2018,5,8,0,3
D52,Break & Enter-Commercial,2018,1,1,1,0
D52,Break & Enter-Commercial,2018,30,67,0,37
D52,Break & Enter-Commercial,2018,30,69,0,39
D52,Break & Enter-House,2018,1,2,0,1
D52,Break & Enter-House,2018,2,5,0,3
D52,Break & Enter-House,2018,0,1,0,1
D51,Other,2018,1,1,1,0
D43,Sexual Violation,2018,3,3,1,0
D52,Theft Under $5000,2018,4,16,0,12
D51,Theft Over $5000,2018,0,6,0,6
D43,Sexual Violation,2018,10,22,0,12
D52,Theft Under $5000,2018,12,71,0,59
D51,Theft Over $5000,2018,4,21,0,17
D43,Sexual Violation,2018,2,3,0,1
D52,Theft Under $5000,2018,27,280,0,253
D51,Theft Over $5000,2018,4,21,0,17
D43,Sexual Violation,2018,6,12,0,6
D52,Theft Under $5000,2018,157,890,0,733
D51,Theft Over $5000,2018,10,36,0,26
D43,Sexual Violation,2018,9,15,0,6
D52,Theft Under $5000,2018,1,19,0,18
D51,Theft Over $5000,2018,0,3,0,3
D43,Sexual Violation,2018,12,25,0,13
D52,Theft Under $5000,2018,53,264,0,211
D51,Theft Over $5000,2018,0,4,0,4
D43,Sexual Violation,2018,9,13,0,4
D52,Theft Under $5000,2018,13,372,0,359
D51,Theft Over $5000,2018,0,6,0,6
D43,Sexual Violation,2018,9,14,0,5
D52,Theft Under $5000,2018,75,650,0,575
D51,Theft Over $5000,2018,2,11,0,9
D43,Sexual Violation,2018,8,15,0,7
D51,Theft Under $5000,2018,89,507,0,418
D52,Theft Under $5000,2018,1381,3167,0,1786
D43,Sexual Violation,2018,0,1,0,1
D51,Theft Under $5000,2018,399,2582,0,2183
D51,Other,2018,1,3,0,2
D51,Theft Under $5000,2018,364,1454,0,1090
D52,Assault,2018,61,119,0,58
D43,Sexual Violation,2018,8,16,0,8
D51,Other,2018,89,98,0,9
D51,Theft Under $5000,2018,194,1126,0,932
D52,Assault,2018,9,23,0,14
D43,Sexual Violation,2018,42,56,0,14
D51,Other,2018,64,75,0,11
D51,Theft Under $5000,2018,0,8,0,8
D52,Assault,2018,41,74,0,33
D43,Sexual Violation,2018,2,4,0,2
D51,Other,2018,6,7,0,1
D51,Theft Under $5000,2018,44,260,0,216
D52,Assault,2018,53,85,0,32
D43,Sexual Violation,2018,10,25,0,15
D51,Other,2018,93,101,0,8
D51,Theft Under $5000,2018,94,296,0,202
D52,Assault,2018,102,191,0,89
D43,Other,2018,5,5,1,0
D51,Other,2018,11,11,1,0
D51,Theft Under $5000,2018,8,251,0,243
D52,Assault,2018,8,10,0,2
D43,Other,2018,5,5,1,0
D51,Theft Under $5000,2018,154,770,0,616
D51,Theft Under $5000,2018,0,1,0,1
D51,Theft Under $5000,2018,0,1,0,1
D51,Assault,2018,60,99,0,39
D51,Assault,2018,167,303,0,136
D51,Assault,2018,212,394,0,182
D51,Assault,2018,261,491,0,230
D51,Assault,2018,8,8,1,0
D51,Assault,2018,92,149,0,57
D51,Assault,2018,61,117,0,56
D51,Assault,2018,44,76,0,32
D51,Assault,2018,81,136,0,55
D51,Assault,2018,0,1,0,1
D51,Attempt Murder,2018,2,2,1,0
D51,Attempt Murder,2018,0,1,0,1
D51,Attempt Murder,2018,3,3,1,0
D51,Attempt Murder,2018,1,3,0,2
D51,Attempt Murder,2018,3,5,0,2
D51,Attempt Murder,2018,1,1,1,0
D53,Theft Over $5000,2018,0,2,0,2
D53,Theft Over $5000,2018,0,3,0,3
D53,Theft Over $5000,2018,0,9,0,9
D53,Theft Over $5000,2018,1,5,0,4
D53,Theft Over $5000,2018,2,11,0,9
D53,Theft Over $5000,2018,0,3,0,3
D53,Theft Over $5000,2018,2,4,0,2
D53,Theft Over $5000,2018,0,5,0,5
D53,Theft Over $5000,2018,0,3,0,3
D53,Sexual Violation,2018,3,10,0,7
D53,Other,2018,11,36,0,25
D53,Theft Under $5000,2018,104,718,0,614
D53,Theft Under $5000,2018,1,5,0,4
D53,Theft Under $5000,2018,2,19,0,17
D53,Sexual Violation,2018,1,2,0,1
D53,Other,2018,3,5,0,2
D53,Theft Under $5000,2018,6,32,0,26
D53,Other,2018,3,5,0,2
D53,Other,2018,2,4,0,2
D53,Theft Under $5000,2018,0,31,0,31
D53,Other,2018,2,2,1,0
D53,Other,2018,6,7,0,1
D53,Theft Under $5000,2018,0,7,0,7
D53,Other,2018,4,4,1,0
D53,Other,2018,7,9,0,2
D53,Theft Under $5000,2018,1,37,0,36
D53,Other,2018,1,1,1,0
D53,Other,2018,1,3,0,2
D53,Theft Under $5000,2018,1,19,0,18
D53,Other,2018,1,1,1,0
D53,Other,2018,6,14,0,8
D53,Theft Under $5000,2018,9,72,0,63
D53,Other,2018,3,3,1,0
D53,Other,2018,1,11,0,10
D52,Other,2018,16,16,1,0
D53,Theft Under $5000,2018,5,78,0,73
D53,Other,2018,5,5,1,0
D53,Other,2018,5,12,0,7
D52,Other,2018,147,314,0,167
D53,Theft Under $5000,2018,26,183,0,157
D53,Other,2018,2,2,1,0
D53,Break & Enter-Other,2018,1,2,0,1
D53,Other,2018,0,2,0,2
D52,Other,2018,11,11,1,0
D53,Theft Under $5000,2018,0,2,0,2
D53,Other,2018,1,1,1,0
D53,Auto Theft,2018,0,4,0,4
D55,Break & Enter-Apartment,2018,4,19,0,15
D53,Other,2018,3,3,1,0
D53,Other,2018,13,15,0,2
D53,Other,2018,7,7,1,0
D53,Other,2018,8,8,1,0
D53,Other,2018,4,4,1,0
D53,Other,2018,3,3,1,0
D53,Other,2018,62,74,0,12
D53,Other,2018,2,2,1,0
D53,Other,2018,6,6,1,0
D53,Other,2018,9,10,0,1
D53,Other,2018,6,7,0,1
D53,Other,2018,1,1,1,0
D53,Other,2018,3,5,0,2
D53,Other,2018,1,1,1,0
D53,Other,2018,6,8,0,2
D53,Other,2018,14,18,0,4
D53,Other,2018,16,20,0,4
D53,Other,2018,1,1,1,0
D53,Other,2018,17,19,0,2
D53,Other,2018,107,113,0,6
D53,Other,2018,27,35,0,8
D53,Other,2018,51,61,0,10
D53,Other,2018,37,43,0,6
D53,Other,2018,10,12,0,2
D53,Other Criminal Violations - Offensive Weapons,2018,13,15,0,2
D53,Other Criminal Violations - Offensive Weapons,2018,1,2,0,1
D53,Other Criminal Violations - Offensive Weapons,2018,1,1,1,0
D53,Other Criminal Violations - Offensive Weapons,2018,1,1,1,0
D53,Other Criminal Violations - Offensive Weapons,2018,2,2,1,0
D53,Other Criminal Violations - Offensive Weapons,2018,3,3,1,0
D53,Other Criminal Violations - Offensive Weapons,2018,1,2,0,1
D53,Other Criminal Violations - Offensive Weapons,2018,0,1,0,1
D53,Other Criminal Violations - Offensive Weapons,2018,0,1,0,1
D53,Other Criminal Violations - Offensive Weapons,2018,4,5,0,1
D53,Other Criminal Violations - Offensive Weapons,2018,9,13,0,4
D53,Other Criminal Violations - Offensive Weapons,2018,5,5,1,0
D53,Other Criminal Violations - Offensive Weapons,2018,2,3,0,1
D53,Other Criminal Violations - Offensive Weapons,2018,6,6,1,0
D53,Other Criminal Violations - Offensive Weapons,2018,1,1,1,0
D53,Other,2018,1,1,1,0
D53,Break & Enter-Other,2018,0,4,0,4
D53,Other,2018,2,3,0,1
D53,Theft Under $5000,2018,0,3,0,3
D52,Other,2018,57,57,1,0
D53,Theft Under $5000,2018,23,92,0,69
D53,Other,2018,6,12,0,6
D53,Auto Theft,2018,7,31,0,24
D53,Theft Under $5000,2018,336,1083,0,747
D55,Other,2018,20,20,1,0
D52,Other,2018,22,27,0,5
D53,Other,2018,10,25,0,15
D53,Theft Under $5000,2018,47,265,0,218
D53,Auto Theft,2018,1,15,0,14
D53,Break & Enter-Other,2018,2,4,0,2
D55,Other,2018,2,2,1,0
D52,Other,2018,112,127,0,15
D53,Other,2018,14,23,0,9
D53,Theft Under $5000,2018,122,301,0,179
D53,Auto Theft,2018,0,13,0,13
D53,Break & Enter-Other,2018,1,4,0,3
D55,Other,2018,10,11,0,1
D52,Other,2018,7,7,1,0
D53,Other,2018,11,23,0,12
D53,Theft Under $5000,2018,1,11,0,10
D53,Auto Theft,2018,3,11,0,8
D53,Break & Enter-Other,2018,0,2,0,2
D55,Other,2018,8,8,1,0
D52,Other,2018,90,92,0,2
D53,Other,2018,8,25,0,17
D53,Theft Under $5000,2018,0,1,0,1
D53,Auto Theft,2018,1,6,0,5
D53,Break & Enter-Other,2018,0,3,0,3
D55,Other,2018,22,22,1,0
D52,Other,2018,17,26,0,9
D53,Other,2018,3,8,0,5
D53,Theft Under $5000,2018,75,294,0,219
D53,Break & Enter-Apartment,2018,9,40,0,31
D53,Break & Enter-Other,2018,1,1,1,0
D55,Other,2018,24,25,0,1
D52,Other,2018,101,105,0,4
D53,Robbery-Financial,2018,2,2,1,0
D53,Theft Under $5000,2018,20,146,0,126
D53,Break & Enter-Apartment,2018,0,2,0,2
D53,Break & Enter-Other,2018,0,2,0,2
D55,Other,2018,21,24,0,3
D52,Other,2018,1601,1659,0,58
D53,Robbery-Financial,2018,0,1,0,1
D53,Assault,2018,61,139,0,78
D53,Break & Enter-Apartment,2018,0,6,0,6
D53,Fraud,2018,11,148,0,137
D53,Fraud,2018,1,2,0,1
D55,Other,2018,1,1,1,0
D53,Fraud,2018,1,14,0,13
D52,Other Criminal Violations - Offensive Weapons,2018,21,23,0,2
D53,Robbery-Financial,2018,1,1,1,0
D53,Break & Enter-Apartment,2018,0,1,0,1
D55,Other,2018,3,3,1,0
D52,Other Criminal Violations - Offensive Weapons,2018,5,5,1,0
D53,Fraud,2018,0,11,0,11
D53,Assault,2018,1,4,0,3
D55,Other,2018,15,15,1,0
D52,Other Criminal Violations - Offensive Weapons,2018,10,10,1,0
D53,Break & Enter-Apartment,2018,2,5,0,3
D53,Robbery-Financial,2018,1,1,1,0
D53,Fraud,2018,1,18,0,17
D53,Assault,2018,2,3,0,1
D55,Other,2018,3,3,1,0
D52,Other Criminal Violations - Offensive Weapons,2018,5,6,0,1
D53,Break & Enter-Apartment,2018,1,12,0,11
D53,Robbery-Financial,2018,1,1,1,0
D53,Fraud,2018,3,7,0,4
D53,Assault,2018,5,17,0,12
D55,Other,2018,8,8,1,0
D52,Other Criminal Violations - Offensive Weapons,2018,16,17,0,1
D53,Break & Enter-Apartment,2018,5,32,0,27
D53,Robbery-Other,2018,9,17,0,8
D53,Fraud,2018,0,14,0,14
D53,Assault,2018,6,11,0,5
D55,Other,2018,4,5,0,1
D52,Other Criminal Violations - Offensive Weapons,2018,1,1,1,0
D53,Break & Enter-Apartment,2018,6,10,0,4
D53,Robbery-Other,2018,1,1,1,0
D53,Fraud,2018,0,9,0,9
D53,Assault,2018,3,9,0,6
D55,Other,2018,42,46,0,4
D53,Break & Enter-Apartment,2018,7,28,0,21
D53,Robbery-Other,2018,1,7,0,6
D52,Other Criminal Violations - Offensive Weapons,2018,15,17,0,2
D53,Fraud,2018,0,37,0,37
D53,Assault,2018,9,17,0,8
D55,Other,2018,22,23,0,1
D53,Break & Enter-Apartment,2018,2,5,0,3
D53,Robbery-Other,2018,0,1,0,1
D53,Robbery-Other,2018,3,5,0,2
D53,Robbery-Other,2018,3,7,0,4
D53,Robbery-Other,2018,2,6,0,4
D53,Robbery-Other,2018,2,2,1,0
D53,Robbery-Other,2018,3,3,1,0
D53,Robbery-Other,2018,1,6,0,5
D53,Robbery-Other,2018,3,20,0,17
D53,Robbery-Other,2018,3,14,0,11
D53,Robbery-Other,2018,0,3,0,3
D53,Robbery-Other,2018,14,27,0,13
D53,Robbery-Other,2018,1,1,1,0
D53,Sexual Violation,2018,10,30,0,20
D53,Sexual Violation,2018,0,2,0,2
D53,Sexual Violation,2018,0,3,0,3
D53,Sexual Violation,2018,0,1,0,1
D53,Sexual Violation,2018,4,5,0,1
D53,Sexual Violation,2018,0,4,0,4
D53,Sexual Violation,2018,1,3,0,2
D53,Sexual Violation,2018,3,7,0,4
D53,Sexual Violation,2018,0,3,0,3
D53,Sexual Violation,2018,2,5,0,3
D53,Sexual Violation,2018,9,15,0,6
D53,Sexual Violation,2018,4,12,0,8
D53,Sexual Violation,2018,8,12,0,4
D53,Sexual Violation,2018,1,1,1,0
D52,Other Criminal Violations - Offensive Weapons,2018,5,5,1,0
D55,Other,2018,4,6,0,2
D53,Assault,2018,2,2,1,0
D53,Fraud,2018,5,33,0,28
D53,Break & Enter-Apartment,2018,1,5,0,4
D52,Other Criminal Violations - Offensive Weapons,2018,19,21,0,2
D55,Other,2018,4,4,1,0
D53,Assault,2018,6,12,0,6
D53,Fraud,2018,1,38,0,37
D53,Break & Enter-Apartment,2018,0,7,0,7
D52,Other Criminal Violations - Offensive Weapons,2018,60,62,0,2
D55,Other,2018,5,5,1,0
D53,Assault,2018,16,34,0,18
D53,Fraud,2018,0,3,0,3
D53,Break & Enter-Commercial,2018,14,38,0,24
D52,Other,2018,10,12,0,2
D55,Other,2018,3,3,1,0
D53,Assault,2018,17,35,0,18
D53,Fraud,2018,4,46,0,42
D52,Other,2018,0,1,0,1
D55,Auto Theft,2018,5,10,0,5
D53,Assault,2018,2,3,0,1
D53,Break & Enter-Commercial,2018,0,3,0,3
D55,Auto Theft,2018,1,7,0,6
D53,Assault,2018,28,50,0,22
D52,Other,2018,3,4,0,1
D53,Break & Enter-Commercial,2018,0,1,0,1
D53,Fraud,2018,10,98,0,88
D55,Auto Theft,2018,1,11,0,10
D53,Assault,2018,67,122,0,55
D52,Other,2018,1,1,1,0
D53,Break & Enter-Commercial,2018,0,4,0,4
D53,Fraud,2018,4,76,0,72
D55,Auto Theft,2018,3,18,0,15
D53,Assault,2018,35,78,0,43
D52,Other,2018,1,2,0,1
D53,Break & Enter-Commercial,2018,3,4,0,1
D53,Fraud,2018,15,59,0,44
D55,Auto Theft,2018,8,33,0,25
D53,Assault,2018,40,81,0,41
D52,Other,2018,2,2,1,0
D53,Break & Enter-Commercial,2018,0,6,0,6
D53,Fraud,2018,0,1,0,1
D55,Auto Theft,2018,1,10,0,9
D53,Assault,2018,1,7,0,6
D52,Other,2018,7,9,0,2
D53,Break & Enter-Commercial,2018,0,13,0,13
D53,Fraud,2018,15,87,0,72
D55,Auto Theft,2018,6,17,0,11
D53,Assault,2018,34,57,0,23
D53,Other,2018,16,16,1,0
D53,Break & Enter-Commercial,2018,4,6,0,2
D53,Fraud,2018,4,36,0,32
D55,Auto Theft,2018,1,13,0,12
D53,Assault,2018,17,24,0,7
D53,Other,2018,1,1,1,0
D53,Break & Enter-Commercial,2018,5,17,0,12
D53,Other,2018,28,149,0,121
D55,Auto Theft,2018,3,20,0,17
D53,Attempt Murder,2018,1,1,1,0
D53,Other,2018,1,1,1,0
D53,Break & Enter-Commercial,2018,0,17,0,17
D53,Other,2018,2,4,0,2
D55,Auto Theft,2018,4,11,0,7
D53,Other,2018,2,2,1,0
D53,Break & Enter-Commercial,2018,4,16,0,12
D53,Other,2018,3,7,0,4
D55,Auto Theft,2018,2,8,0,6
D53,Other,2018,1,1,1,0
D53,Other,2018,3,9,0,6
D53,Break & Enter-Commercial,2018,1,13,0,12
D55,Auto Theft,2018,8,39,0,31
D53,Other,2018,1,1,1,0
D53,Other,2018,3,12,0,9
D53,Break & Enter-Commercial,2018,0,10,0,10
D55,Auto Theft,2018,3,15,0,12
D53,Other,2018,3,5,0,2
D53,Other,2018,0,2,0,2
D53,Break & Enter-House,2018,1,23,0,22
D55,Auto Theft,2018,5,35,0,30
D53,Other,2018,3,3,1,0
D53,Other,2018,1,13,0,12
D53,Break & Enter-House,2018,2,16,0,14
D55,Auto Theft,2018,0,5,0,5
D53,Other,2018,12,12,1,0
D53,Other,2018,0,9,0,9
D53,Break & Enter-House,2018,2,15,0,13
D55,Auto Theft,2018,1,12,0,11
D53,Other,2018,4,4,1,0
D53,Other,2018,6,28,0,22
D53,Break & Enter-House,2018,0,10,0,10
D55,Auto Theft,2018,1,2,0,1
D53,Other,2018,33,33,1,0
D53,Other,2018,7,36,0,29
D53,Break & Enter-House,2018,0,1,0,1
D55,Break & Enter-Apartment,2018,2,11,0,9
D53,Other,2018,6,9,0,3
D53,Other,2018,9,49,0,40
D53,Break & Enter-House,2018,0,13,0,13
D55,Break & Enter-Apartment,2018,0,2,0,2
D53,Other,2018,2,2,1,0
D53,Other,2018,0,1,0,1
D53,Break & Enter-House,2018,4,28,0,24
D55,Break & Enter-Apartment,2018,3,7,0,4
D53,Auto Theft,2018,6,19,0,13
D53,Other,2018,11,39,0,28
D53,Break & Enter-House,2018,0,21,0,21
D55,Break & Enter-Apartment,2018,1,6,0,5
D53,Auto Theft,2018,0,11,0,11
D53,Other,2018,36,122,0,86
D55,Break & Enter-Apartment,2018,8,28,0,20
D53,Break & Enter-House,2018,2,7,0,5
D55,Break & Enter-Apartment,2018,5,15,0,10
D53,Auto Theft,2018,1,5,0,4
D53,Break & Enter-House,2018,2,31,0,29
D53,Other,2018,14,49,0,35
D55,Break & Enter-Apartment,2018,6,12,0,6
D53,Auto Theft,2018,0,10,0,10
D53,Break & Enter-House,2018,0,1,0,1
D53,Other,2018,17,62,0,45
D55,Break & Enter-Apartment,2018,1,4,0,3
D53,Auto Theft,2018,0,5,0,5
D53,Break & Enter-House,2018,0,5,0,5
D53,Other,2018,2,5,0,3
D55,Break & Enter-Apartment,2018,4,10,0,6
D53,Auto Theft,2018,0,13,0,13
D53,Break & Enter-House,2018,0,7,0,7
D53,Other,2018,22,77,0,55
D55,Break & Enter-Apartment,2018,3,4,0,1
D53,Auto Theft,2018,8,30,0,22
D53,Break & Enter-Other,2018,0,4,0,4
D53,Other,2018,6,29,0,23
D55,Break & Enter-Apartment,2018,1,6,0,5
D53,Auto Theft,2018,8,41,0,33
D53,Break & Enter-Other,2018,0,3,0,3
D53,Theft Over $5000,2018,5,39,0,34
D55,Break & Enter-Apartment,2018,5,27,0,22
D53,Auto Theft,2018,2,15,0,13
D53,Break & Enter-Other,2018,0,1,0,1
D53,Theft Over $5000,2018,1,1,1,0
D53,Break & Enter-Other,2018,0,1,0,1
D53,Theft Over $5000,2018,0,2,0,2
D53,Break & Enter-Other,2018,0,2,0,2
D53,Theft Over $5000,2018,1,2,0,1
D53,Break & Enter-Other,2018,0,2,0,2
D55,Break & Enter-Apartment,2018,1,5,0,4
D55,Break & Enter-Apartment,2018,3,6,0,3
D55,Break & Enter-Apartment,2018,1,8,0,7
D55,Break & Enter-Apartment,2018,3,5,0,2
D55,Break & Enter-Commercial,2018,2,6,0,4
D55,Break & Enter-Commercial,2018,1,2,0,1
D55,Break & Enter-Commercial,2018,4,15,0,11
D55,Break & Enter-Commercial,2018,0,3,0,3
D55,Break & Enter-Commercial,2018,9,23,0,14
D55,Break & Enter-Commercial,2018,6,10,0,4
D55,Break & Enter-Commercial,2018,3,13,0,10
D55,Break & Enter-Commercial,2018,4,9,0,5
D55,Break & Enter-Commercial,2018,5,9,0,4
D55,Break & Enter-Commercial,2018,2,7,0,5
D55,Break & Enter-Commercial,2018,11,25,0,14
D55,Break & Enter-Commercial,2018,6,17,0,11
D55,Break & Enter-Commercial,2018,6,19,0,13
D55,Break & Enter-Commercial,2018,3,7,0,4
D55,Break & Enter-Commercial,2018,1,4,0,3
D55,Break & Enter-Commercial,2018,0,1,0,1
D55,Break & Enter-House,2018,1,5,0,4
D55,Break & Enter-House,2018,1,3,0,2
D55,Break & Enter-House,2018,3,8,0,5
D55,Break & Enter-House,2018,3,6,0,3
D55,Break & Enter-House,2018,3,19,0,16
D55,Break & Enter-House,2018,4,9,0,5
D55,Break & Enter-House,2018,2,12,0,10
D55,Break & Enter-House,2018,2,7,0,5
D55,Break & Enter-House,2018,2,13,0,11
D55,Break & Enter-House,2018,1,7,0,6
D55,Break & Enter-House,2018,8,31,0,23
D55,Break & Enter-House,2018,0,6,0,6
D55,Break & Enter-House,2018,4,17,0,13
D55,Break & Enter-House,2018,1,8,0,7
D55,Break & Enter-House,2018,4,5,0,1
D55,Break & Enter-Other,2018,3,5,0,2
D55,Break & Enter-Other,2018,0,1,0,1
D55,Break & Enter-Other,2018,0,3,0,3
D55,Break & Enter-Other,2018,3,9,0,6
D55,Break & Enter-Other,2018,2,7,0,5
D55,Break & Enter-Other,2018,1,5,0,4
D55,Break & Enter-Other,2018,1,1,1,0
D55,Break & Enter-Other,2018,1,4,0,3
D55,Break & Enter-Other,2018,1,7,0,6
D55,Break & Enter-Other,2018,0,2,0,2
D55,Break & Enter-Other,2018,2,4,0,2
D55,Break & Enter-Other,2018,0,3,0,3
D55,Fraud,2018,5,30,0,25
D55,Fraud,2018,4,38,0,34
D55,Sexual Violation,2018,6,16,0,10
D55,Sexual Violation,2018,1,11,0,10
D55,Sexual Violation,2018,1,3,0,2
D55,Sexual Violation,2018,13,24,0,11
D55,Sexual Violation,2018,6,10,0,4
D55,Sexual Violation,2018,2,5,0,3
D55,Sexual Violation,2018,6,8,0,2
D55,Sexual Violation,2018,5,14,0,9
D55,Sexual Violation,2018,3,7,0,4
D55,Other,2018,2,2,1,0
D55,Other,2018,4,4,1,0
D55,Other,2018,4,4,1,0
D55,Fraud,2018,9,30,0,21
D55,Other,2018,4,4,1,0
D55,Other,2018,6,6,1,0
NSA,Other,2018,1,1,1,0
D55,Other,2018,9,9,1,0
D55,Other,2018,9,9,1,0
D55,Fraud,2018,9,49,0,40
D55,Other Criminal Violations - Offensive Weapons,2018,1,1,1,0
D55,Other,2018,6,6,1,0
NSA,Other,2018,1,1,1,0
D55,Fraud,2018,14,73,0,59
D55,Other,2018,3,3,1,0
D55,Other Criminal Violations - Offensive Weapons,2018,2,2,1,0
NSA,Other,2018,1,1,1,0
D55,Fraud,2018,11,72,0,61
D55,Other,2018,8,8,1,0
D55,Other Criminal Violations - Offensive Weapons,2018,6,6,1,0
NSA,Other,2018,207,225,0,18
D55,Fraud,2018,11,38,0,27
D55,Other,2018,19,19,1,0
D55,Other Criminal Violations - Offensive Weapons,2018,5,5,1,0
NSA,Other,2018,1,1,1,0
D55,Fraud,2018,8,42,0,34
D55,Other,2018,4,4,1,0
D55,Other Criminal Violations - Offensive Weapons,2018,17,19,0,2
NSA,Other Criminal Violations - Offensive Weapons,2018,1,1,1,0
D55,Fraud,2018,3,52,0,49
D55,Other,2018,18,19,0,1
D55,Other Criminal Violations - Offensive Weapons,2018,6,6,1,0
NSA,Other Criminal Violations - Offensive Weapons,2018,34,38,0,4
D55,Fraud,2018,1,20,0,19
D55,Other,2018,2,2,1,0
D55,Fraud,2018,5,30,0,25
D11,Break & Enter-Commercial,2019,6,20,0,14
D55,Other Criminal Violations - Offensive Weapons,2018,9,9,1,0
D55,Fraud,2018,19,110,0,91
D11,Break & Enter-Commercial,2019,0,2,0,2
D55,Other,2018,7,7,1,0
NSA,Other,2018,13,15,0,2
D55,Other Criminal Violations - Offensive Weapons,2018,9,10,0,1
D11,Break & Enter-Commercial,2019,1,3,0,2
D55,Other,2018,7,7,1,0
D55,Fraud,2018,4,44,0,40
D11,Other,2019,8,8,1,0
D55,Other Criminal Violations - Offensive Weapons,2018,10,10,1,0
D11,Break & Enter-House,2019,0,4,0,4
D55,Other,2018,6,6,1,0
D55,Fraud,2018,7,53,0,46
D11,Other,2019,3,4,0,1
D55,Other Criminal Violations - Offensive Weapons,2018,3,4,0,1
D11,Break & Enter-House,2019,1,14,0,13
D55,Other,2018,2,2,1,0
D55,Fraud,2018,5,16,0,11
D11,Other,2019,9,11,0,2
D55,Other Criminal Violations - Offensive Weapons,2018,4,5,0,1
D11,Break & Enter-House,2019,2,19,0,17
D55,Other,2018,48,54,0,6
D55,Fraud,2018,10,33,0,23
D11,Other,2019,2,2,1,0
D55,Other Criminal Violations - Offensive Weapons,2018,22,23,0,1
D11,Break & Enter-House,2019,0,4,0,4
D55,Other,2018,26,30,0,4
D55,Fraud,2018,4,17,0,13
D11,Other,2019,11,11,1,0
D55,Other Criminal Violations - Offensive Weapons,2018,7,11,0,4
D11,Break & Enter-House,2019,0,15,0,15
D55,Other,2018,4,4,1,0
D55,Other,2018,19,85,0,66
D11,Other,2019,3,3,1,0
D55,Other Criminal Violations - Offensive Weapons,2018,6,6,1,0
D11,Break & Enter-House,2019,0,10,0,10
D55,Other,2018,42,51,0,9
D55,Other,2018,13,25,0,12
D11,Other,2019,3,3,1,0
D11,Break & Enter-House,2019,1,2,0,1
D55,Other Criminal Violations - Offensive Weapons,2018,3,3,1,0
D11,Break & Enter-House,2019,2,11,0,9
D55,Other,2018,1,1,1,0
D55,Other,2018,31,40,0,9
D11,Other,2019,23,23,1,0
D55,Theft Over $5000,2018,0,3,0,3
D55,Other Criminal Violations - Offensive Weapons,2018,10,10,1,0
D55,Other,2018,20,51,0,31
D55,Other,2018,7,20,0,13
D11,Break & Enter-House,2019,0,3,0,3
D55,Other,2018,106,119,0,13
D11,Other,2019,4,4,1,0
D55,Other,2018,1,1,1,0
D55,Theft Under $5000,2018,32,177,0,145
D55,Other,2018,17,50,0,33
D55,Other,2018,2,2,1,0
D11,Break & Enter-House,2019,1,4,0,3
D55,Other,2018,46,57,0,11
D11,Other,2019,5,5,1,0
D55,Other,2018,1,2,0,1
D55,Theft Under $5000,2018,6,61,0,55
D55,Other,2018,55,122,0,67
D55,Other,2018,11,21,0,10
D11,Break & Enter-Other,2019,1,3,0,2
D55,Other,2018,56,58,0,2
D11,Other,2019,15,15,1,0
D55,Other,2018,1,1,1,0
D55,Theft Under $5000,2018,1,1,1,0
D55,Other,2018,30,69,0,39
D55,Other,2018,21,27,0,6
D11,Break & Enter-Other,2019,2,4,0,2
D55,Other,2018,1,1,1,0
D11,Auto Theft,2019,0,1,0,1
NSA,Other,2018,114,133,0,19
D55,Theft Under $5000,2018,74,187,0,113
D55,Other,2018,26,58,0,32
D55,Other,2018,17,35,0,18
D11,Break & Enter-Other,2019,1,7,0,6
D55,Other,2018,23,25,0,2
D11,Auto Theft,2019,0,4,0,4
NSA,Auto Theft,2018,5,33,0,28
D55,Theft Under $5000,2018,9,80,0,71
D55,Other,2018,2,5,0,3
D55,Other,2018,19,38,0,19
D11,Break & Enter-Other,2019,0,2,0,2
D55,Other,2018,76,82,0,6
D55,Other,2018,3,3,1,0
D55,Other,2018,39,42,0,3
D55,Other,2018,38,42,0,4
D55,Other,2018,131,149,0,18
D55,Other,2018,49,60,0,11
D55,Other,2018,58,67,0,9
D55,Other,2018,23,24,0,1
D55,Other,2018,55,68,0,13
D55,Other,2018,23,25,0,2
D55,Other,2018,5,5,1,0
D55,Other Criminal Violations - Offensive Weapons,2018,1,1,1,0
D55,Other Criminal Violations - Offensive Weapons,2018,10,11,0,1
NSA,Break & Enter-Apartment,2018,3,8,0,5
D11,Auto Theft,2019,2,25,0,23
D55,Other,2018,11,62,0,51
D55,Other,2018,24,32,0,8
D11,Break & Enter-Other,2019,1,13,0,12
D55,Theft Under $5000,2018,133,428,0,295
NSA,Break & Enter-Commercial,2018,7,16,0,9
D11,Auto Theft,2019,10,31,0,21
D55,Other,2018,35,83,0,48
D55,Other,2018,4,12,0,8
D11,Break & Enter-Other,2019,0,1,0,1
D55,Theft Under $5000,2018,17,83,0,66
NSA,Break & Enter-House,2018,1,9,0,8
D11,Auto Theft,2019,7,19,0,12
D55,Other,2018,1,2,0,1
D55,Other,2018,24,36,0,12
D11,Break & Enter-Other,2019,2,6,0,4
D55,Theft Under $5000,2018,42,182,0,140
NSA,Break & Enter-Other,2018,1,2,0,1
D11,Auto Theft,2019,3,23,0,20
D55,Other,2018,19,38,0,19
D55,Other,2018,5,11,0,6
D11,Break & Enter-Other,2019,0,1,0,1
D55,Theft Under $5000,2018,3,11,0,8
NSA,Fraud,2018,0,1,0,1
D11,Auto Theft,2019,0,10,0,10
D55,Other,2018,11,35,0,24
D55,Other,2018,8,11,0,3
D11,Break & Enter-Other,2019,0,1,0,1
D55,Theft Under $5000,2018,30,170,0,140
NSA,Fraud,2018,30,228,0,198
D11,Auto Theft,2019,0,2,0,2
D55,Other,2018,204,347,0,143
D55,Other,2018,23,42,0,19
D55,Other,2018,16,33,0,17
D55,Other,2018,19,32,0,13
D55,Other,2018,3,7,0,4
D55,Other,2018,31,47,0,16
D55,Other,2018,4,10,0,6
D55,Robbery-Financial,2018,1,2,0,1
D55,Robbery-Financial,2018,2,2,1,0
D55,Robbery-Financial,2018,1,1,1,0
D55,Robbery-Financial,2018,3,3,1,0
D55,Robbery-Financial,2018,1,1,1,0
D55,Robbery-Financial,2018,1,1,1,0
D55,Robbery-Other,2018,5,13,0,8
D55,Robbery-Other,2018,2,5,0,3
D55,Robbery-Other,2018,1,1,1,0
D55,Robbery-Other,2018,14,27,0,13
D55,Robbery-Other,2018,1,8,0,7
D55,Robbery-Other,2018,14,23,0,9
D55,Robbery-Other,2018,12,16,0,4
D55,Robbery-Other,2018,9,19,0,10
D55,Robbery-Other,2018,8,14,0,6
D55,Robbery-Other,2018,5,7,0,2
D55,Robbery-Other,2018,1,7,0,6
D55,Robbery-Other,2018,2,4,0,2
D55,Robbery-Other,2018,20,33,0,13
D55,Robbery-Other,2018,4,16,0,12
D55,Robbery-Other,2018,4,9,0,5
D55,Robbery-Other,2018,1,2,0,1
D55,Robbery-Other,2018,11,24,0,13
D55,Robbery-Other,2018,4,6,0,2
D55,Sexual Violation,2018,4,10,0,6
D55,Sexual Violation,2018,5,7,0,2
D55,Sexual Violation,2018,9,13,0,4
D55,Sexual Violation,2018,8,13,0,5
D55,Sexual Violation,2018,9,27,0,18
D55,Sexual Violation,2018,7,14,0,7
D55,Sexual Violation,2018,10,19,0,9
D55,Sexual Violation,2018,1,2,0,1
D55,Sexual Violation,2018,3,9,0,6
D11,Fraud,2019,7,40,0,33
D55,Other,2018,21,58,0,37
D11,Auto Theft,2019,1,14,0,13
NSA,Fraud,2018,0,1,0,1
D11,Fraud,2019,7,63,0,56
D55,Other,2018,44,113,0,69
NSA,Other,2018,51,189,0,138
D11,Auto Theft,2019,8,30,0,22
D55,Theft Under $5000,2018,56,183,0,127
NSA,Other,2018,0,1,0,1
D55,Other,2018,14,30,0,16
D11,Fraud,2019,7,69,0,62
D55,Other,2018,28,80,0,52
D55,Theft Under $5000,2018,0,1,0,1
D11,Auto Theft,2019,1,4,0,3
NSA,Theft Over $5000,2018,5,26,0,21
D11,Fraud,2019,8,64,0,56
D55,Other,2018,12,33,0,21
D55,Theft Under $5000,2018,52,207,0,155
D11,Auto Theft,2019,0,3,0,3
NSA,Theft Under $5000,2018,71,351,0,280
D11,Fraud,2019,12,79,0,67
D55,Theft Over $5000,2018,1,1,1,0
D55,Theft Under $5000,2018,77,318,0,241
D11,Break & Enter-Apartment,2019,1,6,0,5
NSA,Theft Under $5000,2018,0,1,0,1
D11,Fraud,2019,4,26,0,22
D55,Theft Over $5000,2018,0,1,0,1
D55,Theft Under $5000,2018,313,1527,0,1214
D11,Break & Enter-Apartment,2019,1,35,0,34
NSA,Theft Under $5000,2018,0,1,0,1
D11,Fraud,2019,2,11,0,9
D55,Theft Over $5000,2018,1,5,0,4
D55,Theft Under $5000,2018,106,226,0,120
D11,Break & Enter-Apartment,2019,4,18,0,14
NSA,Assault,2018,2,2,1,0
D11,Fraud,2019,0,1,0,1
D55,Theft Over $5000,2018,1,3,0,2
D55,Theft Under $5000,2018,87,436,0,349
D11,Break & Enter-Apartment,2019,3,9,0,6
NSA,Assault,2018,90,251,0,161
D11,Fraud,2019,7,17,0,10
D55,Theft Over $5000,2018,1,8,0,7
D55,Theft Under $5000,2018,20,89,0,69
D11,Break & Enter-Apartment,2019,6,18,0,12
NSA,Assault,2018,2,2,1,0
D11,Fraud,2019,4,57,0,53
D55,Theft Over $5000,2018,0,1,0,1
D55,Theft Under $5000,2018,47,342,0,295
D11,Break & Enter-Apartment,2019,3,4,0,1
NSA,Assault,2018,0,1,0,1
D11,Fraud,2019,9,34,0,25
D55,Theft Over $5000,2018,1,6,0,5
D55,Theft Under $5000,2018,11,61,0,50
D11,Break & Enter-Apartment,2019,0,5,0,5
NSA,Attempt Murder,2018,0,1,0,1
D55,Theft Over $5000,2018,0,5,0,5
D11,Fraud,2019,1,5,0,4
D55,Assault,2018,44,57,0,13
D55,Theft Over $5000,2018,1,6,0,5
NSA,Other,2018,0,1,0,1
D11,Fraud,2019,2,16,0,14
D11,Break & Enter-Apartment,2019,6,34,0,28
D55,Assault,2018,35,57,0,22
D55,Theft Over $5000,2018,0,2,0,2
NSA,Other,2018,36,86,0,50
D11,Other,2019,18,53,0,35
D11,Break & Enter-Apartment,2019,0,4,0,4
D55,Assault,2018,2,2,1,0
D55,Theft Over $5000,2018,4,19,0,15
NSA,Robbery-Financial,2018,5,5,1,0
D11,Other,2019,18,81,0,63
D11,Break & Enter-Apartment,2019,3,5,0,2
D55,Assault,2018,50,95,0,45
D55,Theft Over $5000,2018,1,4,0,3
NSA,Robbery-Other,2018,48,93,0,45
D11,Other,2019,25,87,0,62
D11,Break & Enter-Commercial,2019,4,15,0,11
D55,Assault,2018,58,73,0,15
D55,Theft Over $5000,2018,1,5,0,4
NSA,Sexual Violation,2018,0,1,0,1
D11,Other,2019,9,74,0,65
D11,Break & Enter-Commercial,2019,3,15,0,12
D55,Assault,2018,111,167,0,56
D55,Theft Over $5000,2018,1,2,0,1
NSA,Sexual Violation,2018,0,1,0,1
D11,Other,2019,34,141,0,107
D11,Break & Enter-Commercial,2019,0,10,0,10
D55,Assault,2018,90,123,0,33
D55,Theft Over $5000,2018,3,7,0,4
NSA,Sexual Violation,2018,0,1,0,1
D11,Other,2019,5,18,0,13
D11,Break & Enter-Commercial,2019,2,21,0,19
D55,Assault,2018,64,105,0,41
NSA,Sexual Violation,2018,26,154,0,128
D11,Other,2019,4,15,0,11
D11,Break & Enter-Commercial,2019,16,45,0,29
D55,Assault,2018,2,3,0,1
NSA,Sexual Violation,2018,0,1,0,1
D11,Other,2019,0,1,0,1
D11,Break & Enter-Commercial,2019,0,1,0,1
D55,Assault,2018,34,50,0,16
D11,Break & Enter-Commercial,2019,1,8,0,7
NSA,Sexual Violation,2018,0,1,0,1
D11,Break & Enter-Commercial,2019,0,1,0,1
D55,Assault,2018,79,118,0,39
D11,Other,2019,2,3,0,1
NSA,Other,2018,72,73,0,1
D11,Other,2019,27,105,0,78
D11,Break & Enter-Commercial,2019,7,44,0,37
D55,Assault,2018,0,1,0,1
D11,Other,2019,11,46,0,35
D55,Assault,2018,34,53,0,19
D11,Other,2019,3,16,0,13
D55,Assault,2018,31,50,0,19
D11,Other,2019,13,30,0,17
D55,Assault,2018,127,193,0,66
D11,Theft Over $5000,2019,2,5,0,3
D55,Assault,2018,76,104,0,28
D11,Theft Over $5000,2019,0,5,0,5
D55,Assault,2018,67,90,0,23
D55,Assault,2018,35,55,0,20
D55,Assault,2018,58,80,0,22
D55,Assault,2018,23,39,0,16
D55,Attempt Murder,2018,0,1,0,1
D55,Attempt Murder,2018,1,1,1,0
D55,Attempt Murder,2018,2,2,1,0
D55,Attempt Murder,2018,0,3,0,3
D55,Attempt Murder,2018,1,1,1,0
D55,Attempt Murder,2018,1,1,1,0
D55,Attempt Murder,2018,1,1,1,0
D55,Other,2018,0,1,0,1
D55,Other,2018,13,17,0,4
D11,Theft Over $5000,2019,0,13,0,13
D11,Theft Over $5000,2019,0,8,0,8
D11,Theft Over $5000,2019,1,4,0,3
D11,Theft Over $5000,2019,0,1,0,1
D11,Theft Over $5000,2019,1,3,0,2
D11,Theft Over $5000,2019,1,5,0,4
D11,Theft Over $5000,2019,3,11,0,8
D11,Theft Over $5000,2019,0,2,0,2
D11,Theft Over $5000,2019,1,2,0,1
D11,Theft Under $5000,2019,205,408,0,203
D11,Theft Under $5000,2019,81,352,0,271
D11,Theft Under $5000,2019,61,225,0,164
D11,Theft Under $5000,2019,174,460,0,286
D11,Theft Under $5000,2019,72,376,0,304
D11,Theft Under $5000,2019,3,29,0,26
D11,Theft Under $5000,2019,35,88,0,53
D11,Theft Under $5000,2019,1,1,1,0
D11,Theft Under $5000,2019,51,67,0,16
D11,Theft Under $5000,2019,53,332,0,279
D11,Theft Under $5000,2019,75,255,0,180
D11,Theft Under $5000,2019,0,13,0,13
D11,Theft Under $5000,2019,9,48,0,39
D11,Assault,2019,34,53,0,19
D11,Assault,2019,53,80,0,27
D11,Assault,2019,57,91,0,34
D11,Assault,2019,35,59,0,24
D11,Assault,2019,101,139,0,38
D11,Assault,2019,19,21,0,2
D11,Assault,2019,18,26,0,8
D11,Assault,2019,2,3,0,1
D11,Assault,2019,5,8,0,3
D11,Assault,2019,65,102,0,37
D11,Assault,2019,29,41,0,12
D11,Assault,2019,8,15,0,7
D11,Assault,2019,51,69,0,18
D11,Other,2019,4,10,0,6
D11,Other,2019,11,20,0,9
D11,Other,2019,17,27,0,10
D11,Other,2019,8,20,0,12
D11,Other,2019,16,23,0,7
D11,Other,2019,5,6,0,1
D11,Other,2019,3,6,0,3
D11,Other,2019,2,2,1,0
D11,Other,2019,18,29,0,11
D11,Other,2019,4,8,0,4
D11,Other,2019,0,3,0,3
D11,Other,2019,9,17,0,8
D11,Robbery-Financial,2019,1,1,1,0
D11,Robbery-Financial,2019,1,1,1,0
D11,Robbery-Other,2019,13,21,0,8
D11,Robbery-Other,2019,7,11,0,4
D11,Other Criminal Violations - Offensive Weapons,2019,1,1,1,0
D11,Robbery-Other,2019,11,23,0,12
D11,Other Criminal Violations - Offensive Weapons,2019,2,2,1,0
D13,Break & Enter-Commercial,2019,0,1,0,1
D11,Robbery-Other,2019,5,9,0,4
D11,Other Criminal Violations - Offensive Weapons,2019,2,2,1,0
D12,Theft Over $5000,2019,2,9,0,7
D13,Break & Enter-Commercial,2019,11,20,0,9
D12,Robbery-Other,2019,10,22,0,12
D11,Robbery-Other,2019,11,23,0,12
D11,Robbery-Other,2019,3,4,0,1
D11,Robbery-Other,2019,1,2,0,1
D11,Robbery-Other,2019,2,2,1,0
D11,Robbery-Other,2019,9,21,0,12
D11,Robbery-Other,2019,10,17,0,7
D11,Robbery-Other,2019,0,1,0,1
D11,Sexual Violation,2019,0,1,0,1
D11,Sexual Violation,2019,8,16,0,8
D11,Sexual Violation,2019,12,16,0,4
D11,Sexual Violation,2019,6,15,0,9
D11,Sexual Violation,2019,3,12,0,9
D11,Sexual Violation,2019,9,14,0,5
D11,Sexual Violation,2019,4,5,0,1
D11,Sexual Violation,2019,7,7,1,0
D11,Sexual Violation,2019,0,3,0,3
D11,Sexual Violation,2019,5,10,0,5
D11,Sexual Violation,2019,2,9,0,7
D11,Sexual Violation,2019,0,1,0,1
D11,Sexual Violation,2019,5,8,0,3
D11,Other,2019,1,2,0,1
D11,Other,2019,4,4,1,0
D11,Other,2019,12,12,1,0
D11,Other,2019,17,17,1,0
D11,Other,2019,6,7,0,1
D11,Other,2019,10,10,1,0
D11,Other,2019,5,5,1,0
D11,Other,2019,10,10,1,0
D11,Other,2019,6,6,1,0
D11,Other,2019,70,82,0,12
D11,Other,2019,52,59,0,7
D11,Other,2019,45,56,0,11
D11,Other,2019,72,77,0,5
D11,Other,2019,88,100,0,12
D11,Other,2019,9,9,1,0
D11,Other,2019,12,13,0,1
D11,Other,2019,14,14,1,0
D11,Other,2019,11,11,1,0
D11,Other,2019,106,110,0,4
D11,Other,2019,30,39,0,9
D11,Other,2019,14,14,1,0
D11,Other,2019,115,118,0,3
D11,Other Criminal Violations - Offensive Weapons,2019,11,16,0,5
D11,Other Criminal Violations - Offensive Weapons,2019,13,14,0,1
D11,Other Criminal Violations - Offensive Weapons,2019,9,9,1,0
D11,Other Criminal Violations - Offensive Weapons,2019,4,4,1,0
D11,Other Criminal Violations - Offensive Weapons,2019,11,14,0,3
D12,Break & Enter-Commercial,2019,0,3,0,3
D13,Break & Enter-Commercial,2019,0,2,0,2
D12,Theft Over $5000,2019,0,3,0,3
D11,Other Criminal Violations - Offensive Weapons,2019,9,9,1,0
D13,Break & Enter-Commercial,2019,4,10,0,6
D11,Other Criminal Violations - Offensive Weapons,2019,3,3,1,0
D12,Robbery-Other,2019,2,4,0,2
D13,Break & Enter-Commercial,2019,0,1,0,1
D11,Other Criminal Violations - Offensive Weapons,2019,2,2,1,0
D12,Theft Over $5000,2019,1,5,0,4
D13,Break & Enter-Commercial,2019,3,5,0,2
D12,Robbery-Other,2019,3,9,0,6
D12,Break & Enter-Commercial,2019,3,5,0,2
D11,Other Criminal Violations - Offensive Weapons,2019,9,10,0,1
D12,Theft Over $5000,2019,1,3,0,2
D13,Break & Enter-Commercial,2019,3,8,0,5
D12,Robbery-Other,2019,1,2,0,1
D12,Break & Enter-Commercial,2019,8,18,0,10
D11,Other,2019,1,1,1,0
D12,Theft Over $5000,2019,0,4,0,4
D13,Break & Enter-Commercial,2019,7,14,0,7
D12,Robbery-Other,2019,6,13,0,7
D12,Break & Enter-Commercial,2019,1,2,0,1
D11,Other,2019,2,2,1,0
D12,Theft Over $5000,2019,0,1,0,1
D13,Break & Enter-Commercial,2019,6,20,0,14
D12,Robbery-Other,2019,2,3,0,1
D12,Break & Enter-Commercial,2019,7,29,0,22
D11,Other,2019,1,2,0,1
D12,Theft Over $5000,2019,0,4,0,4
D13,Break & Enter-Commercial,2019,15,26,0,11
D12,Robbery-Other,2019,1,5,0,4
D12,Break & Enter-Commercial,2019,0,6,0,6
D11,Other,2019,1,1,1,0
D12,Theft Over $5000,2019,0,1,0,1
D13,Break & Enter-House,2019,1,5,0,4
D12,Robbery-Other,2019,0,3,0,3
D12,Break & Enter-House,2019,1,2,0,1
D11,Other,2019,2,2,1,0
D12,Theft Under $5000,2019,16,78,0,62
D13,Break & Enter-House,2019,2,4,0,2
D12,Robbery-Other,2019,11,23,0,12
D11,Other,2019,0,1,0,1
D12,Break & Enter-House,2019,2,8,0,6
D12,Other,2019,5,5,1,0
D12,Theft Under $5000,2019,197,335,0,138
D13,Break & Enter-House,2019,1,5,0,4
D12,Other,2019,9,9,1,0
D12,Break & Enter-House,2019,1,1,1,0
D12,Robbery-Other,2019,1,3,0,2
D12,Other,2019,1,1,1,0
D12,Break & Enter-House,2019,1,2,0,1
D12,Theft Under $5000,2019,77,134,0,57
D13,Break & Enter-House,2019,4,7,0,3
D12,Sexual Violation,2019,7,10,0,3
D12,Other,2019,11,11,1,0
D12,Break & Enter-House,2019,0,9,0,9
D12,Theft Under $5000,2019,31,108,0,77
D13,Break & Enter-House,2019,1,9,0,8
D12,Sexual Violation,2019,9,18,0,9
D12,Other,2019,4,4,1,0
D12,Break & Enter-House,2019,1,3,0,2
D12,Theft Under $5000,2019,1,32,0,31
D13,Break & Enter-House,2019,2,10,0,8
D12,Sexual Violation,2019,1,2,0,1
D12,Other,2019,9,9,1,0
D12,Break & Enter-House,2019,0,2,0,2
D12,Theft Under $5000,2019,14,65,0,51
D13,Break & Enter-House,2019,3,14,0,11
D12,Sexual Violation,2019,5,8,0,3
D12,Other,2019,4,5,0,1
D12,Break & Enter-House,2019,1,5,0,4
D12,Theft Under $5000,2019,1,3,0,2
D13,Break & Enter-House,2019,3,11,0,8
D12,Sexual Violation,2019,5,5,1,0
D12,Other,2019,15,15,1,0
D12,Break & Enter-House,2019,0,3,0,3
D12,Theft Under $5000,2019,142,393,0,251
D13,Break & Enter-House,2019,0,1,0,1
D12,Sexual Violation,2019,10,21,0,11
D12,Other,2019,9,10,0,1
D12,Break & Enter-House,2019,0,2,0,2
D12,Theft Under $5000,2019,16,130,0,114
D13,Break & Enter-House,2019,7,15,0,8
D12,Sexual Violation,2019,0,1,0,1
D12,Sexual Violation,2019,0,1,0,1
D12,Sexual Violation,2019,11,16,0,5
D12,Sexual Violation,2019,4,7,0,3
D12,Sexual Violation,2019,10,16,0,6
D12,Sexual Violation,2019,2,4,0,2
D12,Other,2019,7,7,1,0
D12,Other,2019,10,11,0,1
D12,Other,2019,3,3,1,0
D12,Other,2019,4,4,1,0
D12,Other,2019,12,12,1,0
D12,Other,2019,3,4,0,1
D12,Other,2019,3,3,1,0
D12,Other,2019,1,1,1,0
D12,Other,2019,7,8,0,1
D12,Other,2019,10,10,1,0
D12,Other,2019,52,56,0,4
D12,Other,2019,67,71,0,4
D12,Other,2019,19,19,1,0
D12,Other,2019,37,42,0,5
D12,Other,2019,10,14,0,4
D12,Other,2019,37,39,0,2
D12,Other,2019,23,24,0,1
D12,Other,2019,29,30,0,1
D12,Other,2019,77,83,0,6
D12,Other,2019,28,29,0,1
D12,Other,2019,90,102,0,12
D12,Other,2019,9,10,0,1
D12,Other Criminal Violations - Offensive Weapons,2019,9,9,1,0
D12,Other Criminal Violations - Offensive Weapons,2019,8,10,0,2
D12,Other Criminal Violations - Offensive Weapons,2019,3,5,0,2
D12,Other Criminal Violations - Offensive Weapons,2019,6,7,0,1
D12,Other Criminal Violations - Offensive Weapons,2019,2,2,1,0
D12,Other Criminal Violations - Offensive Weapons,2019,6,6,1,0
D12,Break & Enter-Other,2019,0,1,0,1
D12,Theft Under $5000,2019,7,42,0,35
D13,Break & Enter-House,2019,5,14,0,9
D12,Other,2019,23,23,1,0
D12,Break & Enter-Other,2019,1,1,1,0
D12,Theft Under $5000,2019,18,153,0,135
D13,Break & Enter-House,2019,0,4,0,4
D12,Other,2019,4,4,1,0
D12,Break & Enter-Other,2019,1,1,1,0
D12,Theft Under $5000,2019,5,30,0,25
D12,Assault,2019,47,61,0,14
D12,Assault,2019,70,96,0,26
D12,Assault,2019,16,26,0,10
D12,Assault,2019,41,55,0,14
D12,Assault,2019,23,25,0,2
D12,Assault,2019,56,84,0,28
D12,Assault,2019,2,2,1,0
D12,Assault,2019,13,22,0,9
D12,Assault,2019,87,123,0,36
D12,Assault,2019,43,59,0,16
D12,Assault,2019,111,162,0,51
D12,Assault,2019,11,25,0,14
D12,Attempt Murder,2019,5,5,1,0
D12,Attempt Murder,2019,0,7,0,7
D12,Attempt Murder,2019,1,1,1,0
D12,Attempt Murder,2019,1,1,1,0
D12,Attempt Murder,2019,0,2,0,2
D12,Attempt Murder,2019,7,7,1,0
D12,Other,2019,8,17,0,9
D12,Other,2019,11,19,0,8
D12,Other,2019,4,5,0,1
D12,Other,2019,5,12,0,7
D12,Other,2019,4,8,0,4
D12,Other,2019,19,26,0,7
D12,Other,2019,5,8,0,3
D12,Other,2019,13,22,0,9
D12,Other,2019,7,9,0,2
D12,Other,2019,10,18,0,8
D12,Other,2019,0,3,0,3
D12,Robbery-Other,2019,6,10,0,4
D12,Break & Enter-Other,2019,2,2,1,0
D12,Break & Enter-Other,2019,1,2,0,1
D12,Break & Enter-Other,2019,0,4,0,4
D12,Break & Enter-Other,2019,2,9,0,7
D12,Break & Enter-Other,2019,0,1,0,1
D12,Fraud,2019,7,33,0,26
D12,Fraud,2019,16,64,0,48
D12,Fraud,2019,2,14,0,12
D12,Fraud,2019,6,29,0,23
D12,Fraud,2019,0,9,0,9
D12,Fraud,2019,3,24,0,21
D12,Fraud,2019,11,37,0,26
D12,Fraud,2019,8,71,0,63
D12,Fraud,2019,3,29,0,26
D12,Fraud,2019,12,67,0,55
D12,Fraud,2019,1,11,0,10
D12,Other,2019,11,36,0,25
D12,Other,2019,25,73,0,48
D12,Other,2019,6,18,0,12
D12,Other,2019,24,52,0,28
D12,Other,2019,6,21,0,15
D12,Other,2019,15,56,0,41
D12,Other,2019,1,1,1,0
D12,Other,2019,10,33,0,23
D12,Other,2019,43,107,0,64
D12,Other,2019,18,32,0,14
D12,Other,2019,39,118,0,79
D12,Other,2019,8,17,0,9
D12,Theft Over $5000,2019,0,2,0,2
D12,Theft Over $5000,2019,1,12,0,11
D12,Theft Over $5000,2019,1,1,1,0
D13,Break & Enter-Other,2019,2,5,0,3
D13,Break & Enter-Other,2019,0,1,0,1
D13,Break & Enter-Other,2019,0,2,0,2
D13,Break & Enter-Other,2019,1,3,0,2
D13,Break & Enter-Other,2019,0,1,0,1
D13,Break & Enter-Other,2019,2,4,0,2
D13,Break & Enter-Other,2019,0,2,0,2
D13,Break & Enter-Other,2019,1,4,0,3
D13,Break & Enter-Other,2019,0,4,0,4
D13,Break & Enter-Other,2019,2,4,0,2
D13,Fraud,2019,16,54,0,38
D13,Fraud,2019,3,27,0,24
D13,Fraud,2019,2,24,0,22
D13,Fraud,2019,2,37,0,35
D13,Fraud,2019,0,21,0,21
D13,Fraud,2019,0,18,0,18
D13,Fraud,2019,4,33,0,29
D13,Fraud,2019,4,37,0,33
D13,Fraud,2019,0,14,0,14
D13,Fraud,2019,1,3,0,2
D13,Fraud,2019,12,54,0,42
D13,Fraud,2019,8,61,0,53
D13,Fraud,2019,9,43,0,34
D13,Other,2019,21,55,0,34
D13,Other,2019,10,24,0,14
D13,Other,2019,2,16,0,14
D13,Other,2019,28,101,0,73
D13,Other,2019,3,12,0,9
D12,Auto Theft,2019,1,13,0,12
D12,Auto Theft,2019,7,37,0,30
D12,Auto Theft,2019,1,12,0,11
D12,Auto Theft,2019,5,33,0,28
D12,Auto Theft,2019,1,25,0,24
D12,Auto Theft,2019,4,23,0,19
D12,Auto Theft,2019,0,5,0,5
D12,Auto Theft,2019,2,26,0,24
D12,Auto Theft,2019,7,38,0,31
D12,Auto Theft,2019,9,38,0,29
D12,Auto Theft,2019,12,47,0,35
D12,Auto Theft,2019,0,10,0,10
D12,Break & Enter-Apartment,2019,1,3,0,2
D12,Break & Enter-Apartment,2019,4,17,0,13
D12,Break & Enter-Apartment,2019,2,3,0,1
D12,Break & Enter-Apartment,2019,1,3,0,2
D12,Break & Enter-Apartment,2019,3,6,0,3
D12,Break & Enter-Apartment,2019,6,15,0,9
D12,Break & Enter-Apartment,2019,3,9,0,6
D12,Break & Enter-Apartment,2019,1,20,0,19
D12,Break & Enter-Apartment,2019,0,2,0,2
D12,Break & Enter-Commercial,2019,1,5,0,4
D12,Break & Enter-Commercial,2019,4,24,0,20
D12,Break & Enter-Commercial,2019,1,4,0,3
D12,Break & Enter-Commercial,2019,1,11,0,10
D12,Break & Enter-Commercial,2019,1,3,0,2
D13,Other,2019,1,9,0,8
D13,Other,2019,5,19,0,14
D13,Other,2019,17,56,0,39
D13,Other,2019,9,28,0,19
D13,Other,2019,31,82,0,51
D13,Other,2019,22,83,0,61
D13,Other,2019,19,48,0,29
D13,Theft Over $5000,2019,1,6,0,5
D13,Theft Over $5000,2019,0,2,0,2
D13,Theft Over $5000,2019,0,2,0,2
D13,Theft Over $5000,2019,0,5,0,5
D13,Theft Over $5000,2019,0,3,0,3
D13,Theft Over $5000,2019,2,2,1,0
D13,Theft Over $5000,2019,0,3,0,3
D13,Theft Over $5000,2019,1,3,0,2
D13,Theft Over $5000,2019,0,2,0,2
D13,Theft Over $5000,2019,0,1,0,1
D13,Theft Over $5000,2019,1,2,0,1
D13,Theft Under $5000,2019,0,1,0,1
D13,Theft Under $5000,2019,32,118,0,86
D13,Theft Under $5000,2019,14,58,0,44
D13,Theft Under $5000,2019,118,334,0,216
D13,Theft Under $5000,2019,23,114,0,91
D13,Theft Under $5000,2019,4,57,0,53
D13,Theft Under $5000,2019,5,48,0,43
D13,Theft Under $5000,2019,56,130,0,74
D13,Theft Under $5000,2019,21,129,0,108
D13,Theft Under $5000,2019,4,51,0,47
D13,Theft Under $5000,2019,0,1,0,1
D13,Theft Under $5000,2019,35,164,0,129
D13,Theft Under $5000,2019,92,295,0,203
D13,Theft Under $5000,2019,39,116,0,77
D13,Assault,2019,47,65,0,18
D13,Assault,2019,48,64,0,16
D13,Assault,2019,18,34,0,16
D13,Assault,2019,58,81,0,23
D13,Assault,2019,4,11,0,7
D13,Assault,2019,6,20,0,14
D13,Assault,2019,8,20,0,12
D13,Assault,2019,27,40,0,13
D13,Assault,2019,15,20,0,5
D13,Assault,2019,1,2,0,1
D13,Assault,2019,85,131,0,46
D13,Assault,2019,43,66,0,23
D13,Assault,2019,43,63,0,20
D13,Attempt Murder,2019,0,2,0,2
D13,Attempt Murder,2019,1,1,1,0
D13,Attempt Murder,2019,2,3,0,1
D13,Attempt Murder,2019,0,3,0,3
D13,Other,2019,16,25,0,9
D12,Other Criminal Violations - Offensive Weapons,2019,4,4,1,0
D12,Other Criminal Violations - Offensive Weapons,2019,14,15,0,1
D12,Other Criminal Violations - Offensive Weapons,2019,5,5,1,0
D12,Other Criminal Violations - Offensive Weapons,2019,16,18,0,2
D12,Other Criminal Violations - Offensive Weapons,2019,2,2,1,0
D12,Other,2019,1,1,1,0
D12,Other,2019,3,3,1,0
D12,Other,2019,2,2,1,0
D12,Other,2019,3,3,1,0
D12,Other,2019,3,4,0,1
D12,Other,2019,1,1,1,0
D12,Other,2019,2,2,1,0
D12,Other,2019,1,1,1,0
D12,Other,2019,1,1,1,0
D12,Other,2019,2,2,1,0
D13,Other,2019,10,10,1,0
D13,Other,2019,7,7,1,0
D13,Other,2019,1,1,1,0
D13,Other,2019,7,7,1,0
D13,Other,2019,3,3,1,0
D13,Other,2019,1,1,1,0
D13,Other,2019,10,10,1,0
D13,Other,2019,2,2,1,0
D13,Other,2019,5,5,1,0
D13,Auto Theft,2019,6,21,0,15
D13,Auto Theft,2019,4,9,0,5
D13,Auto Theft,2019,0,2,0,2
D13,Auto Theft,2019,6,17,0,11
D13,Auto Theft,2019,2,17,0,15
D13,Auto Theft,2019,0,13,0,13
D13,Auto Theft,2019,0,15,0,15
D13,Auto Theft,2019,2,18,0,16
D13,Auto Theft,2019,0,4,0,4
D13,Auto Theft,2019,19,43,0,24
D13,Auto Theft,2019,0,11,0,11
D13,Auto Theft,2019,1,18,0,17
D13,Break & Enter-Apartment,2019,3,7,0,4
D13,Break & Enter-Apartment,2019,1,1,1,0
D13,Break & Enter-Apartment,2019,1,3,0,2
D13,Break & Enter-Apartment,2019,2,10,0,8
D13,Break & Enter-Apartment,2019,0,5,0,5
D13,Break & Enter-Apartment,2019,0,2,0,2
D13,Break & Enter-Apartment,2019,0,6,0,6
D13,Break & Enter-Apartment,2019,2,8,0,6
D13,Break & Enter-Apartment,2019,0,1,0,1
D13,Break & Enter-Apartment,2019,7,16,0,9
D13,Break & Enter-Apartment,2019,5,11,0,6
D13,Break & Enter-Apartment,2019,1,4,0,3
D13,Break & Enter-Commercial,2019,16,32,0,16
D13,Break & Enter-Commercial,2019,2,4,0,2
D13,Other,2019,15,16,0,1
D13,Other,2019,9,10,0,1
D13,Other,2019,12,12,1,0
D13,Other,2019,45,47,0,2
D13,Other,2019,19,20,0,1
D13,Other,2019,34,36,0,2
D13,Other,2019,33,40,0,7
D13,Other,2019,5,6,0,1
D13,Other,2019,6,9,0,3
D13,Other,2019,20,21,0,1
D13,Other,2019,34,41,0,7
D13,Other,2019,6,7,0,1
D14,Other,2019,79,90,0,11
D14,Break & Enter-Other,2019,0,1,0,1
D22,Auto Theft,2019,1,36,0,35
D13,Other,2019,3,3,1,0
D13,Other,2019,64,73,0,9
D13,Other,2019,53,57,0,4
D13,Other,2019,19,23,0,4
D13,Other Criminal Violations - Offensive Weapons,2019,5,5,1,0
D13,Other Criminal Violations - Offensive Weapons,2019,3,4,0,1
D13,Other Criminal Violations - Offensive Weapons,2019,3,5,0,2
D13,Other Criminal Violations - Offensive Weapons,2019,8,9,0,1
D13,Other Criminal Violations - Offensive Weapons,2019,1,1,1,0
D13,Other Criminal Violations - Offensive Weapons,2019,2,2,1,0
D13,Other Criminal Violations - Offensive Weapons,2019,3,4,0,1
D13,Other Criminal Violations - Offensive Weapons,2019,10,13,0,3
D13,Other Criminal Violations - Offensive Weapons,2019,4,4,1,0
D13,Other Criminal Violations - Offensive Weapons,2019,4,4,1,0
D13,Other,2019,1,1,1,0
D13,Other,2019,1,1,1,0
D13,Other,2019,2,2,1,0
D13,Other,2019,2,2,1,0
D13,Other,2019,1,1,1,0
D14,Other,2019,3,3,1,0
D14,Other,2019,3,3,1,0
D14,Other,2019,1,1,1,0
D14,Other,2019,7,9,0,2
D14,Other,2019,11,14,0,3
D14,Other,2019,15,16,0,1
D14,Other,2019,6,6,1,0
D14,Other,2019,2,2,1,0
D14,Other,2019,5,5,1,0
D14,Other,2019,42,47,0,5
D14,Other,2019,10,11,0,1
D14,Other,2019,4,4,1,0
D14,Other,2019,18,18,1,0
D14,Other,2019,9,10,0,1
D14,Auto Theft,2019,1,16,0,15
D14,Auto Theft,2019,3,11,0,8
D14,Auto Theft,2019,0,2,0,2
D14,Auto Theft,2019,4,20,0,16
D14,Auto Theft,2019,2,7,0,5
D14,Robbery-Other,2019,2,6,0,4
D14,Theft Over $5000,2019,0,6,0,6
D13,Other,2019,2,11,0,9
D14,Break & Enter-Other,2019,1,7,0,6
D14,Other,2019,23,27,0,4
D14,Robbery-Other,2019,3,13,0,10
D22,Break & Enter-Apartment,2019,2,3,0,1
D14,Theft Under $5000,2019,43,331,0,288
D14,Break & Enter-Other,2019,1,8,0,7
D14,Other,2019,74,81,0,7
D22,Break & Enter-Apartment,2019,1,8,0,7
D14,Theft Under $5000,2019,30,221,0,191
D14,Robbery-Other,2019,2,9,0,7
D13,Other,2019,1,4,0,3
D22,Break & Enter-Apartment,2019,1,4,0,3
D14,Theft Under $5000,2019,2,66,0,64
D14,Robbery-Other,2019,2,5,0,3
D14,Break & Enter-Other,2019,5,7,0,2
D14,Other,2019,74,78,0,4
D13,Other,2019,9,21,0,12
D22,Break & Enter-Apartment,2019,1,12,0,11
D14,Theft Under $5000,2019,30,348,0,318
D14,Robbery-Other,2019,1,7,0,6
D14,Break & Enter-Other,2019,0,3,0,3
D14,Other Criminal Violations - Offensive Weapons,2019,7,7,1,0
D13,Other,2019,2,5,0,3
D22,Break & Enter-Apartment,2019,1,4,0,3
D14,Theft Under $5000,2019,37,192,0,155
D14,Theft Under $5000,2019,93,513,0,420
D14,Theft Under $5000,2019,32,149,0,117
D14,Theft Under $5000,2019,0,2,0,2
D14,Theft Under $5000,2019,69,463,0,394
D14,Theft Under $5000,2019,152,533,0,381
D14,Theft Under $5000,2019,0,1,0,1
D14,Theft Under $5000,2019,79,425,0,346
D14,Theft Under $5000,2019,36,216,0,180
D14,Theft Under $5000,2019,100,546,0,446
D14,Theft Under $5000,2019,36,289,0,253
D14,Assault,2019,57,96,0,39
D14,Assault,2019,52,90,0,38
D14,Assault,2019,14,31,0,17
D14,Assault,2019,81,117,0,36
D14,Assault,2019,57,87,0,30
D14,Assault,2019,123,194,0,71
D14,Assault,2019,35,53,0,18
D14,Assault,2019,3,4,0,1
D14,Assault,2019,64,89,0,25
D14,Assault,2019,136,208,0,72
D14,Assault,2019,64,108,0,44
D14,Assault,2019,32,61,0,29
D14,Assault,2019,107,188,0,81
D14,Assault,2019,71,105,0,34
D14,Attempt Murder,2019,2,2,1,0
D14,Attempt Murder,2019,2,2,1,0
D14,Other,2019,15,20,0,5
D14,Other,2019,8,13,0,5
D14,Other,2019,2,10,0,8
D14,Other,2019,12,16,0,4
D14,Other,2019,9,11,0,2
D14,Other,2019,19,25,0,6
D14,Other,2019,3,8,0,5
D14,Other,2019,0,1,0,1
D14,Other,2019,6,12,0,6
D14,Other,2019,21,36,0,15
D14,Other,2019,7,16,0,9
D14,Other,2019,13,23,0,10
D14,Other,2019,7,17,0,10
D14,Other,2019,17,22,0,5
D14,Robbery-Financial,2019,1,1,1,0
D14,Robbery-Financial,2019,1,1,1,0
D14,Robbery-Financial,2019,1,1,1,0
D14,Robbery-Financial,2019,0,2,0,2
D14,Robbery-Other,2019,9,21,0,12
D14,Break & Enter-Other,2019,1,6,0,5
D14,Other Criminal Violations - Offensive Weapons,2019,2,3,0,1
D14,Robbery-Other,2019,4,7,0,3
D22,Break & Enter-Apartment,2019,9,26,0,17
D14,Other Criminal Violations - Offensive Weapons,2019,3,3,1,0
D14,Break & Enter-Other,2019,3,5,0,2
D14,Robbery-Other,2019,0,1,0,1
D22,Break & Enter-Apartment,2019,2,7,0,5
D14,Other Criminal Violations - Offensive Weapons,2019,2,5,0,3
D14,Break & Enter-Other,2019,3,7,0,4
D14,Robbery-Other,2019,5,8,0,3
D22,Break & Enter-Apartment,2019,0,2,0,2
D14,Other Criminal Violations - Offensive Weapons,2019,5,5,1,0
D14,Break & Enter-Other,2019,1,7,0,6
D14,Robbery-Other,2019,8,30,0,22
D22,Break & Enter-Apartment,2019,5,11,0,6
D14,Other Criminal Violations - Offensive Weapons,2019,10,12,0,2
D14,Break & Enter-Other,2019,0,6,0,6
D14,Robbery-Other,2019,9,20,0,11
D22,Break & Enter-Apartment,2019,0,7,0,7
D14,Other Criminal Violations - Offensive Weapons,2019,3,3,1,0
D14,Break & Enter-Other,2019,0,3,0,3
D22,Break & Enter-Apartment,2019,7,19,0,12
D13,Other,2019,3,4,0,1
D14,Robbery-Other,2019,10,12,0,2
D14,Other Criminal Violations - Offensive Weapons,2019,8,8,1,0
D14,Fraud,2019,12,80,0,68
D13,Other,2019,3,6,0,3
D14,Robbery-Other,2019,7,23,0,16
D14,Other Criminal Violations - Offensive Weapons,2019,15,16,0,1
D22,Break & Enter-Apartment,2019,1,10,0,9
D14,Fraud,2019,7,42,0,35
D13,Other,2019,5,12,0,7
D14,Robbery-Other,2019,1,8,0,7
D14,Other Criminal Violations - Offensive Weapons,2019,6,6,1,0
D22,Break & Enter-Apartment,2019,0,2,0,2
D14,Fraud,2019,1,33,0,32
D13,Other,2019,2,4,0,2
D14,Sexual Violation,2019,6,11,0,5
D14,Other Criminal Violations - Offensive Weapons,2019,5,5,1,0
D22,Break & Enter-Apartment,2019,1,11,0,10
D14,Fraud,2019,15,124,0,109
D13,Other,2019,2,2,1,0
D14,Sexual Violation,2019,8,11,0,3
D14,Other Criminal Violations - Offensive Weapons,2019,12,14,0,2
D22,Break & Enter-Commercial,2019,5,13,0,8
D14,Fraud,2019,1,69,0,68
D13,Other,2019,13,26,0,13
D14,Sexual Violation,2019,4,6,0,2
D14,Other Criminal Violations - Offensive Weapons,2019,3,4,0,1
D22,Break & Enter-Commercial,2019,1,8,0,7
D14,Fraud,2019,7,104,0,97
D13,Other,2019,6,9,0,3
D14,Sexual Violation,2019,8,14,0,6
D14,Other,2019,1,1,1,0
D22,Break & Enter-Commercial,2019,1,5,0,4
D14,Fraud,2019,6,73,0,67
D13,Other,2019,3,13,0,10
D14,Sexual Violation,2019,10,15,0,5
D14,Other,2019,3,3,1,0
D22,Break & Enter-Commercial,2019,18,56,0,38
D14,Fraud,2019,7,70,0,63
D13,Robbery-Financial,2019,1,2,0,1
D14,Sexual Violation,2019,7,15,0,8
D14,Other,2019,3,3,1,0
D22,Break & Enter-Commercial,2019,0,6,0,6
D22,Break & Enter-Commercial,2019,2,11,0,9
D22,Break & Enter-Commercial,2019,0,2,0,2
D22,Break & Enter-Commercial,2019,3,14,0,11
D22,Break & Enter-Commercial,2019,2,8,0,6
D22,Break & Enter-Commercial,2019,4,11,0,7
D22,Break & Enter-Commercial,2019,1,7,0,6
D22,Break & Enter-Commercial,2019,0,5,0,5
D22,Break & Enter-Commercial,2019,3,19,0,16
D22,Break & Enter-House,2019,0,8,0,8
D22,Break & Enter-House,2019,1,35,0,34
D22,Break & Enter-House,2019,1,10,0,9
D22,Break & Enter-House,2019,1,4,0,3
D22,Break & Enter-House,2019,0,4,0,4
D22,Break & Enter-House,2019,10,33,0,23
D22,Break & Enter-House,2019,3,19,0,16
D22,Break & Enter-House,2019,2,3,0,1
D22,Break & Enter-House,2019,1,8,0,7
D22,Break & Enter-House,2019,6,12,0,6
D22,Break & Enter-House,2019,0,5,0,5
D22,Break & Enter-House,2019,3,25,0,22
D22,Break & Enter-House,2019,9,29,0,20
D22,Break & Enter-Other,2019,1,2,0,1
D22,Break & Enter-Other,2019,0,2,0,2
D22,Break & Enter-Other,2019,0,1,0,1
D22,Break & Enter-Other,2019,1,2,0,1
D22,Break & Enter-Other,2019,0,2,0,2
D22,Break & Enter-Other,2019,0,2,0,2
D22,Break & Enter-Other,2019,0,1,0,1
D22,Break & Enter-Other,2019,1,2,0,1
D22,Break & Enter-Other,2019,0,3,0,3
D14,Auto Theft,2019,5,29,0,24
D14,Fraud,2019,4,99,0,95
D14,Other,2019,2,2,1,0
D14,Sexual Violation,2019,10,16,0,6
D13,Robbery-Financial,2019,2,2,1,0
D14,Fraud,2019,14,125,0,111
D14,Auto Theft,2019,2,10,0,8
D14,Other,2019,1,1,1,0
D14,Sexual Violation,2019,7,17,0,10
D13,Robbery-Financial,2019,3,3,1,0
D14,Fraud,2019,4,58,0,54
D14,Auto Theft,2019,1,13,0,12
D22,Other,2019,4,4,1,0
D22,Other,2019,1,1,1,0
D22,Other,2019,2,2,1,0
D22,Other,2019,17,17,1,0
D22,Other,2019,4,4,1,0
D22,Other,2019,9,10,0,1
D22,Other,2019,4,4,1,0
D22,Other,2019,3,3,1,0
D22,Other,2019,1,1,1,0
D22,Other,2019,28,31,0,3
D22,Other,2019,1,2,0,1
D22,Other,2019,17,20,0,3
D22,Other,2019,0,1,0,1
D22,Other,2019,5,7,0,2
D22,Auto Theft,2019,0,15,0,15
D22,Auto Theft,2019,0,22,0,22
D22,Auto Theft,2019,0,41,0,41
D22,Auto Theft,2019,12,121,0,109
D22,Auto Theft,2019,0,12,0,12
D22,Auto Theft,2019,7,22,0,15
D22,Auto Theft,2019,1,59,0,58
D22,Auto Theft,2019,1,30,0,29
D22,Auto Theft,2019,1,11,0,10
D22,Auto Theft,2019,0,9,0,9
D22,Auto Theft,2019,4,42,0,38
D22,Auto Theft,2019,0,1,0,1
D22,Auto Theft,2019,6,23,0,17
D22,Auto Theft,2019,0,28,0,28
D13,Robbery-Other,2019,5,18,0,13
D14,Sexual Violation,2019,7,22,0,15
D14,Fraud,2019,12,182,0,170
D13,Robbery-Other,2019,8,16,0,8
D14,Sexual Violation,2019,4,8,0,4
D14,Fraud,2019,7,98,0,91
D13,Robbery-Other,2019,3,7,0,4
D14,Sexual Violation,2019,8,13,0,5
D14,Other,2019,20,107,0,87
D13,Robbery-Other,2019,11,27,0,16
D14,Sexual Violation,2019,14,27,0,13
D14,Other,2019,20,82,0,62
D13,Robbery-Other,2019,0,2,0,2
D14,Sexual Violation,2019,8,15,0,7
D14,Other,2019,8,38,0,30
D13,Robbery-Other,2019,3,4,0,1
D14,Other,2019,0,1,0,1
D14,Other,2019,30,75,0,45
D14,Other,2019,26,79,0,53
D14,Other,2019,57,170,0,113
D14,Other,2019,5,34,0,29
D14,Other,2019,0,2,0,2
D14,Other,2019,27,96,0,69
D14,Other,2019,49,121,0,72
D14,Other,2019,24,99,0,75
D14,Other,2019,14,85,0,71
D14,Other,2019,32,93,0,61
D14,Other,2019,39,96,0,57
D14,Theft Over $5000,2019,2,8,0,6
D14,Theft Over $5000,2019,1,3,0,2
D14,Theft Over $5000,2019,0,3,0,3
D14,Theft Over $5000,2019,2,12,0,10
D14,Theft Over $5000,2019,0,5,0,5
D14,Theft Over $5000,2019,1,10,0,9
D14,Theft Over $5000,2019,1,6,0,5
D14,Theft Over $5000,2019,5,12,0,7
D14,Theft Over $5000,2019,5,24,0,19
D14,Theft Over $5000,2019,1,3,0,2
D14,Theft Over $5000,2019,1,5,0,4
D14,Theft Over $5000,2019,1,14,0,13
D14,Auto Theft,2019,4,19,0,15
D14,Other,2019,10,10,1,0
D14,Other,2019,2,2,1,0
D14,Other,2019,12,12,1,0
D14,Other,2019,13,13,1,0
D14,Other,2019,6,7,0,1
D14,Other,2019,7,7,1,0
D14,Other,2019,10,10,1,0
D14,Other,2019,11,13,0,2
D14,Other,2019,12,12,1,0
D14,Other,2019,3,4,0,1
D14,Other,2019,19,19,1,0
D14,Other,2019,6,6,1,0
D14,Other,2019,35,41,0,6
D14,Other,2019,38,40,0,2
D14,Other,2019,11,13,0,2
D14,Other,2019,56,58,0,2
D14,Other,2019,59,64,0,5
D14,Other,2019,139,149,0,10
D14,Other,2019,94,106,0,12
D14,Other,2019,2,2,1,0
D14,Other,2019,49,59,0,10
D13,Robbery-Other,2019,2,13,0,11
D14,Other,2019,139,148,0,9
D13,Robbery-Other,2019,3,7,0,4
D13,Robbery-Other,2019,1,2,0,1
D13,Robbery-Other,2019,0,3,0,3
D13,Robbery-Other,2019,18,40,0,22
D13,Robbery-Other,2019,2,9,0,7
D13,Robbery-Other,2019,3,11,0,8
D13,Sexual Violation,2019,3,9,0,6
D13,Sexual Violation,2019,5,7,0,2
D13,Sexual Violation,2019,2,8,0,6
D13,Sexual Violation,2019,13,19,0,6
D13,Sexual Violation,2019,1,2,0,1
D13,Sexual Violation,2019,4,6,0,2
D13,Sexual Violation,2019,2,4,0,2
D13,Sexual Violation,2019,4,8,0,4
D13,Sexual Violation,2019,3,4,0,1
D13,Sexual Violation,2019,11,15,0,4
D13,Sexual Violation,2019,6,12,0,6
D13,Sexual Violation,2019,2,10,0,8
D13,Other,2019,1,1,1,0
D13,Other,2019,4,4,1,0
D13,Other,2019,10,10,1,0
D13,Other,2019,1,1,1,0
D13,Other,2019,15,16,0,1
D13,Other,2019,2,2,1,0
D13,Other,2019,2,2,1,0
D13,Other,2019,4,5,0,1
D13,Other,2019,6,6,1,0
D13,Other,2019,2,2,1,0
D14,Auto Theft,2019,6,23,0,17
D14,Auto Theft,2019,1,9,0,8
D14,Auto Theft,2019,5,16,0,11
D14,Auto Theft,2019,2,14,0,12
D14,Break & Enter-Apartment,2019,3,17,0,14
D14,Break & Enter-Apartment,2019,6,10,0,4
D14,Break & Enter-Apartment,2019,0,4,0,4
D14,Break & Enter-Apartment,2019,8,52,0,44
D14,Break & Enter-Apartment,2019,4,35,0,31
D14,Break & Enter-Apartment,2019,7,17,0,10
D14,Break & Enter-Apartment,2019,3,8,0,5
D14,Break & Enter-Apartment,2019,2,6,0,4
D14,Break & Enter-Apartment,2019,12,39,0,27
D14,Break & Enter-Apartment,2019,3,12,0,9
D14,Break & Enter-Apartment,2019,1,18,0,17
D14,Break & Enter-Apartment,2019,8,30,0,22
D14,Break & Enter-Apartment,2019,6,20,0,14
D14,Break & Enter-Commercial,2019,3,32,0,29
D14,Break & Enter-Commercial,2019,12,53,0,41
D14,Break & Enter-Commercial,2019,0,7,0,7
D14,Break & Enter-Commercial,2019,8,20,0,12
D14,Break & Enter-Commercial,2019,2,5,0,3
D14,Break & Enter-Commercial,2019,28,83,0,55
D14,Break & Enter-Commercial,2019,4,19,0,15
D14,Break & Enter-Commercial,2019,1,1,1,0
D14,Break & Enter-Commercial,2019,11,30,0,19
D14,Break & Enter-Commercial,2019,8,37,0,29
D14,Break & Enter-Commercial,2019,13,66,0,53
D14,Break & Enter-Commercial,2019,10,39,0,29
D14,Break & Enter-Commercial,2019,12,41,0,29
D14,Break & Enter-Commercial,2019,8,31,0,23
D14,Break & Enter-House,2019,2,9,0,7
D14,Break & Enter-House,2019,1,11,0,10
D14,Break & Enter-House,2019,0,4,0,4
D14,Break & Enter-House,2019,0,4,0,4
D14,Break & Enter-House,2019,1,1,1,0
D14,Break & Enter-House,2019,2,8,0,6
D14,Break & Enter-House,2019,0,12,0,12
D14,Break & Enter-House,2019,1,9,0,8
D14,Break & Enter-House,2019,0,6,0,6
D14,Break & Enter-House,2019,6,25,0,19
D14,Break & Enter-House,2019,1,5,0,4
D14,Break & Enter-House,2019,0,1,0,1
D14,Break & Enter-House,2019,2,11,0,9
D14,Break & Enter-Other,2019,0,3,0,3
D14,Break & Enter-Other,2019,1,9,0,8
D22,Robbery-Financial,2019,2,2,1,0
D23,Break & Enter-Apartment,2019,1,10,0,9
D22,Robbery-Other,2019,1,5,0,4
D22,Robbery-Other,2019,1,3,0,2
D23,Robbery-Other,2019,22,53,0,31
D23,Break & Enter-Apartment,2019,0,9,0,9
D22,Robbery-Other,2019,5,9,0,4
D23,Break & Enter-Commercial,2019,0,3,0,3
D23,Robbery-Other,2019,14,32,0,18
D22,Robbery-Other,2019,5,18,0,13
D22,Theft Under $5000,2019,14,94,0,80
D23,Break & Enter-Commercial,2019,0,3,0,3
D23,Sexual Violation,2019,0,1,0,1
D22,Robbery-Other,2019,2,4,0,2
D22,Theft Under $5000,2019,340,1036,0,696
D23,Sexual Violation,2019,5,6,0,1
D23,Theft Over $5000,2019,12,65,0,53
D31,Other,2019,2,2,1,0
D23,Break & Enter-Commercial,2019,0,4,0,4
D23,Theft Over $5000,2019,2,3,0,1
D23,Sexual Violation,2019,2,2,1,0
D31,Other,2019,11,12,0,1
D22,Robbery-Other,2019,4,7,0,3
D22,Theft Under $5000,2019,7,39,0,32
D31,Other,2019,16,18,0,2
D23,Theft Under $5000,2019,0,4,0,4
D22,Robbery-Other,2019,7,13,0,6
D23,Break & Enter-Commercial,2019,1,4,0,3
D23,Sexual Violation,2019,8,15,0,7
D22,Theft Under $5000,2019,44,206,0,162
D31,Auto Theft,2019,2,74,0,72
D23,Theft Under $5000,2019,99,161,0,62
D22,Robbery-Other,2019,3,11,0,8
D23,Break & Enter-Commercial,2019,0,9,0,9
D23,Sexual Violation,2019,14,24,0,10
D22,Theft Under $5000,2019,84,286,0,202
D31,Auto Theft,2019,2,54,0,52
D23,Theft Under $5000,2019,0,23,0,23
D22,Robbery-Other,2019,19,27,0,8
D23,Break & Enter-Commercial,2019,10,93,0,83
D23,Sexual Violation,2019,3,6,0,3
D22,Theft Under $5000,2019,33,154,0,121
D31,Auto Theft,2019,10,89,0,79
D23,Theft Under $5000,2019,10,115,0,105
D22,Robbery-Other,2019,4,11,0,7
D23,Break & Enter-Commercial,2019,1,15,0,14
D23,Sexual Violation,2019,8,11,0,3
D22,Theft Under $5000,2019,52,194,0,142
D31,Auto Theft,2019,4,135,0,131
D23,Theft Under $5000,2019,120,464,0,344
D22,Robbery-Other,2019,2,6,0,4
D23,Break & Enter-House,2019,0,2,0,2
D23,Sexual Violation,2019,32,48,0,16
D22,Theft Under $5000,2019,31,148,0,117
D31,Auto Theft,2019,4,73,0,69
D23,Theft Under $5000,2019,1,11,0,10
D22,Robbery-Other,2019,5,14,0,9
D23,Break & Enter-House,2019,0,11,0,11
D23,Sexual Violation,2019,13,16,0,3
D23,Other,2019,1,1,1,0
D23,Other,2019,4,5,0,1
D23,Other,2019,1,1,1,0
D23,Other,2019,4,5,0,1
D23,Other,2019,2,2,1,0
D23,Other,2019,3,3,1,0
D23,Other,2019,9,9,1,0
D23,Other,2019,1,1,1,0
D23,Other,2019,3,3,1,0
D23,Other,2019,12,12,1,0
D23,Other,2019,36,37,0,1
D23,Other,2019,5,5,1,0
D23,Other,2019,4,4,1,0
D23,Other,2019,20,21,0,1
D23,Other,2019,10,11,0,1
D23,Other,2019,27,31,0,4
D23,Other,2019,110,114,0,4
D23,Other,2019,23,24,0,1
D23,Other,2019,9,12,0,3
D23,Other,2019,19,20,0,1
D23,Other,2019,98,109,0,11
D23,Other,2019,23,25,0,2
D23,Other Criminal Violations - Offensive Weapons,2019,6,8,0,2
D23,Other Criminal Violations - Offensive Weapons,2019,1,1,1,0
D23,Other Criminal Violations - Offensive Weapons,2019,17,17,1,0
D23,Other Criminal Violations - Offensive Weapons,2019,5,6,0,1
D23,Other Criminal Violations - Offensive Weapons,2019,3,3,1,0
D23,Other Criminal Violations - Offensive Weapons,2019,20,23,0,3
D23,Other Criminal Violations - Offensive Weapons,2019,1,2,0,1
D23,Other,2019,1,1,1,0
D23,Other,2019,1,1,1,0
D23,Other,2019,3,4,0,1
D23,Other,2019,1,1,1,0
D23,Other,2019,0,1,0,1
D31,Other,2019,8,9,0,1
D31,Other,2019,8,9,0,1
D31,Other,2019,20,20,1,0
D31,Other,2019,3,3,1,0
D31,Other,2019,4,5,0,1
D22,Other,2019,42,47,0,5
D22,Break & Enter-Other,2019,0,2,0,2
D23,Theft Under $5000,2019,8,106,0,98
D23,Break & Enter-House,2019,0,9,0,9
D22,Robbery-Other,2019,5,9,0,4
D22,Other,2019,13,15,0,2
D22,Theft Under $5000,2019,17,150,0,133
D23,Theft Under $5000,2019,5,70,0,65
D31,Auto Theft,2019,0,2,0,2
D22,Break & Enter-Other,2019,0,1,0,1
D31,Auto Theft,2019,5,95,0,90
D23,Break & Enter-House,2019,2,10,0,8
D22,Robbery-Other,2019,8,21,0,13
D22,Other,2019,41,44,0,3
D22,Theft Under $5000,2019,0,3,0,3
D23,Theft Under $5000,2019,166,964,0,798
D22,Break & Enter-Other,2019,2,5,0,3
D31,Auto Theft,2019,0,48,0,48
D23,Break & Enter-House,2019,1,5,0,4
D22,Sexual Violation,2019,9,9,1,0
D22,Other,2019,11,11,1,0
D22,Theft Under $5000,2019,47,216,0,169
D23,Theft Under $5000,2019,27,233,0,206
D22,Fraud,2019,5,34,0,29
D31,Auto Theft,2019,12,98,0,86
D23,Break & Enter-House,2019,0,3,0,3
D22,Sexual Violation,2019,1,3,0,2
D22,Other,2019,678,694,0,16
D22,Theft Under $5000,2019,12,90,0,78
D23,Assault,2019,6,8,0,2
D22,Fraud,2019,2,27,0,25
D31,Break & Enter-Apartment,2019,5,26,0,21
D23,Break & Enter-House,2019,6,25,0,19
D22,Sexual Violation,2019,1,3,0,2
D22,Other,2019,17,17,1,0
D22,Theft Under $5000,2019,89,341,0,252
D23,Assault,2019,37,63,0,26
D22,Fraud,2019,7,42,0,35
D31,Break & Enter-Apartment,2019,1,4,0,3
D23,Break & Enter-House,2019,0,17,0,17
D22,Sexual Violation,2019,7,18,0,11
D22,Other,2019,65,67,0,2
D22,Theft Under $5000,2019,0,1,0,1
D23,Assault,2019,1,1,1,0
D22,Fraud,2019,42,205,0,163
D31,Break & Enter-Apartment,2019,6,13,0,7
D23,Break & Enter-Other,2019,2,4,0,2
D22,Sexual Violation,2019,1,4,0,3
D22,Other,2019,8,12,0,4
D22,Assault,2019,18,31,0,13
D23,Assault,2019,18,29,0,11
D31,Break & Enter-Apartment,2019,0,2,0,2
D23,Break & Enter-Other,2019,0,1,0,1
D22,Sexual Violation,2019,6,16,0,10
D31,Break & Enter-Apartment,2019,0,3,0,3
D22,Fraud,2019,3,32,0,29
D22,Other,2019,45,50,0,5
D22,Assault,2019,13,22,0,9
D23,Assault,2019,0,3,0,3
D22,Fraud,2019,8,68,0,60
D22,Other Criminal Violations - Offensive Weapons,2019,1,2,0,1
D22,Assault,2019,25,38,0,13
D22,Sexual Violation,2019,4,6,0,2
D23,Break & Enter-Other,2019,1,9,0,8
D31,Break & Enter-Apartment,2019,1,1,1,0
D23,Assault,2019,63,88,0,25
D22,Fraud,2019,15,86,0,71
D22,Other Criminal Violations - Offensive Weapons,2019,1,1,1,0
D22,Assault,2019,61,124,0,63
D22,Sexual Violation,2019,2,4,0,2
D23,Break & Enter-Other,2019,0,2,0,2
D31,Break & Enter-Apartment,2019,8,25,0,17
D23,Assault,2019,152,241,0,89
D22,Fraud,2019,1,33,0,32
D22,Other Criminal Violations - Offensive Weapons,2019,0,1,0,1
D22,Assault,2019,31,50,0,19
D22,Sexual Violation,2019,2,5,0,3
D23,Fraud,2019,0,2,0,2
D31,Break & Enter-Apartment,2019,1,13,0,12
D23,Assault,2019,3,5,0,2
D22,Fraud,2019,8,34,0,26
D22,Other Criminal Violations - Offensive Weapons,2019,7,7,1,0
D22,Assault,2019,67,81,0,14
D22,Sexual Violation,2019,8,10,0,2
D23,Fraud,2019,6,37,0,31
D31,Break & Enter-Apartment,2019,7,25,0,18
D23,Assault,2019,31,47,0,16
D22,Fraud,2019,5,41,0,36
D22,Other Criminal Violations - Offensive Weapons,2019,2,2,1,0
D22,Assault,2019,49,68,0,19
D22,Sexual Violation,2019,13,20,0,7
D23,Fraud,2019,3,22,0,19
D31,Break & Enter-Commercial,2019,2,4,0,2
D23,Assault,2019,48,67,0,19
D22,Other Criminal Violations - Offensive Weapons,2019,7,7,1,0
D22,Fraud,2019,4,62,0,58
D22,Sexual Violation,2019,7,15,0,8
D23,Fraud,2019,9,65,0,56
D23,Assault,2019,141,232,0,91
D31,Break & Enter-Commercial,2019,4,13,0,9
D22,Assault,2019,13,25,0,12
D22,Sexual Violation,2019,4,5,0,1
D23,Assault,2019,45,86,0,41
D23,Fraud,2019,20,137,0,117
D22,Other Criminal Violations - Offensive Weapons,2019,6,6,1,0
D31,Break & Enter-Commercial,2019,2,7,0,5
D22,Fraud,2019,1,3,0,2
D22,Assault,2019,34,50,0,16
D22,Sexual Violation,2019,10,14,0,4
D23,Attempt Murder,2019,0,1,0,1
D23,Fraud,2019,0,1,0,1
D22,Other Criminal Violations - Offensive Weapons,2019,6,6,1,0
D31,Break & Enter-Commercial,2019,4,44,0,40
D22,Fraud,2019,9,39,0,30
D22,Assault,2019,8,12,0,4
D22,Other,2019,8,8,1,0
D23,Attempt Murder,2019,1,1,1,0
D23,Fraud,2019,4,34,0,30
D22,Other Criminal Violations - Offensive Weapons,2019,5,6,0,1
D31,Break & Enter-Commercial,2019,15,49,0,34
D22,Fraud,2019,7,27,0,20
D22,Assault,2019,137,211,0,74
D22,Other,2019,4,5,0,1
D23,Attempt Murder,2019,1,1,1,0
D23,Fraud,2019,6,43,0,37
D22,Other Criminal Violations - Offensive Weapons,2019,30,31,0,1
D31,Break & Enter-Commercial,2019,1,1,1,0
D22,Fraud,2019,5,80,0,75
D22,Assault,2019,0,1,0,1
D22,Other,2019,2,2,1,0
D23,Attempt Murder,2019,1,1,1,0
D23,Fraud,2019,43,241,0,198
D22,Other Criminal Violations - Offensive Weapons,2019,16,17,0,1
D31,Break & Enter-Commercial,2019,5,33,0,28
D22,Other,2019,18,40,0,22
D22,Assault,2019,64,95,0,31
D22,Other,2019,27,28,0,1
D23,Attempt Murder,2019,2,2,1,0
D22,Other Criminal Violations - Offensive Weapons,2019,1,1,1,0
D31,Break & Enter-Commercial,2019,7,22,0,15
D22,Other,2019,6,6,1,0
D23,Fraud,2019,10,63,0,53
D22,Other Criminal Violations - Offensive Weapons,2019,9,9,1,0
D22,Other,2019,6,37,0,31
D23,Other,2019,0,1,0,1
D22,Assault,2019,12,25,0,13
D22,Other,2019,2,3,0,1
D23,Other,2019,0,3,0,3
D22,Other,2019,16,44,0,28
D23,Other,2019,12,13,0,1
D31,Break & Enter-House,2019,2,7,0,5
D22,Other,2019,15,16,0,1
D22,Assault,2019,57,79,0,22
D22,Other,2019,0,1,0,1
D23,Other,2019,10,32,0,22
D22,Other,2019,42,154,0,112
D23,Other,2019,8,15,0,7
D31,Break & Enter-House,2019,0,5,0,5
D22,Other,2019,11,11,1,0
D22,Assault,2019,1,1,1,0
D22,Other,2019,2,2,1,0
D23,Other,2019,3,26,0,23
D22,Other,2019,5,26,0,21
D23,Other,2019,16,26,0,10
D31,Break & Enter-House,2019,2,11,0,9
D22,Other,2019,7,8,0,1
D22,Attempt Murder,2019,3,3,1,0
D22,Other,2019,1,3,0,2
D23,Other,2019,0,2,0,2
D22,Other,2019,16,48,0,32
D23,Other,2019,31,48,0,17
D31,Break & Enter-House,2019,1,10,0,9
D22,Other,2019,6,6,1,0
D22,Attempt Murder,2019,2,2,1,0
D22,Other,2019,2,2,1,0
D23,Other,2019,20,64,0,44
D22,Other,2019,17,61,0,44
D23,Other,2019,13,21,0,8
D31,Break & Enter-House,2019,1,5,0,4
D22,Other,2019,5,5,1,0
D22,Other,2019,4,8,0,4
D22,Other,2019,1,1,1,0
D23,Other,2019,26,93,0,67
D23,Other,2019,4,8,0,4
D31,Break & Enter-House,2019,4,19,0,15
D22,Other,2019,16,16,1,0
D23,Other,2019,28,52,0,24
D22,Other,2019,11,29,0,18
D23,Other,2019,4,5,0,1
D22,Other,2019,4,6,0,2
D23,Other,2019,1,3,0,2
D23,Other,2019,12,23,0,11
D23,Other,2019,2,3,0,1
D22,Other,2019,13,55,0,42
D31,Break & Enter-House,2019,0,2,0,2
D22,Other,2019,8,10,0,2
D22,Other,2019,1,2,0,1
D23,Other,2019,0,1,0,1
D23,Robbery-Financial,2019,0,1,0,1
D23,Other,2019,9,14,0,5
D22,Other,2019,6,32,0,26
D31,Break & Enter-House,2019,2,10,0,8
D22,Other,2019,14,29,0,15
D22,Other,2019,9,9,1,0
D23,Other,2019,9,47,0,38
D23,Robbery-Financial,2019,0,5,0,5
D23,Other,2019,3,3,1,0
D22,Other,2019,30,92,0,62
D31,Break & Enter-Other,2019,0,1,0,1
D22,Other,2019,4,11,0,7
D22,Other,2019,2,2,1,0
D23,Other,2019,9,36,0,27
D23,Robbery-Financial,2019,2,5,0,3
D23,Other,2019,50,54,0,4
D22,Other,2019,1,3,0,2
D31,Break & Enter-Other,2019,0,1,0,1
D22,Other,2019,8,20,0,12
D22,Other,2019,15,16,0,1
D23,Other,2019,62,268,0,206
D23,Robbery-Financial,2019,2,2,1,0
D23,Other,2019,1,1,1,0
D22,Other,2019,17,66,0,49
D31,Break & Enter-Other,2019,0,7,0,7
D22,Other,2019,13,20,0,7
D22,Other,2019,21,22,0,1
D23,Other,2019,10,45,0,35
D23,Robbery-Other,2019,5,16,0,11
D23,Auto Theft,2019,1,1,1,0
D22,Other,2019,4,21,0,17
D22,Other,2019,6,10,0,4
D31,Break & Enter-Other,2019,0,3,0,3
D22,Other,2019,7,12,0,5
D22,Other,2019,12,17,0,5
D23,Theft Over $5000,2019,0,1,0,1
D23,Auto Theft,2019,4,28,0,24
D23,Robbery-Other,2019,2,5,0,3
D22,Other,2019,15,79,0,64
D23,Auto Theft,2019,1,19,0,18
D31,Break & Enter-Other,2019,0,6,0,6
D22,Other,2019,6,9,0,3
D22,Other,2019,18,19,0,1
D23,Robbery-Other,2019,5,11,0,6
D23,Theft Over $5000,2019,0,4,0,4
D22,Theft Over $5000,2019,1,7,0,6
D23,Auto Theft,2019,0,40,0,40
D31,Break & Enter-Other,2019,0,4,0,4
D22,Other,2019,41,52,0,11
D22,Other,2019,125,147,0,22
D23,Robbery-Other,2019,26,55,0,29
D23,Theft Over $5000,2019,0,5,0,5
D22,Theft Over $5000,2019,1,9,0,8
D23,Auto Theft,2019,5,88,0,83
D31,Break & Enter-Other,2019,0,1,0,1
D22,Other,2019,10,16,0,6
D22,Other,2019,17,18,0,1
D23,Robbery-Other,2019,1,1,1,0
D23,Theft Over $5000,2019,0,2,0,2
D22,Theft Over $5000,2019,0,4,0,4
D23,Auto Theft,2019,0,1,0,1
D31,Break & Enter-Other,2019,2,14,0,12
D22,Other,2019,3,5,0,2
D22,Other,2019,33,36,0,3
D23,Robbery-Other,2019,1,1,1,0
D23,Theft Over $5000,2019,3,8,0,5
D22,Theft Over $5000,2019,6,27,0,21
D23,Auto Theft,2019,1,52,0,51
D31,Fraud,2019,3,80,0,77
D22,Other,2019,12,22,0,10
D23,Robbery-Other,2019,3,16,0,13
D23,Theft Over $5000,2019,0,3,0,3
D22,Theft Over $5000,2019,2,6,0,4
D23,Auto Theft,2019,4,52,0,48
D22,Robbery-Financial,2019,4,4,1,0
D23,Robbery-Other,2019,2,8,0,6
D31,Fraud,2019,6,52,0,46
D23,Theft Over $5000,2019,0,4,0,4
D22,Theft Over $5000,2019,0,5,0,5
D23,Auto Theft,2019,36,488,0,452
D31,Fraud,2019,11,147,0,136
D22,Theft Over $5000,2019,1,9,0,8
D22,Robbery-Financial,2019,1,1,1,0
D23,Auto Theft,2019,1,45,0,44
D31,Fraud,2019,7,65,0,58
D22,Theft Over $5000,2019,1,4,0,3
D22,Robbery-Financial,2019,2,2,1,0
D23,Break & Enter-Apartment,2019,1,5,0,4
D31,Fraud,2019,5,55,0,50
D22,Theft Over $5000,2019,0,1,0,1
D22,Robbery-Financial,2019,0,1,0,1
D23,Break & Enter-Apartment,2019,1,9,0,8
D22,Theft Over $5000,2019,0,3,0,3
D23,Break & Enter-Apartment,2019,2,18,0,16
D22,Theft Over $5000,2019,2,14,0,12
D23,Break & Enter-Apartment,2019,4,20,0,16
D22,Theft Over $5000,2019,0,2,0,2
D23,Break & Enter-Apartment,2019,1,6,0,5
D22,Theft Over $5000,2019,0,2,0,2
D23,Break & Enter-Apartment,2019,1,1,1,0
D22,Theft Over $5000,2019,1,4,0,3
D22,Theft Over $5000,2019,1,4,0,3
D22,Theft Under $5000,2019,31,132,0,101
D22,Theft Under $5000,2019,12,113,0,101
D32,Other,2019,240,294,0,54
D32,Theft Over $5000,2019,0,4,0,4
D32,Theft Over $5000,2019,1,5,0,4
D32,Theft Over $5000,2019,0,15,0,15
D32,Theft Over $5000,2019,0,2,0,2
D32,Theft Over $5000,2019,3,4,0,1
D32,Theft Over $5000,2019,0,1,0,1
D32,Theft Over $5000,2019,2,9,0,7
D32,Theft Over $5000,2019,1,4,0,3
D31,Other,2019,11,20,0,9
D32,Break & Enter-Other,2019,1,7,0,6
D32,Break & Enter-Apartment,2019,0,3,0,3
D32,Assault,2019,35,61,0,26
D32,Robbery-Other,2019,0,2,0,2
D31,Fraud,2019,6,15,0,9
D32,Theft Over $5000,2019,1,10,0,9
D32,Theft Over $5000,2019,0,4,0,4
D32,Theft Over $5000,2019,1,9,0,8
D32,Theft Over $5000,2019,1,11,0,10
D32,Theft Over $5000,2019,0,3,0,3
D32,Theft Over $5000,2019,0,1,0,1
D32,Theft Over $5000,2019,1,9,0,8
D32,Theft Over $5000,2019,0,15,0,15
D32,Theft Over $5000,2019,4,13,0,9
D32,Theft Over $5000,2019,10,28,0,18
D32,Theft Under $5000,2019,32,125,0,93
D32,Theft Under $5000,2019,9,79,0,70
D32,Theft Under $5000,2019,0,1,0,1
D32,Theft Under $5000,2019,0,1,0,1
D32,Theft Under $5000,2019,17,184,0,167
D32,Theft Under $5000,2019,7,77,0,70
D32,Theft Under $5000,2019,93,378,0,285
D32,Theft Under $5000,2019,3,57,0,54
D32,Theft Under $5000,2019,4,73,0,69
D32,Theft Under $5000,2019,66,190,0,124
D32,Theft Under $5000,2019,23,278,0,255
D32,Theft Under $5000,2019,14,135,0,121
D32,Theft Under $5000,2019,1,5,0,4
D32,Theft Under $5000,2019,8,101,0,93
D32,Theft Under $5000,2019,47,213,0,166
D32,Theft Under $5000,2019,3,61,0,58
D32,Theft Under $5000,2019,6,118,0,112
D32,Theft Under $5000,2019,17,148,0,131
D32,Theft Under $5000,2019,118,721,0,603
D32,Theft Under $5000,2019,151,481,0,330
D32,Theft Under $5000,2019,439,861,0,422
D32,Assault,2019,29,39,0,10
D32,Assault,2019,36,51,0,15
D32,Assault,2019,0,1,0,1
D32,Assault,2019,2,3,0,1
D32,Assault,2019,37,54,0,17
D32,Assault,2019,7,12,0,5
D32,Assault,2019,44,80,0,36
D32,Assault,2019,23,40,0,17
D32,Assault,2019,32,47,0,15
D32,Assault,2019,49,88,0,39
D31,Other Criminal Violations - Offensive Weapons,2019,2,3,0,1
D31,Other,2019,2,5,0,3
D31,Fraud,2019,13,101,0,88
D32,Break & Enter-Other,2019,1,4,0,3
D32,Assault,2019,18,32,0,14
D32,Robbery-Other,2019,0,1,0,1
D31,Other,2019,36,52,0,16
D32,Break & Enter-Apartment,2019,2,5,0,3
D31,Fraud,2019,3,23,0,20
D32,Break & Enter-Other,2019,0,2,0,2
D32,Robbery-Other,2019,2,9,0,7
D32,Break & Enter-Apartment,2019,1,9,0,8
D32,Break & Enter-Apartment,2019,1,2,0,1
D32,Break & Enter-Apartment,2019,0,10,0,10
D32,Break & Enter-Apartment,2019,2,16,0,14
D32,Break & Enter-Apartment,2019,0,14,0,14
D32,Break & Enter-Apartment,2019,3,32,0,29
D32,Break & Enter-Apartment,2019,1,5,0,4
D32,Break & Enter-Apartment,2019,0,10,0,10
D32,Break & Enter-Apartment,2019,0,2,0,2
D32,Break & Enter-Apartment,2019,3,7,0,4
D32,Break & Enter-Commercial,2019,0,4,0,4
D32,Break & Enter-Commercial,2019,1,3,0,2
D32,Break & Enter-Commercial,2019,3,21,0,18
D32,Break & Enter-Commercial,2019,0,1,0,1
D32,Break & Enter-Commercial,2019,5,13,0,8
D32,Break & Enter-Commercial,2019,1,5,0,4
D32,Break & Enter-Commercial,2019,0,2,0,2
D32,Break & Enter-Commercial,2019,1,3,0,2
D32,Break & Enter-Commercial,2019,2,12,0,10
D32,Break & Enter-Commercial,2019,0,11,0,11
D32,Break & Enter-Commercial,2019,1,5,0,4
D32,Break & Enter-Commercial,2019,0,3,0,3
D32,Break & Enter-Commercial,2019,0,10,0,10
D32,Break & Enter-Commercial,2019,0,1,0,1
D32,Break & Enter-Commercial,2019,1,2,0,1
D32,Break & Enter-Commercial,2019,0,4,0,4
D32,Break & Enter-Commercial,2019,3,10,0,7
D32,Break & Enter-Commercial,2019,3,35,0,32
D32,Break & Enter-Commercial,2019,5,33,0,28
D32,Break & Enter-House,2019,0,4,0,4
D32,Break & Enter-House,2019,1,7,0,6
D32,Break & Enter-House,2019,1,35,0,34
D32,Break & Enter-House,2019,1,17,0,16
D32,Break & Enter-House,2019,2,22,0,20
D32,Break & Enter-House,2019,1,8,0,7
D32,Break & Enter-House,2019,1,45,0,44
D32,Break & Enter-House,2019,0,2,0,2
D32,Break & Enter-House,2019,2,18,0,16
D32,Break & Enter-House,2019,2,8,0,6
D32,Break & Enter-House,2019,2,37,0,35
D32,Break & Enter-House,2019,0,22,0,22
D32,Assault,2019,3,9,0,6
D31,Other,2019,7,12,0,5
D32,Break & Enter-House,2019,0,42,0,42
D32,Break & Enter-House,2019,1,3,0,2
D32,Break & Enter-House,2019,2,10,0,8
D32,Break & Enter-House,2019,0,6,0,6
D32,Break & Enter-Other,2019,0,1,0,1
D32,Break & Enter-Other,2019,3,6,0,3
D32,Break & Enter-Other,2019,2,8,0,6
D31,Fraud,2019,24,177,0,153
D32,Assault,2019,45,74,0,29
D31,Other,2019,38,77,0,39
D32,Robbery-Other,2019,5,16,0,11
D31,Robbery-Financial,2019,1,1,1,0
D31,Robbery-Financial,2019,1,1,1,0
D32,Break & Enter-Other,2019,0,2,0,2
D31,Robbery-Other,2019,17,37,0,20
D31,Other,2019,35,98,0,63
D32,Assault,2019,88,139,0,51
D32,Robbery-Other,2019,1,1,1,0
D31,Robbery-Other,2019,3,12,0,9
D32,Break & Enter-Other,2019,0,3,0,3
D31,Other,2019,22,49,0,27
D32,Assault,2019,20,29,0,9
D32,Robbery-Other,2019,3,8,0,5
D31,Robbery-Other,2019,13,44,0,31
D32,Break & Enter-Other,2019,1,6,0,5
D31,Other,2019,50,132,0,82
D32,Assault,2019,70,96,0,26
D32,Robbery-Other,2019,6,21,0,15
D31,Robbery-Other,2019,8,23,0,15
D32,Break & Enter-Other,2019,0,1,0,1
D31,Other,2019,20,70,0,50
D32,Assault,2019,60,92,0,32
D32,Robbery-Other,2019,6,17,0,11
D31,Robbery-Other,2019,8,23,0,15
D32,Break & Enter-Other,2019,0,1,0,1
D31,Other,2019,26,66,0,40
D32,Assault,2019,47,72,0,25
D32,Robbery-Other,2019,8,10,0,2
D31,Robbery-Other,2019,2,3,0,1
D32,Break & Enter-Other,2019,2,2,1,0
D31,Other,2019,0,5,0,5
D32,Assault,2019,36,62,0,26
D32,Robbery-Other,2019,8,23,0,15
D31,Robbery-Other,2019,19,37,0,18
D32,Break & Enter-Other,2019,0,3,0,3
D31,Other,2019,58,127,0,69
D32,Assault,2019,83,122,0,39
D32,Sexual Violation,2019,4,6,0,2
D32,Attempt Murder,2019,1,1,1,0
D31,Robbery-Other,2019,0,4,0,4
D32,Attempt Murder,2019,1,3,0,2
D32,Break & Enter-Other,2019,0,3,0,3
D31,Other,2019,7,19,0,12
D31,Robbery-Other,2019,21,56,0,35
D32,Attempt Murder,2019,0,1,0,1
D32,Sexual Violation,2019,2,6,0,4
D31,Other,2019,59,162,0,103
D31,Sexual Violation,2019,14,30,0,16
D32,Attempt Murder,2019,1,1,1,0
D32,Fraud,2019,4,60,0,56
D32,Sexual Violation,2019,5,12,0,7
D31,Theft Over $5000,2019,3,9,0,6
D31,Sexual Violation,2019,6,11,0,5
D32,Attempt Murder,2019,1,1,1,0
D32,Fraud,2019,3,40,0,37
D32,Sexual Violation,2019,1,3,0,2
D31,Theft Over $5000,2019,0,6,0,6
D31,Sexual Violation,2019,29,52,0,23
D32,Attempt Murder,2019,1,1,1,0
D32,Fraud,2019,3,58,0,55
D32,Sexual Violation,2019,2,8,0,6
D31,Theft Over $5000,2019,2,12,0,10
D31,Sexual Violation,2019,5,7,0,2
D32,Attempt Murder,2019,2,2,1,0
D32,Fraud,2019,1,24,0,23
D32,Sexual Violation,2019,2,2,1,0
D31,Theft Over $5000,2019,3,22,0,19
D32,Other,2019,6,11,0,5
D32,Fraud,2019,3,51,0,48
D32,Sexual Violation,2019,1,1,1,0
D31,Sexual Violation,2019,10,14,0,4
D31,Theft Over $5000,2019,1,8,0,7
D32,Other,2019,7,14,0,7
D32,Fraud,2019,3,24,0,21
D32,Sexual Violation,2019,2,6,0,4
D31,Sexual Violation,2019,2,3,0,1
D31,Theft Over $5000,2019,1,7,0,6
D32,Other,2019,0,1,0,1
D32,Fraud,2019,2,53,0,51
D32,Sexual Violation,2019,6,12,0,6
D31,Sexual Violation,2019,16,31,0,15
D31,Theft Over $5000,2019,1,4,0,3
D32,Fraud,2019,3,49,0,46
D32,Other,2019,5,8,0,3
D32,Fraud,2019,9,73,0,64
D32,Sexual Violation,2019,3,5,0,2
D31,Sexual Violation,2019,7,8,0,1
D31,Theft Over $5000,2019,7,18,0,11
D32,Fraud,2019,7,48,0,41
D32,Sexual Violation,2019,2,6,0,4
D31,Sexual Violation,2019,23,44,0,21
D32,Other,2019,2,3,0,1
D31,Theft Under $5000,2019,76,261,0,185
D32,Fraud,2019,0,1,0,1
D32,Sexual Violation,2019,0,1,0,1
D31,Other,2019,6,6,1,0
D32,Other,2019,9,14,0,5
D31,Theft Under $5000,2019,37,204,0,167
D32,Fraud,2019,1,4,0,3
D32,Sexual Violation,2019,4,11,0,7
D31,Other,2019,10,10,1,0
D32,Other,2019,3,5,0,2
D31,Theft Under $5000,2019,163,391,0,228
D32,Fraud,2019,15,65,0,50
D32,Sexual Violation,2019,9,20,0,11
D31,Other,2019,19,22,0,3
D32,Other,2019,6,12,0,6
D31,Theft Under $5000,2019,39,200,0,161
D32,Fraud,2019,11,121,0,110
D32,Sexual Violation,2019,4,9,0,5
D31,Other,2019,13,16,0,3
D32,Other,2019,10,22,0,12
D31,Theft Under $5000,2019,7,81,0,74
D32,Fraud,2019,1,23,0,22
D32,Sexual Violation,2019,6,9,0,3
D31,Other,2019,11,13,0,2
D32,Other,2019,11,26,0,15
D31,Theft Under $5000,2019,9,21,0,12
D32,Fraud,2019,1,66,0,65
D32,Sexual Violation,2019,8,14,0,6
D31,Other,2019,3,4,0,1
D32,Other,2019,1,3,0,2
D31,Theft Under $5000,2019,263,578,0,315
D32,Fraud,2019,8,89,0,81
D32,Sexual Violation,2019,4,6,0,2
D31,Other,2019,15,18,0,3
D32,Other,2019,2,2,1,0
D31,Theft Under $5000,2019,4,40,0,36
D32,Fraud,2019,8,100,0,92
D32,Fraud,2019,12,88,0,76
D32,Fraud,2019,41,144,0,103
D32,Other,2019,11,38,0,27
D32,Other,2019,18,49,0,31
D32,Other,2019,1,1,1,0
D32,Other,2019,14,54,0,40
D32,Other,2019,0,9,0,9
D32,Other,2019,27,87,0,60
D32,Other,2019,4,15,0,11
D32,Other,2019,5,49,0,44
D32,Other,2019,19,54,0,35
D32,Other,2019,10,64,0,54
D32,Other,2019,11,40,0,29
D32,Other,2019,2,4,0,2
D32,Other,2019,20,52,0,32
D32,Other,2019,15,85,0,70
D32,Other,2019,2,15,0,13
D32,Other,2019,17,59,0,42
D32,Other,2019,17,48,0,31
D32,Other,2019,19,52,0,33
D32,Other,2019,11,45,0,34
D32,Sexual Violation,2019,4,7,0,3
D31,Theft Under $5000,2019,166,583,0,417
D31,Other,2019,4,4,1,0
D32,Other,2019,14,20,0,6
D32,Sexual Violation,2019,8,14,0,6
D31,Assault,2019,130,178,0,48
D31,Other,2019,19,19,1,0
D32,Other,2019,32,41,0,9
D32,Other,2019,2,2,1,0
D31,Assault,2019,61,88,0,27
D31,Other,2019,88,102,0,14
D32,Other,2019,4,4,1,0
D32,Other,2019,8,8,1,0
D31,Assault,2019,197,301,0,104
D31,Other,2019,28,41,0,13
D32,Other,2019,14,23,0,9
D32,Other,2019,1,1,1,0
D31,Assault,2019,66,94,0,28
D31,Other,2019,86,103,0,17
D32,Other,2019,15,19,0,4
D32,Other,2019,6,6,1,0
D31,Assault,2019,104,148,0,44
D31,Other,2019,36,43,0,7
D32,Other,2019,10,12,0,2
D32,Other,2019,1,1,1,0
D31,Assault,2019,4,10,0,6
D31,Assault,2019,180,255,0,75
D31,Other,2019,237,255,0,18
D31,Assault,2019,33,45,0,12
D32,Other,2019,12,14,0,2
D32,Other,2019,13,19,0,6
D31,Assault,2019,175,276,0,101
D32,Other,2019,1,1,1,0
D31,Other,2019,7,8,0,1
D32,Other,2019,15,21,0,6
D31,Attempt Murder,2019,1,1,1,0
D32,Other,2019,1,1,1,0
D31,Other,2019,94,111,0,17
D32,Robbery-Financial,2019,1,1,1,0
D31,Attempt Murder,2019,5,6,0,1
D32,Other,2019,6,6,1,0
D31,Other,2019,22,26,0,4
D32,Robbery-Financial,2019,0,1,0,1
D31,Attempt Murder,2019,0,1,0,1
D32,Other,2019,8,8,1,0
D31,Other,2019,84,108,0,24
D32,Robbery-Other,2019,0,5,0,5
D31,Attempt Murder,2019,0,4,0,4
D32,Other,2019,3,3,1,0
D31,Other Criminal Violations - Offensive Weapons,2019,24,29,0,5
D32,Robbery-Other,2019,6,13,0,7
D31,Attempt Murder,2019,1,1,1,0
D32,Other,2019,9,10,0,1
D31,Other Criminal Violations - Offensive Weapons,2019,4,7,0,3
D32,Robbery-Other,2019,0,1,0,1
D31,Attempt Murder,2019,0,1,0,1
D32,Other,2019,8,8,1,0
D31,Other Criminal Violations - Offensive Weapons,2019,32,39,0,7
D32,Robbery-Other,2019,2,13,0,11
D31,Attempt Murder,2019,3,3,1,0
D32,Other,2019,5,5,1,0
D31,Other Criminal Violations - Offensive Weapons,2019,4,8,0,4
D32,Robbery-Other,2019,7,15,0,8
D31,Other,2019,26,56,0,30
D32,Other,2019,7,7,1,0
D31,Other Criminal Violations - Offensive Weapons,2019,11,17,0,6
D32,Robbery-Other,2019,0,3,0,3
D31,Other,2019,12,24,0,12
D32,Other,2019,3,4,0,1
D31,Other Criminal Violations - Offensive Weapons,2019,1,1,1,0
D32,Robbery-Other,2019,5,20,0,15
D31,Other,2019,37,59,0,22
D32,Other,2019,12,12,1,0
D31,Other Criminal Violations - Offensive Weapons,2019,21,26,0,5
D31,Other,2019,14,22,0,8
D32,Robbery-Other,2019,0,10,0,10
D32,Other,2019,2,3,0,1
D32,Robbery-Other,2019,1,9,0,8
D32,Other,2019,11,15,0,4
D32,Robbery-Other,2019,1,5,0,4
D32,Other,2019,23,36,0,13
D31,Other Criminal Violations - Offensive Weapons,2019,27,33,0,6
D31,Other,2019,0,1,0,1
D31,Other,2019,9,10,0,1
D31,Other,2019,2,3,0,1
D31,Other,2019,2,3,0,1
D31,Other,2019,5,5,1,0
D31,Other,2019,4,4,1,0
D32,Other,2019,1,1,1,0
D32,Other,2019,2,2,1,0
D32,Other,2019,4,4,1,0
D32,Other,2019,3,3,1,0
D32,Other,2019,2,2,1,0
D32,Other,2019,4,5,0,1
D32,Other,2019,3,3,1,0
D32,Other,2019,2,2,1,0
D32,Other,2019,5,5,1,0
D32,Other,2019,0,1,0,1
D32,Other,2019,2,2,1,0
D32,Other,2019,2,2,1,0
D32,Other,2019,1,1,1,0
D32,Other,2019,6,6,1,0
D32,Other,2019,3,4,0,1
D32,Other,2019,1,1,1,0
D32,Other,2019,2,3,0,1
D32,Other,2019,6,6,1,0
D32,Auto Theft,2019,2,16,0,14
D32,Auto Theft,2019,3,26,0,23
D32,Auto Theft,2019,4,48,0,44
D32,Auto Theft,2019,0,5,0,5
D32,Auto Theft,2019,9,48,0,39
D32,Auto Theft,2019,1,17,0,16
D32,Auto Theft,2019,0,32,0,32
D32,Auto Theft,2019,1,8,0,7
D32,Auto Theft,2019,3,25,0,22
D32,Auto Theft,2019,1,19,0,18
D32,Auto Theft,2019,1,4,0,3
D32,Auto Theft,2019,1,29,0,28
D32,Auto Theft,2019,3,62,0,59
D32,Auto Theft,2019,3,27,0,24
D32,Auto Theft,2019,0,35,0,35
D32,Auto Theft,2019,1,25,0,24
D32,Auto Theft,2019,3,29,0,26
D32,Auto Theft,2019,4,49,0,45
D32,Auto Theft,2019,3,47,0,44
D32,Break & Enter-Apartment,2019,1,4,0,3
D32,Break & Enter-Apartment,2019,0,7,0,7
D32,Break & Enter-Apartment,2019,0,9,0,9
D32,Break & Enter-Apartment,2019,0,3,0,3
D32,Break & Enter-Apartment,2019,0,1,0,1
D33,Break & Enter-House,2019,0,5,0,5
D33,Other,2019,1,1,1,0
D33,Break & Enter-House,2019,2,20,0,18
D33,Other,2019,11,16,0,5
D33,Break & Enter-House,2019,0,6,0,6
D33,Other,2019,10,20,0,10
D33,Break & Enter-Other,2019,2,3,0,1
D33,Other,2019,8,18,0,10
D33,Break & Enter-Other,2019,0,1,0,1
D41,Break & Enter-Apartment,2019,4,14,0,10
D33,Other,2019,2,2,1,0
D33,Other,2019,7,9,0,2
D33,Break & Enter-Other,2019,0,1,0,1
D41,Break & Enter-Apartment,2019,5,11,0,6
D32,Other,2019,22,25,0,3
D33,Other,2019,9,11,0,2
D33,Other,2019,3,3,1,0
D33,Break & Enter-Other,2019,0,1,0,1
D41,Break & Enter-Apartment,2019,1,7,0,6
D32,Other,2019,11,13,0,2
D33,Other,2019,6,10,0,4
D33,Auto Theft,2019,5,45,0,40
D33,Break & Enter-Other,2019,0,3,0,3
D41,Break & Enter-Apartment,2019,3,17,0,14
D33,Theft Over $5000,2019,1,2,0,1
D41,Fraud,2019,4,26,0,22
D32,Other,2019,7,7,1,0
D33,Robbery-Financial,2019,0,2,0,2
D33,Auto Theft,2019,10,41,0,31
D33,Break & Enter-Other,2019,0,2,0,2
D41,Break & Enter-Apartment,2019,2,4,0,2
D33,Theft Over $5000,2019,0,13,0,13
D41,Fraud,2019,6,57,0,51
D33,Auto Theft,2019,0,21,0,21
D32,Other,2019,41,48,0,7
D33,Auto Theft,2019,2,26,0,24
D33,Break & Enter-Other,2019,1,2,0,1
D41,Break & Enter-Apartment,2019,6,13,0,7
D33,Auto Theft,2019,0,22,0,22
D32,Other,2019,11,12,0,1
D33,Theft Over $5000,2019,1,6,0,5
D33,Robbery-Other,2019,4,9,0,5
D41,Fraud,2019,9,64,0,55
D33,Auto Theft,2019,0,1,0,1
D32,Other,2019,9,9,1,0
D33,Theft Over $5000,2019,0,3,0,3
D33,Robbery-Other,2019,1,13,0,12
D33,Break & Enter-Other,2019,0,2,0,2
D41,Break & Enter-Apartment,2019,4,14,0,10
D41,Fraud,2019,4,9,0,5
D33,Auto Theft,2019,3,23,0,20
D32,Other,2019,46,53,0,7
D33,Theft Over $5000,2019,0,4,0,4
D33,Robbery-Other,2019,3,5,0,2
D33,Fraud,2019,3,120,0,117
D41,Break & Enter-Apartment,2019,3,16,0,13
D41,Fraud,2019,8,39,0,31
D33,Auto Theft,2019,3,28,0,25
D32,Other,2019,19,27,0,8
D33,Theft Over $5000,2019,1,4,0,3
D33,Robbery-Other,2019,1,11,0,10
D33,Fraud,2019,11,109,0,98
D41,Break & Enter-Apartment,2019,5,13,0,8
D41,Fraud,2019,29,138,0,109
D33,Auto Theft,2019,0,1,0,1
D32,Other,2019,17,23,0,6
D33,Theft Over $5000,2019,0,1,0,1
D33,Robbery-Other,2019,11,30,0,19
D33,Fraud,2019,3,43,0,40
D41,Break & Enter-Commercial,2019,2,2,1,0
D41,Other,2019,3,7,0,4
D33,Auto Theft,2019,0,9,0,9
D32,Other,2019,8,11,0,3
D33,Theft Under $5000,2019,79,346,0,267
D33,Robbery-Other,2019,7,23,0,16
D33,Fraud,2019,0,5,0,5
D41,Break & Enter-Commercial,2019,1,9,0,8
D41,Other,2019,7,23,0,16
D33,Auto Theft,2019,2,24,0,22
D33,Auto Theft,2019,2,15,0,13
D33,Auto Theft,2019,0,10,0,10
D33,Auto Theft,2019,0,2,0,2
D33,Break & Enter-Apartment,2019,1,15,0,14
D33,Break & Enter-Apartment,2019,1,9,0,8
D33,Break & Enter-Apartment,2019,2,5,0,3
D33,Break & Enter-Apartment,2019,1,1,1,0
D33,Break & Enter-Apartment,2019,0,16,0,16
D33,Break & Enter-Apartment,2019,0,23,0,23
D33,Break & Enter-Apartment,2019,1,26,0,25
D33,Break & Enter-Apartment,2019,0,2,0,2
D33,Break & Enter-Apartment,2019,0,10,0,10
D33,Break & Enter-Apartment,2019,1,4,0,3
D33,Break & Enter-Apartment,2019,1,1,1,0
D33,Break & Enter-Apartment,2019,2,22,0,20
D33,Break & Enter-Commercial,2019,1,11,0,10
D33,Break & Enter-Commercial,2019,0,4,0,4
D33,Break & Enter-Commercial,2019,0,2,0,2
D33,Break & Enter-Commercial,2019,0,2,0,2
D33,Break & Enter-Commercial,2019,0,4,0,4
D33,Break & Enter-Commercial,2019,0,1,0,1
D33,Break & Enter-Commercial,2019,0,10,0,10
D33,Break & Enter-Commercial,2019,0,11,0,11
D33,Break & Enter-Commercial,2019,0,1,0,1
D33,Break & Enter-Commercial,2019,0,6,0,6
D33,Break & Enter-Commercial,2019,0,1,0,1
D33,Break & Enter-Commercial,2019,1,5,0,4
D33,Break & Enter-Commercial,2019,0,5,0,5
D33,Break & Enter-House,2019,1,53,0,52
D33,Break & Enter-House,2019,0,23,0,23
D33,Break & Enter-House,2019,0,14,0,14
D33,Break & Enter-House,2019,1,12,0,11
D33,Break & Enter-House,2019,1,14,0,13
D33,Break & Enter-House,2019,1,9,0,8
D33,Break & Enter-House,2019,0,2,0,2
D33,Break & Enter-House,2019,1,18,0,17
D33,Break & Enter-House,2019,2,18,0,16
D41,Other,2019,44,108,0,64
D33,Robbery-Other,2019,0,6,0,6
D33,Theft Under $5000,2019,71,348,0,277
D33,Theft Under $5000,2019,17,86,0,69
D41,Break & Enter-Commercial,2019,0,11,0,11
D33,Fraud,2019,0,1,0,1
D33,Robbery-Other,2019,1,17,0,16
D41,Other,2019,44,139,0,95
D41,Break & Enter-Commercial,2019,6,31,0,25
D33,Theft Under $5000,2019,1,8,0,7
D33,Fraud,2019,13,106,0,93
D32,Other,2019,21,24,0,3
D33,Theft Under $5000,2019,0,1,0,1
D41,Break & Enter-Commercial,2019,1,3,0,2
D33,Fraud,2019,3,58,0,55
D41,Other,2019,9,30,0,21
D33,Robbery-Other,2019,0,1,0,1
D32,Other,2019,49,60,0,11
D33,Theft Under $5000,2019,220,477,0,257
D41,Break & Enter-Commercial,2019,9,34,0,25
D33,Fraud,2019,0,2,0,2
D41,Other,2019,33,90,0,57
D33,Robbery-Other,2019,1,2,0,1
D32,Other,2019,7,9,0,2
D33,Theft Under $5000,2019,11,145,0,134
D41,Break & Enter-Commercial,2019,5,9,0,4
D33,Fraud,2019,4,89,0,85
D41,Other,2019,8,25,0,17
D41,Other,2019,15,43,0,28
D41,Other,2019,43,103,0,60
D41,Other,2019,6,12,0,6
D41,Other,2019,26,102,0,76
D41,Other,2019,63,170,0,107
D41,Theft Over $5000,2019,1,7,0,6
D41,Theft Over $5000,2019,3,14,0,11
D41,Theft Over $5000,2019,0,1,0,1
D41,Theft Over $5000,2019,0,8,0,8
D41,Theft Over $5000,2019,1,5,0,4
D41,Theft Over $5000,2019,1,2,0,1
D41,Theft Over $5000,2019,0,6,0,6
D41,Theft Over $5000,2019,0,6,0,6
D41,Theft Over $5000,2019,3,14,0,11
D41,Theft Under $5000,2019,5,37,0,32
D41,Theft Under $5000,2019,47,100,0,53
D41,Theft Under $5000,2019,86,287,0,201
D41,Theft Under $5000,2019,111,423,0,312
D41,Theft Under $5000,2019,7,47,0,40
D41,Theft Under $5000,2019,89,380,0,291
D41,Theft Under $5000,2019,24,69,0,45
D41,Theft Under $5000,2019,18,93,0,75
D41,Theft Under $5000,2019,124,367,0,243
D41,Theft Under $5000,2019,97,119,0,22
D41,Theft Under $5000,2019,122,346,0,224
D41,Theft Under $5000,2019,571,1004,0,433
D41,Assault,2019,25,35,0,10
D41,Assault,2019,42,55,0,13
D41,Assault,2019,109,188,0,79
D41,Assault,2019,154,260,0,106
D41,Assault,2019,26,37,0,11
D41,Assault,2019,99,146,0,47
D41,Assault,2019,30,49,0,19
D41,Assault,2019,49,65,0,16
D41,Assault,2019,133,191,0,58
D41,Assault,2019,3,10,0,7
D41,Assault,2019,91,147,0,56
D33,Robbery-Other,2019,3,8,0,5
D33,Fraud,2019,7,65,0,58
D33,Robbery-Other,2019,4,14,0,10
D33,Fraud,2019,0,3,0,3
D41,Break & Enter-Commercial,2019,0,2,0,2
D33,Theft Under $5000,2019,1,2,0,1
D33,Robbery-Other,2019,2,6,0,4
D33,Fraud,2019,1,32,0,31
D32,Other,2019,44,49,0,5
D41,Break & Enter-Commercial,2019,5,18,0,13
D33,Theft Under $5000,2019,6,144,0,138
D33,Robbery-Other,2019,0,2,0,2
D33,Fraud,2019,5,65,0,60
D32,Other,2019,51,56,0,5
D33,Robbery-Other,2019,0,2,0,2
D41,Break & Enter-Commercial,2019,0,2,0,2
D33,Fraud,2019,2,34,0,32
D33,Theft Under $5000,2019,7,132,0,125
D32,Other,2019,39,45,0,6
D33,Sexual Violation,2019,6,12,0,6
D41,Break & Enter-Commercial,2019,7,18,0,11
D33,Fraud,2019,1,22,0,21
D33,Theft Under $5000,2019,0,9,0,9
D32,Other,2019,306,339,0,33
D33,Sexual Violation,2019,10,15,0,5
D41,Break & Enter-Commercial,2019,14,51,0,37
D33,Fraud,2019,2,3,0,1
D33,Theft Under $5000,2019,8,59,0,51
D32,Other,2019,109,124,0,15
D33,Sexual Violation,2019,3,5,0,2
D41,Break & Enter-House,2019,0,2,0,2
D33,Other,2019,23,89,0,66
D33,Theft Under $5000,2019,43,174,0,131
D33,Theft Under $5000,2019,22,130,0,108
D33,Theft Under $5000,2019,0,1,0,1
D33,Theft Under $5000,2019,17,107,0,90
D33,Theft Under $5000,2019,0,1,0,1
D33,Assault,2019,47,68,0,21
D33,Assault,2019,46,59,0,13
D33,Assault,2019,28,39,0,11
D33,Assault,2019,4,5,0,1
D33,Assault,2019,71,133,0,62
D33,Assault,2019,71,96,0,25
D33,Assault,2019,1,2,0,1
D33,Assault,2019,50,77,0,27
D33,Assault,2019,37,62,0,25
D33,Assault,2019,1,2,0,1
D33,Assault,2019,1,1,1,0
D33,Assault,2019,34,50,0,16
D33,Assault,2019,28,40,0,12
D33,Assault,2019,14,29,0,15
D33,Assault,2019,1,2,0,1
D33,Assault,2019,39,54,0,15
D33,Assault,2019,3,7,0,4
D33,Attempt Murder,2019,0,1,0,1
D33,Attempt Murder,2019,1,1,1,0
D33,Attempt Murder,2019,3,7,0,4
D33,Other,2019,7,19,0,12
D33,Other,2019,10,19,0,9
D33,Other,2019,2,8,0,6
D33,Other,2019,1,1,1,0
D33,Other,2019,14,27,0,13
D33,Other,2019,20,27,0,7
D33,Other,2019,15,16,0,1
D33,Sexual Violation,2019,9,20,0,11
D41,Break & Enter-House,2019,0,4,0,4
D33,Other,2019,15,46,0,31
D33,Sexual Violation,2019,9,17,0,8
D33,Other,2019,1,3,0,2
D32,Other Criminal Violations - Offensive Weapons,2019,3,3,1,0
D33,Other,2019,30,38,0,8
D33,Sexual Violation,2019,5,8,0,3
D41,Break & Enter-House,2019,6,27,0,21
D33,Other,2019,3,30,0,27
D32,Other Criminal Violations - Offensive Weapons,2019,3,3,1,0
D33,Other,2019,43,49,0,6
D33,Sexual Violation,2019,7,9,0,2
D33,Other,2019,0,1,0,1
D41,Break & Enter-House,2019,2,16,0,14
D33,Sexual Violation,2019,2,9,0,7
D33,Other,2019,0,2,0,2
D32,Other Criminal Violations - Offensive Weapons,2019,1,1,1,0
D33,Other,2019,18,75,0,57
D41,Break & Enter-House,2019,0,2,0,2
D33,Sexual Violation,2019,2,2,1,0
D33,Other,2019,13,14,0,1
D32,Other Criminal Violations - Offensive Weapons,2019,6,7,0,1
D33,Other,2019,16,57,0,41
D41,Break & Enter-House,2019,0,3,0,3
D33,Sexual Violation,2019,1,6,0,5
D33,Other,2019,10,13,0,3
D32,Other Criminal Violations - Offensive Weapons,2019,1,2,0,1
D33,Other,2019,1,6,0,5
D41,Break & Enter-House,2019,0,7,0,7
D33,Sexual Violation,2019,2,2,1,0
D33,Other,2019,1,1,1,0
D32,Other Criminal Violations - Offensive Weapons,2019,4,4,1,0
D33,Other,2019,15,62,0,47
D41,Break & Enter-House,2019,0,1,0,1
D33,Other,2019,14,15,0,1
D33,Other,2019,13,14,0,1
D32,Other Criminal Violations - Offensive Weapons,2019,6,6,1,0
D33,Other,2019,6,40,0,34
D41,Break & Enter-House,2019,1,8,0,7
D33,Other,2019,3,3,1,0
D33,Other,2019,16,18,0,2
D32,Other Criminal Violations - Offensive Weapons,2019,8,12,0,4
D33,Other,2019,1,1,1,0
D41,Break & Enter-House,2019,0,1,0,1
D33,Other,2019,4,4,1,0
D33,Other,2019,20,21,0,1
D32,Other Criminal Violations - Offensive Weapons,2019,3,3,1,0
D33,Other,2019,1,1,1,0
D41,Break & Enter-House,2019,5,12,0,7
D33,Other,2019,1,1,1,0
D33,Other,2019,1,1,1,0
D32,Other Criminal Violations - Offensive Weapons,2019,2,2,1,0
D33,Other,2019,11,46,0,35
D41,Break & Enter-House,2019,4,17,0,13
D33,Other,2019,4,4,1,0
D33,Other,2019,13,14,0,1
D33,Other,2019,5,5,1,0
D33,Other Criminal Violations - Offensive Weapons,2019,7,7,1,0
D33,Other Criminal Violations - Offensive Weapons,2019,3,5,0,2
D33,Other Criminal Violations - Offensive Weapons,2019,9,10,0,1
D33,Other Criminal Violations - Offensive Weapons,2019,10,13,0,3
D33,Other Criminal Violations - Offensive Weapons,2019,1,2,0,1
D33,Other Criminal Violations - Offensive Weapons,2019,3,3,1,0
D33,Other Criminal Violations - Offensive Weapons,2019,4,4,1,0
D33,Other Criminal Violations - Offensive Weapons,2019,1,2,0,1
D33,Other Criminal Violations - Offensive Weapons,2019,3,3,1,0
D33,Other Criminal Violations - Offensive Weapons,2019,2,2,1,0
D33,Other,2019,1,1,1,0
D33,Other,2019,1,1,1,0
D41,Other,2019,1,2,0,1
D41,Other,2019,5,5,1,0
D41,Other,2019,12,13,0,1
D41,Other,2019,17,18,0,1
D41,Other,2019,1,1,1,0
D41,Other,2019,7,8,0,1
D41,Other,2019,2,2,1,0
D41,Other,2019,5,5,1,0
D41,Other,2019,7,9,0,2
D41,Other,2019,2,2,1,0
D41,Other,2019,18,20,0,2
D41,Other,2019,11,12,0,1
D41,Auto Theft,2019,2,12,0,10
D41,Auto Theft,2019,1,10,0,9
D41,Auto Theft,2019,0,26,0,26
D41,Auto Theft,2019,9,71,0,62
D41,Auto Theft,2019,0,6,0,6
D41,Auto Theft,2019,5,61,0,56
D41,Auto Theft,2019,2,8,0,6
D41,Auto Theft,2019,1,9,0,8
D41,Auto Theft,2019,2,25,0,23
D41,Auto Theft,2019,1,10,0,9
D41,Auto Theft,2019,0,8,0,8
D41,Auto Theft,2019,4,96,0,92
D33,Other,2019,10,10,1,0
D41,Break & Enter-Other,2019,1,2,0,1
D32,Other Criminal Violations - Offensive Weapons,2019,3,5,0,2
D33,Other,2019,4,29,0,25
D33,Other,2019,2,2,1,0
D33,Other,2019,6,25,0,19
D41,Break & Enter-Other,2019,3,6,0,3
D32,Other Criminal Violations - Offensive Weapons,2019,10,10,1,0
D33,Other,2019,7,7,1,0
D33,Other,2019,1,1,1,0
D32,Other Criminal Violations - Offensive Weapons,2019,3,3,1,0
D41,Break & Enter-Other,2019,3,5,0,2
D33,Other,2019,3,3,1,0
D33,Other,2019,1,1,1,0
D32,Other Criminal Violations - Offensive Weapons,2019,8,12,0,4
D41,Break & Enter-Other,2019,5,7,0,2
D33,Other,2019,1,1,1,0
D33,Other,2019,8,29,0,21
D32,Other Criminal Violations - Offensive Weapons,2019,10,10,1,0
D41,Break & Enter-Other,2019,0,1,0,1
D33,Other,2019,5,5,1,0
D33,Other,2019,3,3,1,0
D32,Other Criminal Violations - Offensive Weapons,2019,4,5,0,1
D41,Break & Enter-Other,2019,1,3,0,2
D33,Other,2019,1,1,1,0
D33,Theft Over $5000,2019,3,16,0,13
D32,Other Criminal Violations - Offensive Weapons,2019,3,5,0,2
D41,Break & Enter-Other,2019,0,1,0,1
D33,Other,2019,11,11,1,0
D33,Theft Over $5000,2019,0,12,0,12
D32,Other Criminal Violations - Offensive Weapons,2019,23,26,0,3
D41,Break & Enter-Other,2019,1,3,0,2
D33,Other,2019,7,8,0,1
D33,Theft Over $5000,2019,1,2,0,1
D32,Other,2019,2,2,1,0
D41,Break & Enter-Other,2019,0,2,0,2
D33,Other,2019,20,31,0,11
D33,Theft Over $5000,2019,0,1,0,1
D32,Other,2019,0,1,0,1
D41,Break & Enter-Other,2019,1,4,0,3
D33,Other,2019,34,40,0,6
D33,Theft Over $5000,2019,4,14,0,10
D32,Other,2019,1,1,1,0
D41,Break & Enter-Other,2019,1,5,0,4
D32,Other,2019,1,2,0,1
D41,Fraud,2019,4,22,0,18
D32,Other,2019,2,2,1,0
D41,Fraud,2019,3,25,0,22
D32,Other,2019,1,1,1,0
D41,Fraud,2019,9,67,0,58
D32,Other,2019,2,2,1,0
D41,Fraud,2019,20,111,0,91
D33,Other,2019,6,7,0,1
D41,Fraud,2019,2,13,0,11
D33,Other,2019,4,5,0,1
D41,Fraud,2019,18,109,0,91
D33,Other,2019,12,15,0,3
D33,Other,2019,2,2,1,0
D33,Other,2019,3,4,0,1
D33,Other,2019,1,1,1,0
D33,Other,2019,1,1,1,0
D42,Other,2019,15,15,1,0
D42,Assault,2019,61,92,0,31
D42,Auto Theft,2019,8,86,0,78
D42,Other,2019,1,1,1,0
D42,Assault,2019,140,197,0,57
D42,Auto Theft,2019,2,57,0,55
D43,Break & Enter-House,2019,3,11,0,8
D42,Other,2019,7,7,1,0
D42,Assault,2019,66,103,0,37
D42,Auto Theft,2019,0,2,0,2
D43,Break & Enter-Other,2019,1,2,0,1
D42,Other,2019,24,25,0,1
D42,Assault,2019,51,90,0,39
D42,Auto Theft,2019,2,31,0,29
D43,Break & Enter-Other,2019,0,2,0,2
D42,Other,2019,16,18,0,2
D42,Assault,2019,73,99,0,26
D42,Auto Theft,2019,3,25,0,22
D43,Break & Enter-Other,2019,1,5,0,4
D42,Other,2019,13,14,0,1
D42,Assault,2019,1,5,0,4
D42,Auto Theft,2019,1,22,0,21
D43,Break & Enter-Other,2019,2,2,1,0
D42,Other,2019,27,28,0,1
D42,Assault,2019,24,44,0,20
D42,Break & Enter-Apartment,2019,0,3,0,3
D43,Break & Enter-Other,2019,1,1,1,0
D42,Other,2019,1,1,1,0
D42,Assault,2019,67,98,0,31
D42,Break & Enter-Apartment,2019,0,4,0,4
D43,Break & Enter-Other,2019,5,6,0,1
D42,Other,2019,6,6,1,0
D42,Assault,2019,29,46,0,17
D42,Break & Enter-Apartment,2019,2,8,0,6
D43,Break & Enter-Other,2019,4,7,0,3
D43,Break & Enter-Other,2019,0,1,0,1
D43,Break & Enter-Other,2019,1,5,0,4
D43,Fraud,2019,2,18,0,16
D43,Fraud,2019,13,87,0,74
D43,Fraud,2019,4,32,0,28
D43,Fraud,2019,4,45,0,41
D43,Fraud,2019,11,53,0,42
D43,Fraud,2019,12,107,0,95
D43,Fraud,2019,2,24,0,22
D43,Fraud,2019,10,62,0,52
D43,Fraud,2019,2,59,0,57
D43,Fraud,2019,0,4,0,4
D43,Fraud,2019,7,58,0,51
D43,Fraud,2019,15,116,0,101
D43,Fraud,2019,4,21,0,17
D43,Fraud,2019,5,118,0,113
D43,Other,2019,7,12,0,5
D43,Other,2019,40,77,0,37
D43,Other,2019,16,34,0,18
D43,Other,2019,15,51,0,36
D43,Other,2019,23,58,0,35
D43,Other,2019,45,96,0,51
D43,Other,2019,7,26,0,19
D43,Other,2019,12,35,0,23
D43,Other,2019,19,55,0,36
D43,Other,2019,2,4,0,2
D43,Other,2019,35,70,0,35
D43,Other,2019,112,212,0,100
D43,Other,2019,6,15,0,9
D43,Other,2019,39,98,0,59
D43,Theft Over $5000,2019,0,1,0,1
D43,Theft Over $5000,2019,1,8,0,7
D43,Theft Over $5000,2019,0,3,0,3
D43,Theft Over $5000,2019,1,2,0,1
D43,Theft Over $5000,2019,0,3,0,3
D43,Theft Over $5000,2019,1,4,0,3
D43,Theft Over $5000,2019,0,1,0,1
D43,Theft Over $5000,2019,0,1,0,1
D43,Theft Over $5000,2019,0,4,0,4
D43,Theft Over $5000,2019,0,2,0,2
D43,Theft Over $5000,2019,2,4,0,2
D43,Theft Over $5000,2019,0,1,0,1
D43,Other,2019,23,25,0,2
D41,Assault,2019,120,208,0,88
D41,Other,2019,4,4,1,0
D42,Fraud,2019,8,78,0,70
D43,Other,2019,4,4,1,0
D42,Other,2019,10,10,1,0
D42,Break & Enter-Apartment,2019,1,17,0,16
D41,Other,2019,17,18,0,1
D42,Fraud,2019,3,47,0,44
D43,Other,2019,8,9,0,1
D43,Auto Theft,2019,2,8,0,6
D43,Auto Theft,2019,2,27,0,25
D43,Auto Theft,2019,2,21,0,19
D43,Auto Theft,2019,2,14,0,12
D43,Auto Theft,2019,5,20,0,15
D43,Auto Theft,2019,3,21,0,18
D43,Auto Theft,2019,1,3,0,2
D43,Auto Theft,2019,7,27,0,20
D43,Auto Theft,2019,0,8,0,8
D43,Auto Theft,2019,3,20,0,17
D43,Auto Theft,2019,10,48,0,38
D43,Auto Theft,2019,1,11,0,10
D43,Auto Theft,2019,1,40,0,39
D43,Break & Enter-Apartment,2019,2,3,0,1
D43,Break & Enter-Apartment,2019,1,2,0,1
D43,Break & Enter-Apartment,2019,1,2,0,1
D43,Break & Enter-Apartment,2019,7,14,0,7
D43,Break & Enter-Apartment,2019,4,13,0,9
D43,Break & Enter-Apartment,2019,4,7,0,3
D43,Break & Enter-Apartment,2019,4,12,0,8
D43,Break & Enter-Apartment,2019,9,27,0,18
D43,Break & Enter-Apartment,2019,5,18,0,13
D43,Break & Enter-Commercial,2019,2,7,0,5
D43,Break & Enter-Commercial,2019,1,5,0,4
D43,Break & Enter-Commercial,2019,3,12,0,9
D43,Break & Enter-Commercial,2019,1,11,0,10
D43,Break & Enter-Commercial,2019,10,18,0,8
D43,Break & Enter-Commercial,2019,11,20,0,9
D43,Break & Enter-Commercial,2019,0,2,0,2
D43,Break & Enter-Commercial,2019,2,3,0,1
D43,Break & Enter-Commercial,2019,0,1,0,1
D43,Break & Enter-Commercial,2019,4,15,0,11
D43,Break & Enter-Commercial,2019,13,30,0,17
D43,Break & Enter-Commercial,2019,1,6,0,5
D43,Break & Enter-Commercial,2019,8,26,0,18
D43,Break & Enter-House,2019,1,5,0,4
D43,Break & Enter-House,2019,0,2,0,2
D43,Break & Enter-House,2019,1,15,0,14
D43,Break & Enter-House,2019,6,15,0,9
D43,Break & Enter-House,2019,0,5,0,5
D43,Break & Enter-House,2019,2,5,0,3
D43,Break & Enter-House,2019,2,8,0,6
D43,Break & Enter-House,2019,6,29,0,23
D42,Attempt Murder,2019,0,1,0,1
D41,Attempt Murder,2019,1,1,1,0
D43,Break & Enter-House,2019,0,9,0,9
D43,Break & Enter-House,2019,3,7,0,4
D43,Break & Enter-House,2019,6,13,0,7
D43,Break & Enter-House,2019,3,7,0,4
D42,Break & Enter-Apartment,2019,2,2,1,0
D41,Other,2019,5,6,0,1
D42,Attempt Murder,2019,1,2,0,1
D42,Break & Enter-Apartment,2019,0,5,0,5
D41,Attempt Murder,2019,1,1,1,0
D42,Fraud,2019,14,83,0,69
D42,Fraud,2019,13,87,0,74
D42,Other,2019,8,8,1,0
D41,Other,2019,2,9,0,7
D41,Other,2019,14,14,1,0
D42,Attempt Murder,2019,2,2,1,0
D42,Break & Enter-Apartment,2019,0,2,0,2
D42,Fraud,2019,1,2,0,1
D42,Other,2019,22,31,0,9
D41,Other,2019,8,20,0,12
D41,Other,2019,84,99,0,15
D42,Attempt Murder,2019,1,1,1,0
D42,Break & Enter-Apartment,2019,0,1,0,1
D42,Fraud,2019,1,53,0,52
D42,Other,2019,60,65,0,5
D41,Other,2019,29,38,0,9
D41,Other,2019,507,535,0,28
D42,Other,2019,12,18,0,6
D42,Break & Enter-Apartment,2019,0,5,0,5
D42,Fraud,2019,13,102,0,89
D42,Other,2019,34,38,0,4
D41,Other,2019,35,50,0,15
D41,Other,2019,9,11,0,2
D42,Other,2019,13,38,0,25
D42,Break & Enter-Apartment,2019,3,11,0,8
D42,Fraud,2019,2,35,0,33
D42,Other,2019,34,37,0,3
D41,Other,2019,10,12,0,2
D41,Other,2019,219,234,0,15
D42,Other,2019,25,30,0,5
D42,Break & Enter-Apartment,2019,0,1,0,1
D42,Other,2019,11,58,0,47
D42,Other,2019,65,76,0,11
D41,Other,2019,15,38,0,23
D41,Other,2019,11,13,0,2
D42,Other,2019,7,13,0,6
D42,Break & Enter-Commercial,2019,0,13,0,13
D42,Other,2019,25,80,0,55
D42,Other,2019,27,29,0,2
D41,Other,2019,2,6,0,4
D41,Other,2019,98,102,0,4
D41,Other,2019,103,111,0,8
D41,Other,2019,10,12,0,2
D41,Other,2019,100,109,0,9
D41,Other,2019,129,143,0,14
D41,Other Criminal Violations - Offensive Weapons,2019,1,1,1,0
D41,Other Criminal Violations - Offensive Weapons,2019,9,11,0,2
D41,Other Criminal Violations - Offensive Weapons,2019,14,14,1,0
D41,Other Criminal Violations - Offensive Weapons,2019,21,22,0,1
D41,Other Criminal Violations - Offensive Weapons,2019,3,3,1,0
D41,Other Criminal Violations - Offensive Weapons,2019,15,20,0,5
D41,Other Criminal Violations - Offensive Weapons,2019,3,4,0,1
D41,Other Criminal Violations - Offensive Weapons,2019,8,8,1,0
D41,Other Criminal Violations - Offensive Weapons,2019,9,11,0,2
D41,Other Criminal Violations - Offensive Weapons,2019,1,1,1,0
D41,Other Criminal Violations - Offensive Weapons,2019,14,18,0,4
D41,Other Criminal Violations - Offensive Weapons,2019,20,21,0,1
D41,Other,2019,1,1,1,0
D41,Other,2019,2,2,1,0
D41,Other,2019,1,1,1,0
D41,Other,2019,0,1,0,1
D41,Other,2019,2,2,1,0
D41,Other,2019,2,2,1,0
D41,Other,2019,2,2,1,0
D42,Other,2019,1,1,1,0
D42,Other,2019,8,8,1,0
D42,Other,2019,5,7,0,2
D42,Other,2019,3,3,1,0
D42,Other,2019,3,3,1,0
D42,Other,2019,3,3,1,0
D42,Other,2019,1,1,1,0
D42,Other,2019,1,1,1,0
D42,Other,2019,1,1,1,0
D42,Other,2019,3,3,1,0
D42,Auto Theft,2019,10,43,0,33
D42,Auto Theft,2019,4,58,0,54
D42,Auto Theft,2019,0,1,0,1
D42,Auto Theft,2019,1,13,0,12
D42,Auto Theft,2019,1,27,0,26
D42,Auto Theft,2019,11,40,0,29
D42,Auto Theft,2019,2,38,0,36
D42,Other,2019,34,40,0,6
D42,Other,2019,14,47,0,33
D42,Break & Enter-Commercial,2019,16,56,0,40
D42,Other,2019,42,47,0,5
D42,Other,2019,17,35,0,18
D42,Other,2019,12,47,0,35
D42,Other,2019,2,3,0,1
D42,Other,2019,19,25,0,6
D42,Other,2019,17,72,0,55
D42,Other,2019,7,10,0,3
D42,Break & Enter-Commercial,2019,1,5,0,4
D42,Other,2019,6,19,0,13
D42,Other,2019,15,63,0,48
D42,Other,2019,33,38,0,5
D42,Break & Enter-Commercial,2019,0,2,0,2
D42,Other,2019,11,22,0,11
D42,Other,2019,16,82,0,66
D42,Other,2019,10,10,1,0
D42,Break & Enter-Commercial,2019,2,2,1,0
D42,Other,2019,5,8,0,3
D42,Other,2019,25,83,0,58
D42,Other Criminal Violations - Offensive Weapons,2019,8,8,1,0
D42,Break & Enter-Commercial,2019,3,14,0,11
D42,Other,2019,9,24,0,15
D42,Other,2019,0,1,0,1
D42,Other Criminal Violations - Offensive Weapons,2019,7,7,1,0
D42,Break & Enter-Commercial,2019,28,65,0,37
D42,Other,2019,2,6,0,4
D42,Other,2019,4,37,0,33
D42,Other Criminal Violations - Offensive Weapons,2019,1,1,1,0
D42,Break & Enter-Commercial,2019,6,11,0,5
D42,Robbery-Financial,2019,3,5,0,2
D42,Other,2019,21,83,0,62
D42,Other Criminal Violations - Offensive Weapons,2019,4,5,0,1
D42,Break & Enter-Commercial,2019,6,8,0,2
D42,Robbery-Other,2019,15,35,0,20
D42,Other,2019,7,25,0,18
D42,Other Criminal Violations - Offensive Weapons,2019,2,3,0,1
D42,Break & Enter-Commercial,2019,6,20,0,14
D42,Robbery-Other,2019,10,23,0,13
D42,Theft Over $5000,2019,1,3,0,2
D42,Other Criminal Violations - Offensive Weapons,2019,6,7,0,1
D42,Break & Enter-Commercial,2019,0,3,0,3
D42,Robbery-Other,2019,10,34,0,24
D42,Theft Over $5000,2019,2,15,0,13
D42,Other Criminal Violations - Offensive Weapons,2019,5,7,0,2
D42,Break & Enter-House,2019,1,40,0,39
D42,Robbery-Other,2019,7,18,0,11
D42,Theft Over $5000,2019,1,2,0,1
D42,Other Criminal Violations - Offensive Weapons,2019,3,4,0,1
D42,Break & Enter-House,2019,0,37,0,37
D42,Theft Over $5000,2019,0,3,0,3
D42,Other Criminal Violations - Offensive Weapons,2019,10,10,1,0
D42,Robbery-Other,2019,9,20,0,11
D42,Break & Enter-House,2019,0,26,0,26
D42,Theft Over $5000,2019,2,6,0,4
D42,Other Criminal Violations - Offensive Weapons,2019,3,4,0,1
D42,Robbery-Other,2019,3,20,0,17
D42,Break & Enter-House,2019,1,26,0,25
D42,Theft Over $5000,2019,3,22,0,19
D42,Other Criminal Violations - Offensive Weapons,2019,1,1,1,0
D42,Robbery-Other,2019,4,28,0,24
D42,Break & Enter-House,2019,3,10,0,7
D42,Theft Over $5000,2019,1,9,0,8
D42,Other,2019,3,3,1,0
D42,Robbery-Other,2019,5,11,0,6
D42,Break & Enter-House,2019,2,10,0,8
D42,Theft Over $5000,2019,0,1,0,1
D42,Other,2019,2,2,1,0
D42,Robbery-Other,2019,3,7,0,4
D42,Break & Enter-House,2019,1,63,0,62
D42,Theft Over $5000,2019,1,5,0,4
D42,Other,2019,2,2,1,0
D42,Robbery-Other,2019,3,8,0,5
D42,Break & Enter-House,2019,1,24,0,23
D42,Theft Over $5000,2019,0,3,0,3
D42,Other,2019,2,2,1,0
D42,Robbery-Other,2019,13,23,0,10
D42,Break & Enter-House,2019,2,52,0,50
D42,Theft Over $5000,2019,0,3,0,3
D42,Other,2019,5,6,0,1
D42,Robbery-Other,2019,9,18,0,9
D42,Break & Enter-House,2019,1,34,0,33
D42,Theft Under $5000,2019,60,260,0,200
D42,Other,2019,1,1,1,0
D42,Sexual Violation,2019,6,12,0,6
D42,Break & Enter-House,2019,0,5,0,5
D42,Theft Under $5000,2019,48,210,0,162
D42,Other,2019,1,1,1,0
D42,Sexual Violation,2019,9,18,0,9
D42,Break & Enter-Other,2019,0,3,0,3
D42,Theft Under $5000,2019,1,1,1,0
D42,Sexual Violation,2019,11,19,0,8
D43,Other,2019,1,1,1,0
D42,Theft Under $5000,2019,1,3,0,2
D42,Sexual Violation,2019,7,11,0,4
D42,Break & Enter-Other,2019,0,1,0,1
D43,Other,2019,2,3,0,1
D42,Theft Under $5000,2019,5,61,0,56
D42,Sexual Violation,2019,6,18,0,12
D42,Break & Enter-Other,2019,0,1,0,1
D43,Other,2019,2,2,1,0
D42,Theft Under $5000,2019,47,192,0,145
D42,Sexual Violation,2019,4,5,0,1
D42,Break & Enter-Other,2019,1,1,1,0
D43,Other,2019,6,6,1,0
D42,Theft Under $5000,2019,120,309,0,189
D42,Sexual Violation,2019,7,14,0,7
D42,Break & Enter-Other,2019,0,2,0,2
D43,Other,2019,18,20,0,2
D42,Theft Under $5000,2019,27,125,0,98
D42,Sexual Violation,2019,8,11,0,3
D42,Break & Enter-Other,2019,0,1,0,1
D43,Other,2019,7,7,1,0
D42,Theft Under $5000,2019,113,347,0,234
D42,Sexual Violation,2019,5,12,0,7
D42,Break & Enter-Other,2019,0,2,0,2
D43,Other,2019,3,3,1,0
D42,Theft Under $5000,2019,37,193,0,156
D42,Sexual Violation,2019,10,14,0,4
D42,Fraud,2019,5,68,0,63
D43,Other,2019,7,8,0,1
D42,Theft Under $5000,2019,2,3,0,1
D42,Sexual Violation,2019,1,9,0,8
D42,Fraud,2019,14,95,0,81
D43,Other,2019,12,13,0,1
D42,Theft Under $5000,2019,4,62,0,58
D42,Other,2019,18,18,1,0
D42,Fraud,2019,3,49,0,46
D42,Theft Under $5000,2019,142,437,0,295
D42,Other,2019,26,26,1,0
D42,Fraud,2019,2,58,0,56
D42,Theft Under $5000,2019,6,98,0,92
D42,Theft Under $5000,2019,0,1,0,1
D42,Assault,2019,40,69,0,29
D42,Assault,2019,68,111,0,43
D42,Assault,2019,54,83,0,29
D42,Assault,2019,0,1,0,1
D41,Other,2019,14,16,0,2
D41,Other,2019,35,47,0,12
D41,Other,2019,2,2,1,0
D41,Other,2019,9,23,0,14
D41,Other,2019,32,53,0,21
D41,Robbery-Financial,2019,0,3,0,3
D41,Robbery-Other,2019,0,1,0,1
D41,Robbery-Other,2019,1,8,0,7
D41,Robbery-Other,2019,13,27,0,14
D41,Robbery-Other,2019,11,32,0,21
D41,Robbery-Other,2019,1,5,0,4
D41,Robbery-Other,2019,16,33,0,17
D41,Robbery-Other,2019,1,6,0,5
D41,Robbery-Other,2019,7,11,0,4
D41,Robbery-Other,2019,10,24,0,14
D41,Robbery-Other,2019,0,3,0,3
D41,Robbery-Other,2019,17,26,0,9
D41,Robbery-Other,2019,7,21,0,14
D41,Sexual Violation,2019,2,3,0,1
D41,Sexual Violation,2019,5,8,0,3
D41,Sexual Violation,2019,15,27,0,12
D41,Sexual Violation,2019,22,36,0,14
D41,Sexual Violation,2019,7,8,0,1
D41,Sexual Violation,2019,7,19,0,12
D41,Sexual Violation,2019,3,4,0,1
D41,Sexual Violation,2019,3,9,0,6
D41,Sexual Violation,2019,15,32,0,17
D41,Sexual Violation,2019,1,1,1,0
D41,Sexual Violation,2019,1,7,0,6
D41,Sexual Violation,2019,16,32,0,16
D41,Other,2019,3,3,1,0
D41,Other,2019,4,4,1,0
D41,Other,2019,22,23,0,1
D41,Other,2019,15,18,0,3
D41,Other,2019,9,9,1,0
D41,Other,2019,25,28,0,3
D41,Other,2019,7,8,0,1
D41,Other,2019,8,8,1,0
D41,Other,2019,11,11,1,0
D41,Other,2019,2,2,1,0
D43,Theft Over $5000,2019,0,4,0,4
D51,Theft Over $5000,2019,4,6,0,2
D51,Sexual Violation,2019,11,19,0,8
D51,Break & Enter-Apartment,2019,18,44,0,26
D43,Robbery-Financial,2019,1,1,1,0
D52,Theft Over $5000,2019,2,15,0,13
D52,Auto Theft,2019,1,3,0,2
D43,Theft Under $5000,2019,1,21,0,20
D43,Theft Under $5000,2019,400,674,0,274
D43,Theft Under $5000,2019,19,97,0,78
D43,Theft Under $5000,2019,49,196,0,147
D43,Theft Under $5000,2019,78,193,0,115
D43,Theft Under $5000,2019,142,319,0,177
D43,Theft Under $5000,2019,11,53,0,42
D43,Theft Under $5000,2019,28,135,0,107
D43,Theft Under $5000,2019,30,151,0,121
D43,Theft Under $5000,2019,5,14,0,9
D43,Theft Under $5000,2019,110,225,0,115
D43,Theft Under $5000,2019,130,335,0,205
D43,Theft Under $5000,2019,10,43,0,33
D43,Theft Under $5000,2019,55,274,0,219
D43,Assault,2019,16,28,0,12
D43,Assault,2019,79,126,0,47
D43,Assault,2019,28,41,0,13
D43,Assault,2019,55,87,0,32
D43,Assault,2019,90,117,0,27
D43,Assault,2019,131,204,0,73
D43,Assault,2019,25,26,0,1
D43,Assault,2019,43,59,0,16
D43,Assault,2019,117,157,0,40
D43,Assault,2019,10,12,0,2
D43,Assault,2019,121,155,0,34
D43,Assault,2019,285,393,0,108
D43,Assault,2019,15,22,0,7
D43,Assault,2019,144,189,0,45
D43,Attempt Murder,2019,1,1,1,0
D43,Attempt Murder,2019,1,3,0,2
D43,Attempt Murder,2019,1,1,1,0
D43,Attempt Murder,2019,0,2,0,2
D43,Attempt Murder,2019,5,6,0,1
D43,Attempt Murder,2019,0,1,0,1
D43,Other,2019,4,4,1,0
D43,Other,2019,21,31,0,10
D43,Other,2019,14,17,0,3
D43,Other,2019,13,25,0,12
D43,Other,2019,21,33,0,12
D43,Other,2019,40,55,0,15
D43,Other,2019,8,11,0,3
D43,Other,2019,7,16,0,9
D43,Other,2019,18,24,0,6
D43,Other,2019,1,2,0,1
D43,Other,2019,21,33,0,12
D43,Other,2019,56,88,0,32
D43,Other,2019,4,7,0,3
D43,Other,2019,23,41,0,18
D43,Robbery-Financial,2019,2,2,1,0
D51,Theft Over $5000,2019,1,4,0,3
D52,Theft Over $5000,2019,3,26,0,23
D51,Break & Enter-Apartment,2019,0,1,0,1
D43,Robbery-Financial,2019,1,1,1,0
D51,Sexual Violation,2019,4,13,0,9
D51,Break & Enter-Apartment,2019,11,39,0,28
D52,Auto Theft,2019,6,23,0,17
D43,Robbery-Other,2019,0,3,0,3
D51,Sexual Violation,2019,5,12,0,7
D51,Theft Over $5000,2019,4,18,0,14
D52,Theft Over $5000,2019,0,10,0,10
D51,Break & Enter-Commercial,2019,9,38,0,29
D52,Auto Theft,2019,12,40,0,28
D43,Robbery-Other,2019,9,23,0,14
D51,Sexual Violation,2019,11,16,0,5
D51,Theft Under $5000,2019,51,304,0,253
D52,Theft Over $5000,2019,0,2,0,2
D51,Break & Enter-Commercial,2019,10,56,0,46
D52,Break & Enter-Apartment,2019,15,31,0,16
D43,Robbery-Other,2019,12,21,0,9
D51,Other,2019,2,3,0,1
D51,Theft Under $5000,2019,251,1634,0,1383
D52,Theft Over $5000,2019,4,15,0,11
D51,Break & Enter-Commercial,2019,19,101,0,82
D52,Break & Enter-Apartment,2019,3,21,0,18
D43,Robbery-Other,2019,7,20,0,13
D51,Other,2019,2,4,0,2
D51,Theft Under $5000,2019,331,1491,0,1160
D52,Theft Over $5000,2019,17,63,0,46
D51,Break & Enter-Commercial,2019,15,97,0,82
D52,Break & Enter-Apartment,2019,2,31,0,29
D43,Robbery-Other,2019,16,43,0,27
D51,Other,2019,15,16,0,1
D51,Theft Under $5000,2019,155,919,0,764
D52,Theft Under $5000,2019,58,419,0,361
D51,Break & Enter-Commercial,2019,0,2,0,2
D52,Break & Enter-Apartment,2019,3,20,0,17
D43,Robbery-Other,2019,5,7,0,2
D51,Other,2019,27,28,0,1
D51,Theft Under $5000,2019,0,7,0,7
D52,Theft Under $5000,2019,1,28,0,27
D51,Break & Enter-Commercial,2019,2,12,0,10
D52,Break & Enter-Apartment,2019,3,7,0,4
D43,Robbery-Other,2019,3,10,0,7
D51,Other,2019,0,1,0,1
D51,Theft Under $5000,2019,53,488,0,435
D52,Theft Under $5000,2019,0,1,0,1
D51,Break & Enter-Commercial,2019,1,12,0,11
D51,Break & Enter-Commercial,2019,0,1,0,1
D51,Break & Enter-Commercial,2019,8,32,0,24
D51,Break & Enter-House,2019,3,31,0,28
D51,Break & Enter-House,2019,2,4,0,2
D51,Break & Enter-House,2019,0,4,0,4
D51,Break & Enter-House,2019,5,18,0,13
D51,Break & Enter-House,2019,0,3,0,3
D51,Break & Enter-House,2019,1,4,0,3
D51,Break & Enter-House,2019,0,1,0,1
D51,Break & Enter-Other,2019,4,12,0,8
D51,Break & Enter-Other,2019,3,6,0,3
D51,Break & Enter-Other,2019,6,20,0,14
D51,Break & Enter-Other,2019,7,18,0,11
D51,Break & Enter-Other,2019,2,3,0,1
D51,Break & Enter-Other,2019,0,5,0,5
D51,Break & Enter-Other,2019,1,3,0,2
D51,Fraud,2019,6,75,0,69
D51,Fraud,2019,21,244,0,223
D51,Fraud,2019,21,269,0,248
D51,Fraud,2019,28,218,0,190
D51,Fraud,2019,0,2,0,2
D51,Fraud,2019,14,78,0,64
D51,Fraud,2019,4,65,0,61
D51,Fraud,2019,1,31,0,30
D51,Fraud,2019,3,133,0,130
D51,Other,2019,37,126,0,89
D51,Other,2019,73,229,0,156
D51,Other,2019,156,418,0,262
D51,Other,2019,161,449,0,288
D51,Other,2019,1,4,0,3
D51,Other,2019,40,163,0,123
D51,Other,2019,37,98,0,61
D51,Other,2019,4,14,0,10
D51,Other,2019,37,138,0,101
D51,Theft Over $5000,2019,1,3,0,2
D51,Theft Over $5000,2019,4,21,0,17
D51,Theft Over $5000,2019,3,22,0,19
D51,Theft Over $5000,2019,4,25,0,21
D51,Theft Over $5000,2019,1,1,1,0
D51,Theft Over $5000,2019,3,15,0,12
D51,Theft Under $5000,2019,67,264,0,197
D43,Robbery-Other,2019,5,14,0,9
D52,Break & Enter-Apartment,2019,4,31,0,27
D52,Theft Under $5000,2019,7,68,0,61
D51,Other,2019,4,5,0,1
D51,Theft Under $5000,2019,8,349,0,341
D43,Robbery-Other,2019,0,2,0,2
D52,Break & Enter-Apartment,2019,4,33,0,29
D51,Theft Under $5000,2019,143,580,0,437
D43,Robbery-Other,2019,10,23,0,13
D51,Other,2019,14,14,1,0
D52,Break & Enter-Commercial,2019,8,44,0,36
D51,Assault,2019,85,131,0,46
D52,Theft Under $5000,2019,53,268,0,215
D43,Robbery-Other,2019,38,61,0,23
D51,Other,2019,10,10,1,0
D52,Break & Enter-Commercial,2019,1,1,1,0
D51,Assault,2019,163,300,0,137
D52,Theft Under $5000,2019,117,740,0,623
D43,Robbery-Other,2019,1,1,1,0
D51,Other,2019,16,16,1,0
D52,Break & Enter-Commercial,2019,1,7,0,6
D51,Assault,2019,271,481,0,210
D52,Theft Under $5000,2019,1,6,0,5
D43,Robbery-Other,2019,1,1,1,0
D51,Other,2019,50,60,0,10
D52,Break & Enter-Commercial,2019,29,117,0,88
D52,Break & Enter-Commercial,2019,0,5,0,5
D52,Break & Enter-Commercial,2019,0,5,0,5
D52,Break & Enter-Commercial,2019,21,46,0,25
D52,Break & Enter-Commercial,2019,31,76,0,45
D52,Break & Enter-House,2019,0,2,0,2
D52,Break & Enter-House,2019,1,2,0,1
D52,Break & Enter-House,2019,6,9,0,3
D52,Break & Enter-House,2019,1,2,0,1
D52,Break & Enter-Other,2019,2,5,0,3
D52,Break & Enter-Other,2019,0,3,0,3
D52,Break & Enter-Other,2019,4,7,0,3
D52,Break & Enter-Other,2019,2,4,0,2
D52,Break & Enter-Other,2019,0,8,0,8
D52,Break & Enter-Other,2019,1,1,1,0
D52,Break & Enter-Other,2019,5,10,0,5
D52,Fraud,2019,18,150,0,132
D52,Fraud,2019,1,13,0,12
D52,Fraud,2019,20,44,0,24
D52,Fraud,2019,12,124,0,112
D52,Fraud,2019,9,129,0,120
D52,Fraud,2019,1,5,0,4
D52,Fraud,2019,34,133,0,99
D52,Fraud,2019,2,38,0,36
D52,Fraud,2019,16,185,0,169
D52,Fraud,2019,49,506,0,457
D52,Other,2019,50,115,0,65
D52,Other,2019,6,6,1,0
D52,Other,2019,11,31,0,20
D52,Other,2019,18,56,0,38
D52,Other,2019,59,197,0,138
D52,Other,2019,0,9,0,9
D52,Other,2019,30,196,0,166
D52,Other,2019,11,41,0,30
D52,Other,2019,55,138,0,83
D52,Other,2019,165,401,0,236
D52,Theft Over $5000,2019,1,10,0,9
D51,Assault,2019,321,559,0,238
D43,Robbery-Other,2019,9,18,0,9
D52,Theft Under $5000,2019,30,213,0,183
D51,Other,2019,160,178,0,18
D51,Assault,2019,4,7,0,3
D43,Sexual Violation,2019,2,5,0,3
D52,Theft Under $5000,2019,14,218,0,204
D51,Other,2019,335,353,0,18
D51,Other,2019,542,574,0,32
D51,Other,2019,4,6,0,2
D51,Other,2019,95,108,0,13
D51,Other,2019,91,95,0,4
D51,Other,2019,5,5,1,0
D51,Other,2019,76,83,0,7
D51,Other Criminal Violations - Offensive Weapons,2019,7,11,0,4
D51,Other Criminal Violations - Offensive Weapons,2019,24,31,0,7
D51,Other Criminal Violations - Offensive Weapons,2019,73,79,0,6
D51,Other Criminal Violations - Offensive Weapons,2019,73,81,0,8
D51,Other Criminal Violations - Offensive Weapons,2019,2,2,1,0
D51,Other Criminal Violations - Offensive Weapons,2019,25,28,0,3
D51,Other Criminal Violations - Offensive Weapons,2019,10,11,0,1
D51,Other Criminal Violations - Offensive Weapons,2019,1,1,1,0
D51,Other Criminal Violations - Offensive Weapons,2019,12,14,0,2
D51,Other,2019,1,1,1,0
D51,Other,2019,1,1,1,0
D51,Other,2019,8,8,1,0
D51,Other,2019,14,14,1,0
D51,Other,2019,0,1,0,1
D51,Other,2019,1,1,1,0
D52,Other,2019,42,46,0,4
D52,Other,2019,4,4,1,0
D52,Other,2019,4,4,1,0
D52,Other,2019,8,9,0,1
D52,Other,2019,27,29,0,2
D52,Other,2019,11,12,0,1
D52,Other,2019,9,9,1,0
D52,Other,2019,39,41,0,2
D52,Auto Theft,2019,7,13,0,6
D52,Auto Theft,2019,0,2,0,2
D52,Auto Theft,2019,1,4,0,3
D52,Auto Theft,2019,1,7,0,6
D52,Auto Theft,2019,8,18,0,10
D51,Assault,2019,124,209,0,85
D43,Sexual Violation,2019,12,16,0,4
D51,Assault,2019,90,154,0,64
D43,Sexual Violation,2019,6,9,0,3
D51,Assault,2019,18,44,0,26
D43,Sexual Violation,2019,8,11,0,3
D43,Sexual Violation,2019,13,16,0,3
D43,Sexual Violation,2019,13,19,0,6
D43,Sexual Violation,2019,4,8,0,4
D43,Sexual Violation,2019,9,16,0,7
D43,Sexual Violation,2019,5,13,0,8
D43,Sexual Violation,2019,3,4,0,1
D43,Sexual Violation,2019,12,16,0,4
D43,Sexual Violation,2019,24,35,0,11
D43,Sexual Violation,2019,10,20,0,10
D43,Other,2019,8,8,1,0
D43,Other,2019,5,5,1,0
D43,Other,2019,4,4,1,0
D43,Other,2019,8,9,0,1
D43,Other,2019,15,15,1,0
D43,Other,2019,31,32,0,1
D43,Other,2019,3,3,1,0
D43,Other,2019,11,11,1,0
D43,Other,2019,8,9,0,1
D43,Other,2019,1,2,0,1
D43,Other,2019,8,8,1,0
D43,Other,2019,23,25,0,2
D43,Other,2019,2,2,1,0
D43,Other,2019,18,19,0,1
D43,Other,2019,6,7,0,1
D43,Other,2019,83,91,0,8
D43,Other,2019,21,23,0,2
D43,Other,2019,50,51,0,1
D43,Other,2019,83,88,0,5
D43,Other,2019,121,134,0,13
D43,Other,2019,11,12,0,1
D52,Theft Under $5000,2019,89,556,0,467
D51,Assault,2019,84,139,0,55
D51,Assault,2019,0,1,0,1
D51,Attempt Murder,2019,1,1,1,0
D51,Attempt Murder,2019,1,1,1,0
D51,Attempt Murder,2019,5,5,1,0
D51,Attempt Murder,2019,6,6,1,0
D51,Attempt Murder,2019,3,4,0,1
D51,Other,2019,7,16,0,9
D51,Other,2019,11,34,0,23
D51,Other,2019,30,65,0,35
D51,Other,2019,47,66,0,19
D51,Other,2019,3,3,1,0
D51,Other,2019,18,31,0,13
D51,Other,2019,11,22,0,11
D52,Theft Under $5000,2019,1394,3471,0,2077
D51,Other,2019,2,6,0,4
D52,Assault,2019,86,142,0,56
D51,Other,2019,10,32,0,22
D52,Assault,2019,14,22,0,8
D51,Robbery-Financial,2019,1,1,1,0
D52,Assault,2019,32,72,0,40
D51,Robbery-Other,2019,6,17,0,11
D52,Assault,2019,52,79,0,27
D51,Robbery-Other,2019,13,38,0,25
D52,Assault,2019,81,159,0,78
D51,Robbery-Other,2019,0,1,0,1
D52,Assault,2019,2,3,0,1
D51,Robbery-Other,2019,37,95,0,58
D52,Assault,2019,70,116,0,46
D51,Robbery-Other,2019,40,114,0,74
D52,Assault,2019,31,52,0,21
D51,Robbery-Other,2019,8,27,0,19
D52,Assault,2019,109,198,0,89
D51,Robbery-Other,2019,8,14,0,6
D52,Assault,2019,407,618,0,211
D51,Robbery-Other,2019,2,4,0,2
D52,Attempt Murder,2019,2,2,1,0
D51,Robbery-Other,2019,6,18,0,12
D52,Attempt Murder,2019,2,4,0,2
D51,Sexual Violation,2019,5,14,0,9
D52,Other,2019,14,29,0,15
D51,Sexual Violation,2019,14,35,0,21
D52,Other,2019,3,4,0,1
D51,Sexual Violation,2019,38,73,0,35
D52,Other,2019,5,7,0,2
D51,Sexual Violation,2019,26,63,0,37
D52,Other,2019,12,20,0,8
D52,Other,2019,18,36,0,18
D52,Other,2019,1,1,1,0
D52,Other,2019,7,18,0,11
D52,Other,2019,9,13,0,4
D52,Other,2019,15,38,0,23
D52,Other,2019,57,94,0,37
D52,Robbery-Financial,2019,3,3,1,0
D52,Robbery-Financial,2019,4,4,1,0
D52,Robbery-Other,2019,14,26,0,12
D52,Robbery-Other,2019,1,6,0,5
D52,Robbery-Other,2019,3,9,0,6
D52,Robbery-Other,2019,3,10,0,7
D52,Robbery-Other,2019,11,17,0,6
D52,Robbery-Other,2019,1,1,1,0
D52,Robbery-Other,2019,5,11,0,6
D52,Robbery-Other,2019,1,2,0,1
D52,Robbery-Other,2019,7,25,0,18
D43,Other,2019,15,23,0,8
D43,Other,2019,46,47,0,1
D43,Other,2019,7,7,1,0
D43,Other,2019,108,116,0,8
D43,Other,2019,353,374,0,21
D43,Other,2019,9,10,0,1
D43,Other,2019,116,127,0,11
D43,Other Criminal Violations - Offensive Weapons,2019,4,4,1,0
D43,Other Criminal Violations - Offensive Weapons,2019,21,23,0,2
D43,Other Criminal Violations - Offensive Weapons,2019,2,2,1,0
D43,Other Criminal Violations - Offensive Weapons,2019,12,13,0,1
D43,Other Criminal Violations - Offensive Weapons,2019,12,13,0,1
D43,Other Criminal Violations - Offensive Weapons,2019,19,22,0,3
D43,Other Criminal Violations - Offensive Weapons,2019,1,3,0,2
D43,Other Criminal Violations - Offensive Weapons,2019,3,3,1,0
D43,Other Criminal Violations - Offensive Weapons,2019,17,18,0,1
D43,Other Criminal Violations - Offensive Weapons,2019,16,16,1,0
D43,Other Criminal Violations - Offensive Weapons,2019,37,39,0,2
D43,Other Criminal Violations - Offensive Weapons,2019,2,2,1,0
D43,Other Criminal Violations - Offensive Weapons,2019,13,16,0,3
D43,Other,2019,2,2,1,0
D43,Other,2019,1,1,1,0
D43,Other,2019,1,1,1,0
D43,Other,2019,1,1,1,0
D43,Other,2019,4,4,1,0
D43,Other,2019,1,1,1,0
D43,Other,2019,1,1,1,0
D51,Other,2019,9,9,1,0
D51,Other,2019,38,38,1,0
D51,Other,2019,69,70,0,1
D51,Other,2019,139,147,0,8
D51,Other,2019,3,3,1,0
D51,Other,2019,19,19,1,0
D51,Other,2019,11,11,1,0
D51,Other,2019,6,6,1,0
D51,Other,2019,10,10,1,0
D51,Auto Theft,2019,5,23,0,18
D51,Auto Theft,2019,9,18,0,9
D51,Auto Theft,2019,8,39,0,31
D51,Auto Theft,2019,12,43,0,31
D51,Auto Theft,2019,0,2,0,2
D51,Auto Theft,2019,2,20,0,18
D51,Auto Theft,2019,4,23,0,19
D51,Auto Theft,2019,2,12,0,10
D51,Auto Theft,2019,3,20,0,17
D51,Break & Enter-Apartment,2019,5,29,0,24
D51,Break & Enter-Apartment,2019,15,62,0,47
D51,Break & Enter-Apartment,2019,17,55,0,38
D51,Break & Enter-Apartment,2019,29,98,0,69
D51,Break & Enter-Apartment,2019,14,52,0,38
D53,Theft Under $5000,2019,86,327,0,241
D53,Theft Under $5000,2019,25,165,0,140
D53,Assault,2019,102,170,0,68
D53,Assault,2019,2,2,1,0
D53,Assault,2019,2,2,1,0
D53,Assault,2019,8,23,0,15
D53,Assault,2019,17,21,0,4
D53,Assault,2019,0,3,0,3
D53,Assault,2019,0,2,0,2
D53,Assault,2019,9,16,0,7
D53,Assault,2019,3,6,0,3
D53,Assault,2019,16,24,0,8
D53,Assault,2019,21,29,0,8
D53,Assault,2019,30,51,0,21
D53,Assault,2019,0,3,0,3
D53,Assault,2019,1,2,0,1
D53,Assault,2019,36,64,0,28
D53,Assault,2019,64,122,0,58
D53,Assault,2019,39,64,0,25
D53,Assault,2019,52,95,0,43
D53,Other,2019,81,90,0,9
D53,Assault,2019,1,1,1,0
D53,Assault,2019,49,85,0,36
D53,Assault,2019,19,31,0,12
D53,Other,2019,25,31,0,6
D53,Other,2019,23,39,0,16
D53,Other,2019,36,43,0,7
D53,Other,2019,2,6,0,4
D53,Other,2019,68,72,0,4
D53,Fraud,2019,1,56,0,55
D53,Other,2019,2,4,0,2
D53,Other,2019,9,12,0,3
D53,Other,2019,0,3,0,3
D53,Other,2019,25,116,0,91
D53,Other,2019,6,7,0,1
D55,Auto Theft,2019,1,1,1,0
D53,Other Criminal Violations - Offensive Weapons,2019,9,13,0,4
D53,Other Criminal Violations - Offensive Weapons,2019,1,1,1,0
D53,Other Criminal Violations - Offensive Weapons,2019,1,2,0,1
D53,Other Criminal Violations - Offensive Weapons,2019,2,2,1,0
D53,Other Criminal Violations - Offensive Weapons,2019,1,1,1,0
D53,Other Criminal Violations - Offensive Weapons,2019,2,5,0,3
D53,Other Criminal Violations - Offensive Weapons,2019,4,5,0,1
D53,Other Criminal Violations - Offensive Weapons,2019,11,12,0,1
D53,Other Criminal Violations - Offensive Weapons,2019,3,4,0,1
D53,Other Criminal Violations - Offensive Weapons,2019,8,9,0,1
D53,Other Criminal Violations - Offensive Weapons,2019,6,7,0,1
D53,Other Criminal Violations - Offensive Weapons,2019,2,4,0,2
D53,Other,2019,0,1,0,1
D53,Other,2019,1,1,1,0
D53,Other,2019,1,1,1,0
D53,Other,2019,1,1,1,0
D53,Other,2019,1,1,1,0
D53,Other,2019,1,1,1,0
D55,Other,2019,8,8,1,0
D55,Other,2019,1,1,1,0
D55,Other,2019,4,4,1,0
D55,Other,2019,4,5,0,1
D55,Other,2019,10,10,1,0
D55,Other,2019,7,8,0,1
D55,Other,2019,7,7,1,0
D55,Other,2019,5,5,1,0
D55,Other,2019,5,5,1,0
D55,Other,2019,6,6,1,0
D55,Other,2019,3,5,0,2
D55,Other,2019,24,27,0,3
D55,Other,2019,10,10,1,0
D55,Other,2019,4,5,0,1
D55,Other,2019,14,14,1,0
D55,Other,2019,5,5,1,0
D55,Other,2019,4,4,1,0
D55,Auto Theft,2019,0,9,0,9
D55,Auto Theft,2019,0,3,0,3
D55,Auto Theft,2019,0,1,0,1
D55,Auto Theft,2019,0,8,0,8
D55,Auto Theft,2019,0,13,0,13
D55,Auto Theft,2019,1,22,0,21
D55,Auto Theft,2019,0,8,0,8
D55,Auto Theft,2019,3,29,0,26
D55,Auto Theft,2019,2,21,0,19
D55,Auto Theft,2019,7,29,0,22
D53,Break & Enter-Commercial,2019,2,14,0,12
D53,Break & Enter-House,2019,6,23,0,17
D53,Other,2019,6,8,0,2
D53,Break & Enter-House,2019,3,13,0,10
D52,Robbery-Other,2019,23,46,0,23
D53,Other,2019,0,1,0,1
D53,Other,2019,4,4,1,0
D53,Break & Enter-House,2019,3,16,0,13
D53,Other,2019,5,13,0,8
D52,Sexual Violation,2019,13,25,0,12
D55,Auto Theft,2019,0,4,0,4
D53,Other,2019,10,11,0,1
D53,Robbery-Other,2019,1,5,0,4
D53,Break & Enter-House,2019,1,9,0,8
D53,Other,2019,3,9,0,6
D53,Other,2019,3,8,0,5
D52,Sexual Violation,2019,0,1,0,1
D55,Auto Theft,2019,2,9,0,7
D53,Other,2019,1,1,1,0
D53,Robbery-Other,2019,3,10,0,7
D53,Break & Enter-House,2019,0,1,0,1
D53,Other,2019,3,10,0,7
D53,Other,2019,3,9,0,6
D52,Sexual Violation,2019,3,6,0,3
D55,Auto Theft,2019,1,27,0,26
D53,Auto Theft,2019,1,11,0,10
D53,Robbery-Other,2019,1,1,1,0
D53,Break & Enter-House,2019,1,10,0,9
D53,Other,2019,6,11,0,5
D53,Other,2019,4,15,0,11
D52,Sexual Violation,2019,6,12,0,6
D55,Auto Theft,2019,2,11,0,9
D53,Auto Theft,2019,1,16,0,15
D53,Robbery-Other,2019,4,10,0,6
D53,Break & Enter-House,2019,2,33,0,31
D53,Other,2019,3,14,0,11
D53,Other,2019,1,3,0,2
D52,Sexual Violation,2019,24,43,0,19
D55,Auto Theft,2019,6,23,0,17
D53,Auto Theft,2019,2,7,0,5
D53,Robbery-Other,2019,2,2,1,0
D53,Break & Enter-House,2019,1,17,0,16
D53,Other,2019,1,4,0,3
D53,Other,2019,7,12,0,5
D52,Sexual Violation,2019,2,3,0,1
D55,Auto Theft,2019,1,6,0,5
D53,Sexual Violation,2019,8,31,0,23
D53,Auto Theft,2019,0,3,0,3
D53,Sexual Violation,2019,0,1,0,1
D53,Break & Enter-House,2019,2,10,0,8
D53,Other,2019,2,11,0,9
D55,Auto Theft,2019,1,8,0,7
D53,Other,2019,10,17,0,7
D53,Break & Enter-House,2019,0,1,0,1
D53,Auto Theft,2019,2,15,0,13
D53,Other,2019,8,31,0,23
D53,Sexual Violation,2019,0,2,0,2
D52,Sexual Violation,2019,14,26,0,12
D53,Other,2019,5,43,0,38
D55,Auto Theft,2019,1,8,0,7
D53,Sexual Violation,2019,0,2,0,2
D53,Other,2019,8,23,0,15
D53,Auto Theft,2019,0,6,0,6
D53,Break & Enter-House,2019,5,35,0,30
D52,Sexual Violation,2019,3,8,0,5
D53,Other,2019,9,48,0,39
D55,Break & Enter-Apartment,2019,1,7,0,6
D53,Sexual Violation,2019,3,4,0,1
D53,Other,2019,4,6,0,2
D53,Auto Theft,2019,3,27,0,24
D53,Break & Enter-House,2019,0,5,0,5
D52,Sexual Violation,2019,6,26,0,20
D53,Other,2019,1,2,0,1
D55,Break & Enter-Apartment,2019,0,11,0,11
D53,Sexual Violation,2019,4,5,0,1
D53,Robbery-Financial,2019,1,1,1,0
D53,Auto Theft,2019,3,31,0,28
D53,Break & Enter-House,2019,0,1,0,1
D52,Sexual Violation,2019,23,52,0,29
D53,Other,2019,7,37,0,30
D55,Break & Enter-Apartment,2019,0,5,0,5
D53,Sexual Violation,2019,1,4,0,3
D53,Robbery-Other,2019,10,24,0,14
D53,Auto Theft,2019,2,17,0,15
D53,Break & Enter-House,2019,3,8,0,5
D52,Other,2019,4,4,1,0
D53,Other,2019,13,87,0,74
D55,Break & Enter-Apartment,2019,1,5,0,4
D53,Sexual Violation,2019,1,4,0,3
D53,Robbery-Other,2019,1,1,1,0
D53,Auto Theft,2019,0,1,0,1
D53,Break & Enter-House,2019,0,2,0,2
D53,Break & Enter-Other,2019,2,6,0,4
D53,Break & Enter-Other,2019,2,2,1,0
D53,Break & Enter-Other,2019,0,2,0,2
D53,Break & Enter-Other,2019,0,1,0,1
D53,Break & Enter-Other,2019,1,2,0,1
D53,Break & Enter-Other,2019,1,1,1,0
D53,Break & Enter-Other,2019,0,5,0,5
D53,Break & Enter-Other,2019,0,2,0,2
D53,Break & Enter-Other,2019,2,4,0,2
D53,Break & Enter-Other,2019,0,2,0,2
D53,Break & Enter-Other,2019,2,6,0,4
D53,Break & Enter-Other,2019,1,4,0,3
D53,Break & Enter-Other,2019,0,2,0,2
D53,Break & Enter-Other,2019,1,3,0,2
D53,Break & Enter-Other,2019,0,1,0,1
D53,Fraud,2019,22,200,0,178
D53,Fraud,2019,0,2,0,2
D53,Fraud,2019,0,10,0,10
D53,Fraud,2019,0,20,0,20
D53,Fraud,2019,1,30,0,29
D53,Fraud,2019,0,9,0,9
D53,Fraud,2019,1,14,0,13
D53,Fraud,2019,2,11,0,9
D53,Fraud,2019,5,40,0,35
D53,Fraud,2019,1,54,0,53
D53,Fraud,2019,2,48,0,46
D53,Fraud,2019,1,3,0,2
D53,Fraud,2019,0,1,0,1
D53,Fraud,2019,4,60,0,56
D53,Fraud,2019,15,144,0,129
D53,Fraud,2019,5,87,0,82
D53,Fraud,2019,5,64,0,59
D53,Fraud,2019,0,2,0,2
D53,Fraud,2019,9,98,0,89
D53,Robbery-Other,2019,0,2,0,2
D53,Other,2019,15,54,0,39
D53,Sexual Violation,2019,3,7,0,4
D53,Auto Theft,2019,0,4,0,4
D55,Break & Enter-Apartment,2019,9,25,0,16
D53,Robbery-Other,2019,0,1,0,1
D53,Other,2019,19,57,0,38
D52,Other,2019,2,2,1,0
D53,Sexual Violation,2019,0,1,0,1
D53,Auto Theft,2019,3,34,0,31
D55,Break & Enter-Apartment,2019,7,15,0,8
D55,Break & Enter-Apartment,2019,4,9,0,5
D55,Break & Enter-Apartment,2019,1,2,0,1
D55,Break & Enter-Apartment,2019,3,6,0,3
D55,Break & Enter-Apartment,2019,0,26,0,26
D55,Break & Enter-Apartment,2019,0,2,0,2
D55,Break & Enter-Apartment,2019,4,7,0,3
D55,Break & Enter-Apartment,2019,9,23,0,14
D55,Break & Enter-Apartment,2019,7,47,0,40
D55,Break & Enter-Apartment,2019,2,9,0,7
D55,Break & Enter-Apartment,2019,4,10,0,6
D55,Break & Enter-Apartment,2019,1,6,0,5
D55,Break & Enter-Apartment,2019,0,1,0,1
D55,Break & Enter-Commercial,2019,1,2,0,1
D55,Break & Enter-Commercial,2019,2,4,0,2
D55,Break & Enter-Commercial,2019,4,20,0,16
D55,Break & Enter-Commercial,2019,1,8,0,7
D55,Break & Enter-Commercial,2019,2,23,0,21
D55,Break & Enter-Commercial,2019,0,1,0,1
D55,Break & Enter-Commercial,2019,5,20,0,15
D55,Break & Enter-Commercial,2019,2,14,0,12
D55,Break & Enter-Commercial,2019,14,23,0,9
D55,Break & Enter-Commercial,2019,0,6,0,6
D55,Break & Enter-Commercial,2019,4,13,0,9
D55,Break & Enter-Commercial,2019,6,63,0,57
D55,Break & Enter-Commercial,2019,3,11,0,8
D55,Break & Enter-Commercial,2019,5,24,0,19
D55,Break & Enter-Commercial,2019,7,13,0,6
D55,Break & Enter-Commercial,2019,1,5,0,4
D55,Break & Enter-Commercial,2019,0,1,0,1
D55,Break & Enter-House,2019,3,9,0,6
D55,Break & Enter-House,2019,2,9,0,7
D55,Break & Enter-House,2019,2,14,0,12
D55,Break & Enter-House,2019,2,10,0,8
D55,Break & Enter-House,2019,3,12,0,9
D55,Break & Enter-House,2019,7,16,0,9
D53,Auto Theft,2019,1,8,0,7
D53,Other,2019,2,4,0,2
D53,Robbery-Other,2019,5,14,0,9
D53,Sexual Violation,2019,2,8,0,6
D52,Other,2019,3,3,1,0
D53,Other,2019,10,57,0,47
D53,Robbery-Other,2019,0,4,0,4
D53,Sexual Violation,2019,8,20,0,12
D53,Other,2019,6,24,0,18
D53,Auto Theft,2019,4,17,0,13
D53,Sexual Violation,2019,3,12,0,9
D53,Robbery-Other,2019,1,11,0,10
D52,Other,2019,20,21,0,1
D53,Sexual Violation,2019,12,17,0,5
D53,Theft Over $5000,2019,5,33,0,28
D53,Robbery-Other,2019,0,1,0,1
D53,Auto Theft,2019,2,13,0,11
D52,Other,2019,6,7,0,1
D53,Sexual Violation,2019,0,1,0,1
D53,Theft Over $5000,2019,1,3,0,2
D53,Robbery-Other,2019,7,10,0,3
D53,Auto Theft,2019,2,7,0,5
D52,Other,2019,10,10,1,0
D53,Sexual Violation,2019,6,12,0,6
D53,Theft Over $5000,2019,0,1,0,1
D53,Robbery-Other,2019,1,1,1,0
D53,Break & Enter-Apartment,2019,12,51,0,39
D52,Other,2019,13,14,0,1
D53,Sexual Violation,2019,1,8,0,7
D53,Theft Over $5000,2019,0,1,0,1
D53,Robbery-Other,2019,3,19,0,16
D53,Break & Enter-Apartment,2019,0,1,0,1
D52,Other,2019,18,20,0,2
D53,Other,2019,6,7,0,1
D53,Theft Over $5000,2019,0,8,0,8
D53,Robbery-Other,2019,8,17,0,9
D53,Break & Enter-Apartment,2019,2,11,0,9
D52,Other,2019,120,755,0,635
D53,Other,2019,1,1,1,0
D53,Theft Over $5000,2019,0,7,0,7
D53,Break & Enter-Apartment,2019,0,10,0,10
D52,Other,2019,15,15,1,0
D53,Other,2019,1,1,1,0
D53,Theft Over $5000,2019,0,3,0,3
D53,Break & Enter-Apartment,2019,0,2,0,2
D52,Other,2019,41,45,0,4
D53,Other,2019,3,3,1,0
D53,Theft Over $5000,2019,0,4,0,4
D53,Break & Enter-Apartment,2019,0,2,0,2
D52,Other,2019,38,47,0,9
D53,Other,2019,6,6,1,0
D53,Theft Over $5000,2019,3,14,0,11
D53,Theft Over $5000,2019,0,3,0,3
D53,Theft Over $5000,2019,2,5,0,3
D53,Theft Over $5000,2019,1,9,0,8
D53,Theft Over $5000,2019,1,6,0,5
D53,Theft Under $5000,2019,163,762,0,599
D53,Theft Under $5000,2019,0,5,0,5
D53,Theft Under $5000,2019,0,35,0,35
D53,Theft Under $5000,2019,2,28,0,26
D53,Theft Under $5000,2019,7,40,0,33
D53,Theft Under $5000,2019,1,16,0,15
D53,Theft Under $5000,2019,2,23,0,21
D53,Theft Under $5000,2019,1,14,0,13
D53,Theft Under $5000,2019,3,96,0,93
D53,Theft Under $5000,2019,6,107,0,101
D53,Theft Under $5000,2019,58,214,0,156
D53,Theft Under $5000,2019,1,3,0,2
D53,Theft Under $5000,2019,21,121,0,100
D53,Theft Under $5000,2019,158,588,0,430
D53,Theft Under $5000,2019,25,233,0,208
D53,Theft Under $5000,2019,146,335,0,189
D53,Theft Under $5000,2019,1,7,0,6
D53,Break & Enter-Apartment,2019,1,7,0,6
D53,Other,2019,2,2,1,0
D53,Break & Enter-Apartment,2019,1,21,0,20
D53,Other,2019,1,1,1,0
D53,Break & Enter-Apartment,2019,0,1,0,1
D53,Other,2019,1,1,1,0
D53,Break & Enter-Apartment,2019,2,27,0,25
D53,Other,2019,4,4,1,0
D53,Break & Enter-Apartment,2019,3,22,0,19
D53,Other,2019,3,3,1,0
D53,Break & Enter-Apartment,2019,13,61,0,48
D53,Other,2019,10,11,0,1
D53,Break & Enter-Apartment,2019,1,11,0,10
D53,Other,2019,1,1,1,0
D53,Break & Enter-Apartment,2019,0,5,0,5
D53,Other,2019,1,1,1,0
D53,Break & Enter-Apartment,2019,1,11,0,10
D53,Other,2019,6,6,1,0
D53,Break & Enter-Commercial,2019,17,71,0,54
D53,Other,2019,78,90,0,12
D53,Break & Enter-Commercial,2019,1,2,0,1
D53,Other,2019,3,3,1,0
D53,Break & Enter-Commercial,2019,0,1,0,1
D53,Other,2019,4,5,0,1
D53,Break & Enter-Commercial,2019,0,4,0,4
D52,Other,2019,209,227,0,18
D53,Other,2019,4,6,0,2
D52,Other,2019,18,18,1,0
D53,Other,2019,6,9,0,3
D52,Other,2019,55,60,0,5
D53,Break & Enter-Commercial,2019,1,2,0,1
D53,Other,2019,1,1,1,0
D52,Other,2019,32,39,0,7
D53,Break & Enter-Commercial,2019,0,1,0,1
D53,Other,2019,7,9,0,2
D52,Other,2019,87,95,0,8
D53,Break & Enter-Commercial,2019,4,17,0,13
D53,Other,2019,1,2,0,1
D52,Other,2019,1186,1247,0,61
D53,Break & Enter-Commercial,2019,1,19,0,18
D53,Other,2019,5,8,0,3
D52,Other Criminal Violations - Offensive Weapons,2019,19,19,1,0
D53,Break & Enter-Commercial,2019,5,15,0,10
D53,Other,2019,9,19,0,10
D52,Other Criminal Violations - Offensive Weapons,2019,5,5,1,0
D53,Break & Enter-Commercial,2019,0,2,0,2
D53,Other,2019,23,29,0,6
D52,Other Criminal Violations - Offensive Weapons,2019,15,15,1,0
D53,Break & Enter-Commercial,2019,1,6,0,5
D53,Other,2019,1,2,0,1
D52,Other Criminal Violations - Offensive Weapons,2019,7,9,0,2
D53,Break & Enter-Commercial,2019,8,38,0,30
D53,Other,2019,2,2,1,0
D52,Other Criminal Violations - Offensive Weapons,2019,17,17,1,0
D53,Break & Enter-Commercial,2019,2,13,0,11
D53,Other,2019,17,19,0,2
D52,Other Criminal Violations - Offensive Weapons,2019,6,6,1,0
D53,Break & Enter-Commercial,2019,2,14,0,12
D52,Other Criminal Violations - Offensive Weapons,2019,2,3,0,1
D53,Break & Enter-Commercial,2019,6,25,0,19
D52,Other Criminal Violations - Offensive Weapons,2019,24,26,0,2
D52,Other Criminal Violations - Offensive Weapons,2019,67,71,0,4
D52,Other,2019,5,14,0,9
D52,Other,2019,0,3,0,3
D52,Other,2019,3,3,1,0
D52,Other,2019,1,1,1,0
D52,Other,2019,3,3,1,0
D52,Other,2019,5,5,1,0
D53,Other,2019,8,8,1,0
D53,Other,2019,2,2,1,0
D53,Other,2019,3,3,1,0
D53,Other,2019,1,1,1,0
D53,Other,2019,1,1,1,0
D53,Other,2019,6,6,1,0
D11,Fraud,2020,0,11,0,11
D11,Fraud,2020,2,9,0,7
D11,Fraud,2020,3,69,0,66
D11,Fraud,2020,0,28,0,28
D11,Fraud,2020,0,23,0,23
D11,Other,2020,6,59,0,53
D11,Other,2020,23,88,0,65
D11,Other,2020,23,84,0,61
D11,Other,2020,20,74,0,54
D11,Other,2020,26,156,0,130
D11,Other,2020,6,27,0,21
D11,Other,2020,6,25,0,19
D11,Other,2020,1,1,1,0
D11,Other,2020,2,5,0,3
D11,Other,2020,28,78,0,50
D11,Other,2020,12,43,0,31
D11,Other,2020,2,4,0,2
D11,Other,2020,13,33,0,20
D11,Theft Over $5000,2020,0,4,0,4
D11,Theft Over $5000,2020,1,4,0,3
D11,Theft Over $5000,2020,0,9,0,9
D11,Theft Over $5000,2020,0,4,0,4
D11,Theft Over $5000,2020,1,6,0,5
D11,Theft Over $5000,2020,2,2,1,0
D11,Theft Over $5000,2020,0,3,0,3
D11,Theft Over $5000,2020,2,4,0,2
D11,Theft Over $5000,2020,2,3,0,1
D11,Theft Over $5000,2020,0,4,0,4
D11,Theft Under $5000,2020,64,282,0,218
D11,Theft Under $5000,2020,43,294,0,251
D11,Theft Under $5000,2020,17,158,0,141
D11,Theft Under $5000,2020,162,469,0,307
D11,Theft Under $5000,2020,42,317,0,275
D11,Auto Theft,2020,0,7,0,7
D55,Other,2019,31,69,0,38
D11,Theft Under $5000,2020,1,28,0,27
D55,Assault,2019,42,56,0,14
D11,Theft Under $5000,2020,14,59,0,45
D11,Theft Under $5000,2020,0,1,0,1
D11,Theft Under $5000,2020,13,40,0,27
D11,Theft Under $5000,2020,22,245,0,223
D11,Theft Under $5000,2020,34,140,0,106
D11,Theft Under $5000,2020,2,6,0,4
D11,Theft Under $5000,2020,5,42,0,37
D11,Assault,2020,0,1,0,1
D11,Assault,2020,35,51,0,16
D11,Assault,2020,43,76,0,33
D11,Assault,2020,34,64,0,30
D11,Assault,2020,42,73,0,31
D11,Assault,2020,83,124,0,41
D11,Assault,2020,21,25,0,4
D11,Assault,2020,13,26,0,13
D11,Assault,2020,2,2,1,0
D55,Other,2019,5,5,1,0
NSA,Auto Theft,2019,8,49,0,41
D55,Robbery-Other,2019,2,2,1,0
D55,Other,2019,1,1,1,0
D55,Assault,2019,0,1,0,1
D55,Other,2019,15,15,1,0
D11,Break & Enter-Apartment,2020,4,13,0,9
NSA,Break & Enter-Apartment,2019,7,28,0,21
D55,Robbery-Other,2019,0,3,0,3
D55,Other,2019,18,43,0,25
D55,Assault,2019,50,79,0,29
D55,Other,2019,4,4,1,0
D11,Break & Enter-Apartment,2020,0,13,0,13
NSA,Break & Enter-Commercial,2019,13,36,0,23
D55,Robbery-Other,2019,10,18,0,8
D55,Other,2019,12,47,0,35
D55,Assault,2019,65,84,0,19
D55,Other,2019,8,9,0,1
D11,Break & Enter-Apartment,2020,2,14,0,12
NSA,Break & Enter-House,2019,1,17,0,16
D55,Robbery-Other,2019,2,8,0,6
D55,Other,2019,57,194,0,137
D55,Assault,2019,104,170,0,66
D55,Other,2019,1,1,1,0
D11,Break & Enter-Apartment,2020,2,9,0,7
NSA,Break & Enter-Other,2019,3,11,0,8
D55,Robbery-Other,2019,15,24,0,9
D55,Other,2019,18,65,0,47
D55,Assault,2019,83,131,0,48
D55,Other,2019,41,45,0,4
D11,Break & Enter-Apartment,2020,4,26,0,22
NSA,Fraud,2019,22,292,0,270
D55,Robbery-Other,2019,6,12,0,6
D55,Other,2019,22,90,0,68
D55,Other,2019,15,35,0,20
D55,Other,2019,15,55,0,40
D55,Other,2019,3,25,0,22
D55,Theft Over $5000,2019,0,4,0,4
D55,Theft Over $5000,2019,0,1,0,1
D55,Theft Over $5000,2019,0,1,0,1
D55,Theft Over $5000,2019,0,4,0,4
D55,Theft Over $5000,2019,1,8,0,7
D55,Theft Over $5000,2019,2,9,0,7
D55,Theft Over $5000,2019,0,3,0,3
D55,Theft Over $5000,2019,1,5,0,4
D55,Theft Over $5000,2019,1,5,0,4
D55,Theft Over $5000,2019,1,7,0,6
D55,Theft Over $5000,2019,2,3,0,1
D55,Theft Over $5000,2019,2,6,0,4
D55,Theft Over $5000,2019,3,17,0,14
D55,Theft Over $5000,2019,1,3,0,2
D55,Theft Over $5000,2019,4,9,0,5
D55,Theft Over $5000,2019,2,3,0,1
D55,Theft Over $5000,2019,1,3,0,2
D55,Theft Over $5000,2019,0,5,0,5
D55,Theft Under $5000,2019,28,121,0,93
D55,Theft Under $5000,2019,15,80,0,65
D55,Theft Under $5000,2019,1,2,0,1
D55,Theft Under $5000,2019,50,197,0,147
D55,Theft Under $5000,2019,13,140,0,127
D55,Theft Under $5000,2019,123,385,0,262
D55,Theft Under $5000,2019,17,81,0,64
D55,Theft Under $5000,2019,36,266,0,230
D55,Theft Under $5000,2019,1,1,1,0
D55,Theft Under $5000,2019,18,191,0,173
D55,Theft Under $5000,2019,26,124,0,98
D55,Theft Under $5000,2019,0,3,0,3
D55,Theft Under $5000,2019,50,180,0,130
D55,Theft Under $5000,2019,85,316,0,231
D55,Theft Under $5000,2019,292,844,0,552
D55,Theft Under $5000,2019,42,146,0,104
D55,Theft Under $5000,2019,109,390,0,281
D55,Theft Under $5000,2019,12,57,0,45
D55,Theft Under $5000,2019,96,380,0,284
D55,Theft Under $5000,2019,5,65,0,60
D55,Assault,2019,0,2,0,2
D55,Assault,2019,37,65,0,28
D55,Assault,2019,80,116,0,36
D55,Assault,2019,1,2,0,1
D55,Assault,2019,39,68,0,29
D55,Assault,2019,97,135,0,38
D55,Assault,2019,4,5,0,1
D11,Break & Enter-Apartment,2020,0,2,0,2
D55,Assault,2019,30,41,0,11
D55,Robbery-Other,2019,5,9,0,4
D55,Assault,2019,36,68,0,32
NSA,Fraud,2019,0,1,0,1
D11,Break & Enter-Apartment,2020,0,3,0,3
D55,Other,2019,17,19,0,2
D55,Assault,2019,1,1,1,0
D55,Robbery-Other,2019,5,15,0,10
NSA,Other,2019,86,277,0,191
D11,Break & Enter-Apartment,2020,0,1,0,1
D55,Other,2019,1,1,1,0
D55,Assault,2019,125,187,0,62
D55,Robbery-Other,2019,5,11,0,6
NSA,Theft Over $5000,2019,5,26,0,21
D11,Break & Enter-Apartment,2020,7,21,0,14
D55,Other,2019,53,64,0,11
D55,Assault,2019,73,101,0,28
D55,Robbery-Other,2019,0,1,0,1
NSA,Theft Under $5000,2019,106,472,0,366
D11,Break & Enter-Apartment,2020,1,2,0,1
D55,Other,2019,24,27,0,3
D55,Assault,2019,42,76,0,34
D55,Robbery-Other,2019,3,9,0,6
NSA,Theft Under $5000,2019,0,2,0,2
NSA,Assault,2019,0,1,0,1
NSA,Assault,2019,0,1,0,1
NSA,Assault,2019,159,381,0,222
NSA,Attempt Murder,2019,2,3,0,1
NSA,Other,2019,38,83,0,45
NSA,Robbery-Financial,2019,28,29,0,1
NSA,Robbery-Other,2019,0,1,0,1
NSA,Robbery-Other,2019,1,1,1,0
NSA,Robbery-Other,2019,77,137,0,60
NSA,Sexual Violation,2019,0,1,0,1
NSA,Sexual Violation,2019,38,163,0,125
NSA,Other,2019,89,95,0,6
NSA,Other,2019,332,357,0,25
NSA,Other Criminal Violations - Offensive Weapons,2019,46,51,0,5
NSA,Other,2019,0,1,0,1
NSA,Other,2019,8,13,0,5
D11,Other,2020,6,6,1,0
D11,Other,2020,4,5,0,1
D11,Other,2020,7,8,0,1
D11,Other,2020,6,8,0,2
D11,Other,2020,11,12,0,1
D11,Other,2020,3,3,1,0
D11,Other,2020,1,2,0,1
D11,Other,2020,1,1,1,0
D11,Other,2020,17,19,0,2
D11,Other,2020,1,1,1,0
D11,Other,2020,0,1,0,1
D11,Other,2020,3,4,0,1
D11,Auto Theft,2020,2,8,0,6
D11,Auto Theft,2020,3,18,0,15
D11,Auto Theft,2020,1,44,0,43
D11,Auto Theft,2020,4,29,0,25
D11,Auto Theft,2020,1,29,0,28
D11,Auto Theft,2020,1,11,0,10
D11,Auto Theft,2020,3,11,0,8
D11,Auto Theft,2020,0,4,0,4
D11,Auto Theft,2020,0,16,0,16
D11,Auto Theft,2020,1,17,0,16
D11,Auto Theft,2020,0,2,0,2
D11,Break & Enter-Apartment,2020,1,6,0,5
D55,Other,2019,94,101,0,7
D55,Assault,2019,31,51,0,20
D11,Break & Enter-Commercial,2020,8,15,0,7
D55,Robbery-Other,2019,2,7,0,5
D55,Other,2019,47,54,0,7
D11,Break & Enter-Commercial,2020,2,5,0,3
D55,Robbery-Other,2019,19,27,0,8
D55,Other,2019,55,68,0,13
D55,Robbery-Other,2019,2,11,0,9
D55,Assault,2019,63,94,0,31
D11,Break & Enter-Commercial,2020,2,16,0,14
D55,Other,2019,1,2,0,1
D55,Robbery-Other,2019,4,13,0,9
D55,Assault,2019,23,31,0,8
D11,Break & Enter-Commercial,2020,2,20,0,18
D55,Other,2019,27,33,0,6
D55,Robbery-Other,2019,7,9,0,2
D55,Attempt Murder,2019,2,2,1,0
D11,Break & Enter-Commercial,2020,4,36,0,32
D55,Other,2019,63,73,0,10
D55,Robbery-Other,2019,4,11,0,7
D55,Attempt Murder,2019,1,1,1,0
D11,Break & Enter-Commercial,2020,1,3,0,2
D55,Other,2019,22,22,1,0
D55,Robbery-Other,2019,1,3,0,2
D55,Attempt Murder,2019,2,2,1,0
D11,Break & Enter-Commercial,2020,3,9,0,6
D55,Other,2019,37,42,0,5
D55,Sexual Violation,2019,3,12,0,9
D55,Attempt Murder,2019,0,1,0,1
D11,Break & Enter-Commercial,2020,1,1,1,0
D55,Other,2019,129,153,0,24
D55,Sexual Violation,2019,2,6,0,4
D55,Attempt Murder,2019,3,3,1,0
D11,Break & Enter-Commercial,2020,11,27,0,16
D55,Other,2019,63,66,0,3
D55,Sexual Violation,2019,3,7,0,4
D55,Attempt Murder,2019,1,1,1,0
D11,Break & Enter-Commercial,2020,3,15,0,12
D55,Other,2019,50,55,0,5
D55,Sexual Violation,2019,4,9,0,5
D55,Attempt Murder,2019,1,1,1,0
D11,Break & Enter-Commercial,2020,1,4,0,3
D55,Other,2019,32,34,0,2
D55,Sexual Violation,2019,14,23,0,9
D55,Other,2019,8,15,0,7
D11,Break & Enter-House,2020,1,6,0,5
D55,Other,2019,139,144,0,5
D55,Sexual Violation,2019,12,21,0,9
D55,Other,2019,7,10,0,3
D11,Break & Enter-House,2020,1,9,0,8
D11,Break & Enter-House,2020,2,9,0,7
D11,Break & Enter-House,2020,3,7,0,4
D11,Break & Enter-House,2020,2,15,0,13
D11,Break & Enter-House,2020,0,8,0,8
D11,Break & Enter-House,2020,2,5,0,3
D11,Break & Enter-House,2020,0,1,0,1
D11,Break & Enter-House,2020,3,16,0,13
D11,Break & Enter-House,2020,2,10,0,8
D11,Break & Enter-House,2020,1,1,1,0
D11,Break & Enter-House,2020,2,5,0,3
D11,Break & Enter-Other,2020,0,3,0,3
D11,Break & Enter-Other,2020,1,5,0,4
D11,Break & Enter-Other,2020,1,10,0,9
D11,Break & Enter-Other,2020,0,1,0,1
D11,Break & Enter-Other,2020,2,7,0,5
D11,Break & Enter-Other,2020,0,1,0,1
D11,Break & Enter-Other,2020,1,4,0,3
D11,Break & Enter-Other,2020,1,2,0,1
D11,Break & Enter-Other,2020,2,4,0,2
D11,Fraud,2020,4,36,0,32
D11,Fraud,2020,1,64,0,63
D11,Fraud,2020,5,58,0,53
D11,Fraud,2020,7,49,0,42
D11,Fraud,2020,7,77,0,70
D11,Fraud,2020,1,22,0,21
D55,Other,2019,23,23,1,0
D55,Sexual Violation,2019,2,7,0,5
D55,Other,2019,12,16,0,4
D55,Other Criminal Violations - Offensive Weapons,2019,6,6,1,0
D55,Sexual Violation,2019,1,2,0,1
D55,Other,2019,19,25,0,6
D55,Other Criminal Violations - Offensive Weapons,2019,3,4,0,1
D55,Sexual Violation,2019,6,15,0,9
D55,Other,2019,22,31,0,9
D55,Other Criminal Violations - Offensive Weapons,2019,9,10,0,1
D55,Sexual Violation,2019,5,12,0,7
D55,Other,2019,7,11,0,4
D55,Other Criminal Violations - Offensive Weapons,2019,8,9,0,1
D55,Sexual Violation,2019,8,9,0,1
D55,Other,2019,11,16,0,5
D55,Other Criminal Violations - Offensive Weapons,2019,9,9,1,0
D55,Sexual Violation,2019,3,6,0,3
D55,Other Criminal Violations - Offensive Weapons,2019,12,12,1,0
D55,Sexual Violation,2019,17,28,0,11
D55,Other Criminal Violations - Offensive Weapons,2019,8,10,0,2
D55,Other,2019,1,1,1,0
D55,Sexual Violation,2019,9,13,0,4
D55,Other Criminal Violations - Offensive Weapons,2019,4,4,1,0
D55,Other,2019,3,11,0,8
D55,Sexual Violation,2019,9,16,0,7
D55,Other Criminal Violations - Offensive Weapons,2019,10,11,0,1
D55,Other,2019,27,40,0,13
D55,Sexual Violation,2019,2,5,0,3
D55,Other Criminal Violations - Offensive Weapons,2019,1,1,1,0
D55,Other,2019,15,18,0,3
D55,Sexual Violation,2019,2,7,0,5
D55,Other Criminal Violations - Offensive Weapons,2019,1,3,0,2
D55,Other,2019,7,13,0,6
D55,Sexual Violation,2019,7,10,0,3
D55,Other Criminal Violations - Offensive Weapons,2019,3,3,1,0
D55,Other,2019,28,46,0,18
D55,Other,2019,4,4,1,0
D55,Other Criminal Violations - Offensive Weapons,2019,20,21,0,1
D55,Other,2019,8,19,0,11
D55,Other,2019,6,6,1,0
D55,Other Criminal Violations - Offensive Weapons,2019,5,5,1,0
D55,Other,2019,13,22,0,9
D55,Other,2019,0,1,0,1
D55,Other Criminal Violations - Offensive Weapons,2019,6,6,1,0
D55,Other,2019,5,6,0,1
D55,Other,2019,4,4,1,0
D55,Other Criminal Violations - Offensive Weapons,2019,5,5,1,0
D55,Other,2019,12,24,0,12
D55,Other,2019,5,5,1,0
D55,Other Criminal Violations - Offensive Weapons,2019,8,11,0,3
D55,Other,2019,6,7,0,1
D55,Other,2019,15,16,0,1
D55,Other Criminal Violations - Offensive Weapons,2019,2,4,0,2
D55,Robbery-Financial,2019,1,1,1,0
D55,Other,2019,3,4,0,1
D55,Other,2019,1,1,1,0
D55,Robbery-Financial,2019,5,6,0,1
D55,Other,2019,8,8,1,0
D55,Other,2019,3,3,1,0
D55,Other,2019,1,1,1,0
D55,Other,2019,0,1,0,1
D55,Other,2019,1,1,1,0
D55,Other,2019,1,1,1,0
D55,Other,2019,1,1,1,0
NSA,Other,2019,83,97,0,14
D55,Robbery-Financial,2019,1,2,0,1
D55,Other,2019,4,4,1,0
D55,Robbery-Other,2019,0,1,0,1
D55,Other,2019,3,3,1,0
D55,Robbery-Other,2019,3,8,0,5
D55,Other,2019,8,9,0,1
D55,Other,2019,18,18,1,0
D55,Other,2019,1,2,0,1
D55,Other,2019,28,28,1,0
D55,Break & Enter-House,2019,1,1,1,0
D55,Break & Enter-House,2019,3,21,0,18
D55,Break & Enter-House,2019,4,7,0,3
D55,Break & Enter-House,2019,1,5,0,4
D55,Break & Enter-House,2019,1,13,0,12
D55,Break & Enter-House,2019,11,40,0,29
D55,Break & Enter-House,2019,2,5,0,3
D55,Break & Enter-House,2019,4,22,0,18
D55,Break & Enter-House,2019,3,18,0,15
D55,Break & Enter-House,2019,2,7,0,5
D55,Break & Enter-Other,2019,0,1,0,1
D55,Break & Enter-Other,2019,1,1,1,0
D55,Break & Enter-Other,2019,0,1,0,1
D55,Break & Enter-Other,2019,0,2,0,2
D55,Break & Enter-Other,2019,0,3,0,3
D55,Break & Enter-Other,2019,0,2,0,2
D55,Break & Enter-Other,2019,1,2,0,1
D55,Break & Enter-Other,2019,0,4,0,4
D55,Break & Enter-Other,2019,0,3,0,3
D55,Break & Enter-Other,2019,1,1,1,0
D55,Break & Enter-Other,2019,0,4,0,4
D55,Break & Enter-Other,2019,0,1,0,1
D55,Fraud,2019,2,26,0,24
D55,Fraud,2019,1,43,0,42
D55,Fraud,2019,3,41,0,38
D55,Fraud,2019,4,44,0,40
D55,Fraud,2019,8,90,0,82
D55,Fraud,2019,8,50,0,42
D55,Fraud,2019,5,53,0,48
D55,Fraud,2019,4,50,0,46
D55,Fraud,2019,6,48,0,42
D55,Fraud,2019,2,19,0,17
D55,Fraud,2019,9,39,0,30
D55,Fraud,2019,17,154,0,137
D55,Fraud,2019,6,59,0,53
D55,Fraud,2019,8,69,0,61
D55,Fraud,2019,1,25,0,24
D55,Fraud,2019,1,37,0,36
D55,Fraud,2019,5,26,0,21
D55,Other,2019,0,1,0,1
D55,Other,2019,16,80,0,64
D55,Other,2019,14,43,0,29
D55,Other,2019,3,3,1,0
D55,Other,2019,21,53,0,32
D55,Other,2019,11,56,0,45
D55,Other,2019,42,145,0,103
D55,Other,2019,21,70,0,49
D55,Other,2019,24,98,0,74
D55,Other,2019,0,1,0,1
D55,Other,2019,8,55,0,47
D11,Assault,2020,1,2,0,1
D11,Assault,2020,58,97,0,39
D11,Assault,2020,16,29,0,13
D11,Assault,2020,9,15,0,6
D11,Assault,2020,40,68,0,28
D11,Attempt Murder,2020,2,2,1,0
D11,Attempt Murder,2020,1,1,1,0
D11,Other,2020,2,10,0,8
D11,Other,2020,11,17,0,6
D11,Other,2020,7,12,0,5
D11,Other,2020,9,12,0,3
D11,Other,2020,15,28,0,13
D11,Other,2020,3,4,0,1
D11,Other,2020,3,3,1,0
D11,Other,2020,4,10,0,6
D11,Other,2020,3,9,0,6
D11,Other,2020,0,1,0,1
D11,Other,2020,11,15,0,4
D11,Robbery-Financial,2020,2,2,1,0
D11,Robbery-Financial,2020,0,2,0,2
D11,Robbery-Other,2020,4,13,0,9
D11,Robbery-Other,2020,3,12,0,9
D11,Robbery-Other,2020,4,8,0,4
D11,Robbery-Other,2020,1,3,0,2
D11,Robbery-Other,2020,6,15,0,9
D11,Robbery-Other,2020,0,1,0,1
D11,Robbery-Other,2020,0,1,0,1
D11,Robbery-Other,2020,0,1,0,1
D12,Fraud,2020,1,26,0,25
D11,Robbery-Other,2020,11,16,0,5
D11,Robbery-Other,2020,2,6,0,4
D11,Robbery-Other,2020,0,4,0,4
D11,Robbery-Other,2020,1,2,0,1
D11,Sexual Violation,2020,7,10,0,3
D11,Sexual Violation,2020,7,11,0,4
D11,Sexual Violation,2020,9,21,0,12
D11,Sexual Violation,2020,2,9,0,7
D11,Sexual Violation,2020,9,13,0,4
D11,Sexual Violation,2020,2,5,0,3
D11,Sexual Violation,2020,0,1,0,1
D11,Sexual Violation,2020,0,1,0,1
D11,Sexual Violation,2020,3,12,0,9
D11,Sexual Violation,2020,1,5,0,4
D11,Sexual Violation,2020,0,1,0,1
D11,Sexual Violation,2020,10,13,0,3
D11,Other,2020,3,4,0,1
D11,Other,2020,1,1,1,0
D11,Other,2020,6,8,0,2
D11,Other,2020,6,6,1,0
D11,Other,2020,12,12,1,0
D11,Other,2020,3,3,1,0
D12,Assault,2020,122,171,0,49
D12,Auto Theft,2020,1,18,0,17
D13,Auto Theft,2020,1,28,0,27
D11,Other,2020,7,7,1,0
D12,Fraud,2020,3,36,0,33
D13,Auto Theft,2020,3,31,0,28
D11,Other,2020,2,2,1,0
D12,Assault,2020,15,22,0,7
D12,Fraud,2020,8,39,0,31
D13,Break & Enter-Apartment,2020,1,15,0,14
D11,Other,2020,8,9,0,1
D12,Attempt Murder,2020,1,1,1,0
D12,Fraud,2020,0,63,0,63
D13,Break & Enter-Apartment,2020,0,1,0,1
D11,Other,2020,6,7,0,1
D12,Attempt Murder,2020,0,1,0,1
D12,Fraud,2020,0,16,0,16
D13,Break & Enter-Apartment,2020,4,8,0,4
D11,Other,2020,1,1,1,0
D12,Attempt Murder,2020,1,1,1,0
D12,Fraud,2020,9,81,0,72
D13,Break & Enter-Apartment,2020,0,3,0,3
D11,Other,2020,27,30,0,3
D12,Attempt Murder,2020,1,2,0,1
D12,Fraud,2020,0,21,0,21
D13,Break & Enter-Apartment,2020,1,4,0,3
D12,Other,2020,36,39,0,3
D13,Fraud,2020,1,17,0,16
D11,Other,2020,45,51,0,6
D11,Other,2020,33,39,0,6
D11,Other,2020,86,96,0,10
D11,Other,2020,82,87,0,5
D11,Other,2020,15,16,0,1
D11,Other,2020,19,21,0,2
D11,Other,2020,10,10,1,0
D11,Other,2020,8,8,1,0
D11,Other,2020,96,100,0,4
D11,Other,2020,15,18,0,3
D11,Other,2020,16,19,0,3
D11,Other,2020,99,104,0,5
D11,Other Criminal Violations - Offensive Weapons,2020,4,5,0,1
D11,Other Criminal Violations - Offensive Weapons,2020,4,5,0,1
D11,Other Criminal Violations - Offensive Weapons,2020,1,2,0,1
D11,Other Criminal Violations - Offensive Weapons,2020,10,10,1,0
D11,Other Criminal Violations - Offensive Weapons,2020,5,5,1,0
D11,Other Criminal Violations - Offensive Weapons,2020,4,4,1,0
D11,Other Criminal Violations - Offensive Weapons,2020,1,1,1,0
D11,Other Criminal Violations - Offensive Weapons,2020,1,2,0,1
D11,Other Criminal Violations - Offensive Weapons,2020,6,6,1,0
D11,Other Criminal Violations - Offensive Weapons,2020,4,5,0,1
D11,Other,2020,3,3,1,0
D11,Other,2020,1,1,1,0
D11,Other,2020,0,1,0,1
D11,Other,2020,1,1,1,0
D11,Other,2020,1,2,0,1
D11,Other,2020,2,3,0,1
D12,Other,2020,8,8,1,0
D12,Other,2020,5,6,0,1
D12,Other,2020,3,3,1,0
D12,Other,2020,3,3,1,0
D12,Other,2020,2,2,1,0
D12,Other,2020,3,4,0,1
D12,Other,2020,1,1,1,0
D12,Other,2020,8,8,1,0
D12,Other,2020,7,8,0,1
D12,Other,2020,9,9,1,0
D12,Other,2020,28,29,0,1
D12,Other,2020,3,3,1,0
D12,Auto Theft,2020,0,15,0,15
D12,Auto Theft,2020,3,24,0,21
D12,Auto Theft,2020,5,57,0,52
D12,Auto Theft,2020,0,6,0,6
D12,Auto Theft,2020,0,23,0,23
D13,Break & Enter-Apartment,2020,0,1,0,1
D12,Other,2020,37,42,0,5
D12,Other,2020,14,34,0,20
D13,Fraud,2020,1,43,0,42
D12,Other,2020,1,1,1,0
D13,Break & Enter-Apartment,2020,2,3,0,1
D12,Auto Theft,2020,0,2,0,2
D13,Fraud,2020,0,13,0,13
D12,Attempt Murder,2020,5,5,1,0
D12,Other,2020,20,66,0,46
D12,Auto Theft,2020,0,25,0,25
D13,Break & Enter-Apartment,2020,3,18,0,15
D13,Fraud,2020,0,14,0,14
D12,Other,2020,14,15,0,1
D12,Other,2020,4,7,0,3
D12,Other,2020,8,24,0,16
D12,Auto Theft,2020,5,59,0,54
D13,Break & Enter-Apartment,2020,1,5,0,4
D13,Fraud,2020,0,32,0,32
D12,Other,2020,20,27,0,7
D12,Other,2020,9,17,0,8
D12,Other,2020,16,56,0,40
D12,Auto Theft,2020,3,22,0,19
D13,Break & Enter-Apartment,2020,4,6,0,2
D13,Fraud,2020,1,38,0,37
D12,Other,2020,13,16,0,3
D12,Other,2020,1,3,0,2
D12,Other,2020,5,22,0,17
D12,Auto Theft,2020,9,77,0,68
D13,Break & Enter-Apartment,2020,2,6,0,4
D13,Fraud,2020,0,19,0,19
D12,Other,2020,40,43,0,3
D12,Other,2020,5,10,0,5
D12,Other,2020,18,63,0,45
D12,Auto Theft,2020,0,12,0,12
D13,Break & Enter-Apartment,2020,3,3,1,0
D13,Fraud,2020,0,2,0,2
D12,Other,2020,26,26,1,0
D12,Other,2020,3,6,0,3
D12,Other,2020,6,20,0,14
D12,Break & Enter-Apartment,2020,1,6,0,5
D13,Break & Enter-Commercial,2020,9,25,0,16
D13,Fraud,2020,7,50,0,43
D12,Other,2020,10,13,0,3
D12,Other,2020,7,14,0,7
D12,Other,2020,33,107,0,74
D12,Break & Enter-Apartment,2020,3,7,0,4
D13,Break & Enter-Commercial,2020,1,4,0,3
D13,Fraud,2020,3,46,0,43
D13,Fraud,2020,12,39,0,27
D13,Other,2020,22,89,0,67
D13,Other,2020,14,32,0,18
D13,Other,2020,7,31,0,24
D13,Other,2020,18,70,0,52
D13,Other,2020,4,18,0,14
D13,Other,2020,3,21,0,18
D13,Other,2020,6,29,0,23
D13,Other,2020,13,54,0,41
D13,Other,2020,3,24,0,21
D13,Other,2020,0,1,0,1
D13,Other,2020,38,117,0,79
D13,Other,2020,17,56,0,39
D13,Other,2020,13,61,0,48
D13,Theft Over $5000,2020,2,8,0,6
D13,Theft Over $5000,2020,0,2,0,2
D13,Theft Over $5000,2020,0,2,0,2
D13,Theft Over $5000,2020,3,6,0,3
D13,Theft Over $5000,2020,0,4,0,4
D13,Theft Over $5000,2020,0,3,0,3
D13,Theft Over $5000,2020,0,6,0,6
D13,Theft Over $5000,2020,1,3,0,2
D13,Theft Over $5000,2020,1,3,0,2
D13,Theft Over $5000,2020,1,1,1,0
D13,Theft Over $5000,2020,2,3,0,1
D13,Theft Under $5000,2020,22,140,0,118
D13,Theft Under $5000,2020,15,63,0,48
D13,Theft Under $5000,2020,46,262,0,216
D13,Theft Under $5000,2020,14,126,0,112
D13,Theft Under $5000,2020,4,50,0,46
D13,Theft Under $5000,2020,4,49,0,45
D13,Theft Under $5000,2020,13,133,0,120
D13,Theft Under $5000,2020,17,132,0,115
D13,Theft Under $5000,2020,0,50,0,50
D13,Theft Under $5000,2020,0,3,0,3
D13,Theft Under $5000,2020,19,152,0,133
D13,Theft Under $5000,2020,41,318,0,277
D13,Theft Under $5000,2020,10,142,0,132
D13,Assault,2020,40,67,0,27
D13,Assault,2020,33,46,0,13
D12,Break & Enter-Apartment,2020,1,2,0,1
D12,Other,2020,14,29,0,15
D13,Break & Enter-Commercial,2020,12,24,0,12
D12,Break & Enter-Apartment,2020,1,1,1,0
D12,Other,2020,56,68,0,12
D12,Other,2020,42,95,0,53
D12,Other,2020,0,4,0,4
D13,Break & Enter-Commercial,2020,0,2,0,2
D12,Break & Enter-Apartment,2020,2,4,0,2
D13,Break & Enter-Commercial,2020,7,12,0,5
D12,Other,2020,5,19,0,14
D12,Other,2020,15,20,0,5
D12,Break & Enter-Apartment,2020,0,2,0,2
D12,Other,2020,31,33,0,2
D13,Break & Enter-Commercial,2020,0,1,0,1
D12,Theft Over $5000,2020,2,2,1,0
D12,Other,2020,5,9,0,4
D12,Break & Enter-Apartment,2020,4,11,0,7
D12,Other,2020,76,90,0,14
D13,Break & Enter-Commercial,2020,1,5,0,4
D12,Theft Over $5000,2020,0,10,0,10
D12,Other,2020,18,27,0,9
D12,Break & Enter-Apartment,2020,4,7,0,3
D12,Other,2020,7,7,1,0
D13,Break & Enter-Commercial,2020,1,2,0,1
D12,Theft Over $5000,2020,0,2,0,2
D12,Other,2020,1,2,0,1
D12,Break & Enter-Apartment,2020,4,7,0,3
D13,Break & Enter-Commercial,2020,2,9,0,7
D12,Theft Over $5000,2020,1,4,0,3
D12,Robbery-Financial,2020,1,1,1,0
D12,Break & Enter-Apartment,2020,0,1,0,1
D13,Break & Enter-Commercial,2020,10,25,0,15
D12,Theft Over $5000,2020,0,2,0,2
D12,Break & Enter-Commercial,2020,0,2,0,2
D12,Other Criminal Violations - Offensive Weapons,2020,7,7,1,0
D12,Robbery-Other,2020,1,3,0,2
D13,Break & Enter-Commercial,2020,5,18,0,13
D12,Theft Over $5000,2020,0,3,0,3
D12,Break & Enter-Commercial,2020,2,17,0,15
D12,Other Criminal Violations - Offensive Weapons,2020,7,9,0,2
D12,Robbery-Other,2020,10,14,0,4
D13,Break & Enter-House,2020,1,5,0,4
D12,Theft Over $5000,2020,0,2,0,2
D12,Break & Enter-Commercial,2020,5,10,0,5
D12,Other Criminal Violations - Offensive Weapons,2020,4,5,0,1
D12,Robbery-Other,2020,0,5,0,5
D13,Break & Enter-House,2020,0,5,0,5
D12,Theft Over $5000,2020,0,4,0,4
D12,Break & Enter-Commercial,2020,6,16,0,10
D12,Other Criminal Violations - Offensive Weapons,2020,2,3,0,1
D12,Robbery-Other,2020,2,11,0,9
D13,Break & Enter-House,2020,0,2,0,2
D12,Theft Over $5000,2020,0,4,0,4
D12,Break & Enter-Commercial,2020,0,9,0,9
D12,Other Criminal Violations - Offensive Weapons,2020,4,4,1,0
D12,Robbery-Other,2020,0,2,0,2
D13,Break & Enter-House,2020,3,9,0,6
D12,Theft Over $5000,2020,2,10,0,8
D12,Break & Enter-Commercial,2020,1,4,0,3
D12,Other Criminal Violations - Offensive Weapons,2020,3,5,0,2
D12,Robbery-Other,2020,5,14,0,9
D13,Break & Enter-House,2020,1,6,0,5
D12,Theft Under $5000,2020,4,49,0,45
D12,Break & Enter-Commercial,2020,2,14,0,12
D12,Other Criminal Violations - Offensive Weapons,2020,4,4,1,0
D12,Robbery-Other,2020,5,8,0,3
D13,Break & Enter-House,2020,3,20,0,17
D12,Theft Under $5000,2020,81,253,0,172
D12,Other Criminal Violations - Offensive Weapons,2020,7,8,0,1
D12,Robbery-Other,2020,0,5,0,5
D13,Break & Enter-House,2020,1,14,0,13
D12,Theft Under $5000,2020,38,138,0,100
D13,Break & Enter-House,2020,6,23,0,17
D12,Other Criminal Violations - Offensive Weapons,2020,1,1,1,0
D12,Break & Enter-Commercial,2020,1,2,0,1
D12,Robbery-Other,2020,9,21,0,12
D12,Theft Under $5000,2020,19,103,0,84
D13,Break & Enter-House,2020,4,12,0,8
D12,Other Criminal Violations - Offensive Weapons,2020,13,15,0,2
D12,Break & Enter-Commercial,2020,1,8,0,7
D12,Robbery-Other,2020,1,2,0,1
D12,Theft Under $5000,2020,3,42,0,39
D13,Break & Enter-House,2020,2,13,0,11
D12,Other Criminal Violations - Offensive Weapons,2020,3,4,0,1
D12,Break & Enter-Commercial,2020,4,5,0,1
D12,Sexual Violation,2020,2,4,0,2
D12,Theft Under $5000,2020,12,77,0,65
D13,Break & Enter-House,2020,2,8,0,6
D12,Other,2020,1,1,1,0
D12,Break & Enter-House,2020,0,5,0,5
D12,Sexual Violation,2020,6,13,0,7
D12,Theft Under $5000,2020,0,1,0,1
D13,Break & Enter-House,2020,0,8,0,8
D12,Other,2020,5,5,1,0
D12,Break & Enter-House,2020,1,2,0,1
D12,Sexual Violation,2020,0,1,0,1
D12,Theft Under $5000,2020,47,231,0,184
D13,Break & Enter-Other,2020,0,1,0,1
D12,Other,2020,2,2,1,0
D12,Break & Enter-House,2020,4,5,0,1
D12,Sexual Violation,2020,2,4,0,2
D12,Theft Under $5000,2020,11,129,0,118
D13,Break & Enter-Other,2020,1,2,0,1
D12,Other,2020,1,1,1,0
D12,Break & Enter-House,2020,0,7,0,7
D12,Sexual Violation,2020,1,4,0,3
D12,Theft Under $5000,2020,2,55,0,53
D13,Break & Enter-Other,2020,0,5,0,5
D12,Other,2020,1,2,0,1
D12,Break & Enter-House,2020,3,8,0,5
D12,Sexual Violation,2020,3,10,0,7
D12,Sexual Violation,2020,6,10,0,4
D12,Sexual Violation,2020,3,5,0,2
D12,Sexual Violation,2020,17,30,0,13
D12,Sexual Violation,2020,1,4,0,3
D12,Other,2020,9,10,0,1
D12,Other,2020,16,18,0,2
D12,Other,2020,3,4,0,1
D12,Other,2020,11,13,0,2
D12,Other,2020,2,6,0,4
D12,Other,2020,12,13,0,1
D12,Other,2020,5,5,1,0
D12,Other,2020,13,16,0,3
D12,Other,2020,4,5,0,1
D12,Other,2020,12,14,0,2
D12,Other,2020,5,6,0,1
D12,Theft Under $5000,2020,25,189,0,164
D12,Break & Enter-House,2020,2,3,0,1
D13,Break & Enter-Other,2020,0,1,0,1
D12,Other,2020,2,2,1,0
D12,Theft Under $5000,2020,5,43,0,38
D12,Break & Enter-House,2020,0,10,0,10
D13,Break & Enter-Other,2020,0,1,0,1
D12,Other,2020,0,1,0,1
D12,Assault,2020,26,40,0,14
D12,Break & Enter-House,2020,2,5,0,3
D13,Break & Enter-Other,2020,0,2,0,2
D13,Other,2020,8,8,1,0
D12,Assault,2020,55,83,0,28
D12,Break & Enter-House,2020,1,4,0,3
D13,Break & Enter-Other,2020,1,4,0,3
D13,Other,2020,3,4,0,1
D12,Assault,2020,17,24,0,7
D12,Break & Enter-House,2020,2,2,1,0
D13,Break & Enter-Other,2020,1,7,0,6
D13,Other,2020,2,4,0,2
D12,Assault,2020,54,72,0,18
D12,Break & Enter-Other,2020,0,4,0,4
D13,Break & Enter-Other,2020,0,4,0,4
D13,Other,2020,3,3,1,0
D12,Assault,2020,22,24,0,2
D12,Break & Enter-Other,2020,0,2,0,2
D13,Break & Enter-Other,2020,3,6,0,3
D13,Other,2020,6,7,0,1
D12,Assault,2020,45,65,0,20
D13,Break & Enter-Other,2020,4,9,0,5
D13,Other,2020,10,14,0,4
D12,Assault,2020,1,2,0,1
D13,Other,2020,5,5,1,0
D12,Break & Enter-Other,2020,0,2,0,2
D13,Fraud,2020,8,50,0,42
D12,Assault,2020,14,16,0,2
D13,Other,2020,3,3,1,0
D12,Break & Enter-Other,2020,0,1,0,1
D13,Fraud,2020,1,29,0,28
D12,Assault,2020,79,111,0,32
D13,Auto Theft,2020,4,38,0,34
D12,Break & Enter-Other,2020,0,1,0,1
D12,Assault,2020,38,54,0,16
D13,Auto Theft,2020,1,11,0,10
D12,Break & Enter-Other,2020,0,1,0,1
D13,Auto Theft,2020,0,6,0,6
D12,Break & Enter-Other,2020,3,5,0,2
D13,Auto Theft,2020,1,14,0,13
D12,Break & Enter-Other,2020,2,3,0,1
D13,Auto Theft,2020,0,25,0,25
D12,Fraud,2020,3,37,0,34
D13,Auto Theft,2020,1,25,0,24
D12,Fraud,2020,6,58,0,52
D13,Auto Theft,2020,1,25,0,24
D12,Fraud,2020,1,11,0,10
D13,Auto Theft,2020,2,27,0,25
D12,Fraud,2020,2,21,0,19
D13,Auto Theft,2020,4,15,0,11
D13,Auto Theft,2020,0,1,0,1
D13,Auto Theft,2020,3,28,0,25
D14,Other,2020,9,9,1,0
D14,Other,2020,3,7,0,4
D14,Other,2020,27,34,0,7
D14,Other,2020,4,10,0,6
D14,Other,2020,46,52,0,6
D14,Other,2020,24,35,0,11
D14,Other,2020,7,7,1,0
D14,Other,2020,8,16,0,8
D14,Other,2020,55,59,0,4
D14,Other,2020,3,8,0,5
D14,Other,2020,46,52,0,6
D14,Other,2020,7,9,0,2
D14,Other,2020,98,113,0,15
D14,Other,2020,6,11,0,5
D14,Other,2020,11,13,0,2
D22,Auto Theft,2020,3,51,0,48
D14,Break & Enter-House,2020,0,7,0,7
D14,Other,2020,99,111,0,12
D14,Other,2020,4,4,1,0
D14,Other,2020,27,33,0,6
D14,Other,2020,148,160,0,12
D14,Other,2020,51,59,0,8
D14,Other,2020,16,24,0,8
D14,Other,2020,62,71,0,9
D14,Other,2020,55,63,0,8
D14,Other Criminal Violations - Offensive Weapons,2020,5,6,0,1
D14,Other Criminal Violations - Offensive Weapons,2020,2,3,0,1
D14,Other Criminal Violations - Offensive Weapons,2020,5,5,1,0
D14,Other Criminal Violations - Offensive Weapons,2020,11,11,1,0
D14,Other Criminal Violations - Offensive Weapons,2020,15,17,0,2
D14,Other Criminal Violations - Offensive Weapons,2020,4,4,1,0
D14,Other Criminal Violations - Offensive Weapons,2020,14,15,0,1
D14,Other Criminal Violations - Offensive Weapons,2020,2,3,0,1
D14,Other Criminal Violations - Offensive Weapons,2020,1,1,1,0
D14,Other Criminal Violations - Offensive Weapons,2020,10,12,0,2
D14,Other Criminal Violations - Offensive Weapons,2020,4,4,1,0
D14,Other,2020,2,2,1,0
D14,Other,2020,1,1,1,0
D14,Other,2020,3,3,1,0
D14,Other,2020,0,1,0,1
D14,Other,2020,2,2,1,0
D14,Other,2020,1,2,0,1
D14,Other,2020,1,1,1,0
D14,Other,2020,1,2,0,1
D22,Other,2020,3,3,1,0
D22,Other,2020,1,2,0,1
D22,Other,2020,16,19,0,3
D22,Other,2020,13,13,1,0
D22,Other,2020,0,1,0,1
D22,Other,2020,1,1,1,0
D22,Other,2020,15,18,0,3
D22,Other,2020,8,9,0,1
D22,Other,2020,1,1,1,0
D22,Other,2020,7,7,1,0
D22,Auto Theft,2020,2,28,0,26
D22,Auto Theft,2020,0,29,0,29
D22,Auto Theft,2020,1,52,0,51
D22,Auto Theft,2020,3,103,0,100
D22,Auto Theft,2020,0,13,0,13
D22,Auto Theft,2020,4,17,0,13
D13,Assault,2020,15,42,0,27
D13,Sexual Violation,2020,4,8,0,4
D14,Other,2020,34,126,0,92
D14,Robbery-Financial,2020,1,1,1,0
D13,Assault,2020,53,74,0,21
D13,Sexual Violation,2020,1,5,0,4
D14,Other,2020,27,91,0,64
D14,Robbery-Financial,2020,1,1,1,0
D13,Assault,2020,10,10,1,0
D14,Break & Enter-House,2020,5,15,0,10
D13,Sexual Violation,2020,5,7,0,2
D14,Other,2020,6,6,1,0
D14,Theft Over $5000,2020,1,10,0,9
D13,Assault,2020,8,16,0,8
D14,Robbery-Financial,2020,1,1,1,0
D14,Robbery-Other,2020,5,6,0,1
D14,Robbery-Other,2020,6,11,0,5
D22,Auto Theft,2020,1,17,0,16
D14,Break & Enter-House,2020,2,5,0,3
D14,Robbery-Other,2020,0,2,0,2
D13,Assault,2020,13,20,0,7
D14,Other,2020,1,1,1,0
D22,Auto Theft,2020,2,24,0,22
D14,Theft Over $5000,2020,0,3,0,3
D14,Break & Enter-House,2020,1,2,0,1
D14,Robbery-Other,2020,6,10,0,4
D13,Assault,2020,23,38,0,15
D13,Sexual Violation,2020,2,7,0,5
D14,Other,2020,5,5,1,0
D22,Auto Theft,2020,5,30,0,25
D14,Theft Over $5000,2020,0,4,0,4
D14,Break & Enter-House,2020,4,12,0,8
D14,Robbery-Other,2020,2,6,0,4
D13,Assault,2020,18,23,0,5
D13,Sexual Violation,2020,2,11,0,9
D14,Other,2020,49,50,0,1
D22,Auto Theft,2020,1,34,0,33
D14,Theft Over $5000,2020,1,3,0,2
D14,Break & Enter-House,2020,0,4,0,4
D14,Robbery-Other,2020,13,20,0,7
D13,Assault,2020,0,1,0,1
D13,Other,2020,6,7,0,1
D14,Other,2020,6,9,0,3
D22,Auto Theft,2020,0,2,0,2
D14,Theft Over $5000,2020,1,8,0,7
D14,Break & Enter-House,2020,1,9,0,8
D14,Robbery-Other,2020,2,7,0,5
D13,Assault,2020,83,114,0,31
D13,Other,2020,2,3,0,1
D13,Other,2020,4,7,0,3
D13,Other,2020,11,11,1,0
D13,Other,2020,2,2,1,0
D13,Other,2020,0,3,0,3
D13,Other,2020,5,5,1,0
D13,Other,2020,8,8,1,0
D13,Other,2020,4,4,1,0
D13,Other,2020,15,17,0,2
D13,Other,2020,7,10,0,3
D13,Other,2020,9,10,0,1
D13,Other,2020,37,42,0,5
D13,Other,2020,11,14,0,3
D13,Other,2020,22,24,0,2
D13,Other,2020,31,35,0,4
D13,Other,2020,2,4,0,2
D13,Other,2020,15,18,0,3
D13,Other,2020,5,9,0,4
D13,Other,2020,47,54,0,7
D13,Other,2020,8,12,0,4
D13,Other,2020,4,4,1,0
D13,Other,2020,72,84,0,12
D13,Other,2020,44,48,0,4
D13,Other,2020,25,30,0,5
D13,Other Criminal Violations - Offensive Weapons,2020,5,5,1,0
D13,Other Criminal Violations - Offensive Weapons,2020,1,3,0,2
D13,Other Criminal Violations - Offensive Weapons,2020,2,3,0,1
D13,Other Criminal Violations - Offensive Weapons,2020,5,5,1,0
D13,Other Criminal Violations - Offensive Weapons,2020,1,1,1,0
D13,Other Criminal Violations - Offensive Weapons,2020,8,8,1,0
D13,Other Criminal Violations - Offensive Weapons,2020,1,1,1,0
D13,Other Criminal Violations - Offensive Weapons,2020,5,5,1,0
D13,Other Criminal Violations - Offensive Weapons,2020,1,1,1,0
D13,Other Criminal Violations - Offensive Weapons,2020,1,1,1,0
D13,Other Criminal Violations - Offensive Weapons,2020,4,5,0,1
D13,Other Criminal Violations - Offensive Weapons,2020,4,4,1,0
D13,Other,2020,1,1,1,0
D13,Other,2020,1,1,1,0
D13,Other,2020,3,3,1,0
D14,Other,2020,2,2,1,0
D14,Other,2020,4,5,0,1
D14,Other,2020,4,4,1,0
D14,Other,2020,5,5,1,0
D14,Other,2020,17,18,0,1
D14,Theft Over $5000,2020,0,3,0,3
D22,Auto Theft,2020,0,21,0,21
D14,Other,2020,3,5,0,2
D14,Break & Enter-House,2020,6,11,0,5
D14,Robbery-Other,2020,4,9,0,5
D13,Assault,2020,53,75,0,22
D14,Theft Over $5000,2020,0,4,0,4
D22,Auto Theft,2020,1,20,0,19
D14,Break & Enter-House,2020,1,15,0,14
D14,Robbery-Other,2020,4,10,0,6
D14,Theft Over $5000,2020,2,13,0,11
D13,Assault,2020,33,55,0,22
D14,Other,2020,9,10,0,1
D22,Auto Theft,2020,2,49,0,47
D14,Break & Enter-House,2020,4,8,0,4
D14,Robbery-Other,2020,13,17,0,4
D14,Theft Over $5000,2020,1,8,0,7
D13,Attempt Murder,2020,1,1,1,0
D14,Other,2020,4,4,1,0
D22,Break & Enter-Apartment,2020,3,6,0,3
D14,Break & Enter-House,2020,2,2,1,0
D14,Robbery-Other,2020,1,5,0,4
D14,Theft Over $5000,2020,0,5,0,5
D13,Attempt Murder,2020,0,1,0,1
D14,Auto Theft,2020,0,15,0,15
D22,Break & Enter-Apartment,2020,0,2,0,2
D14,Break & Enter-House,2020,1,6,0,5
D14,Robbery-Other,2020,6,9,0,3
D14,Theft Over $5000,2020,3,13,0,10
D13,Attempt Murder,2020,1,1,1,0
D14,Auto Theft,2020,0,18,0,18
D22,Break & Enter-Apartment,2020,1,6,0,5
D14,Break & Enter-Other,2020,1,6,0,5
D14,Robbery-Other,2020,4,7,0,3
D14,Theft Over $5000,2020,2,7,0,5
D13,Attempt Murder,2020,1,1,1,0
D14,Auto Theft,2020,3,10,0,7
D22,Break & Enter-Apartment,2020,0,4,0,4
D14,Break & Enter-Other,2020,4,7,0,3
D14,Sexual Violation,2020,2,2,1,0
D14,Theft Under $5000,2020,20,266,0,246
D13,Other,2020,7,18,0,11
D14,Auto Theft,2020,0,18,0,18
D22,Break & Enter-Apartment,2020,3,14,0,11
D14,Break & Enter-Other,2020,1,2,0,1
D14,Sexual Violation,2020,0,3,0,3
D14,Theft Under $5000,2020,23,188,0,165
D13,Other,2020,2,4,0,2
D14,Auto Theft,2020,2,12,0,10
D14,Auto Theft,2020,1,30,0,29
D14,Auto Theft,2020,2,17,0,15
D14,Auto Theft,2020,0,1,0,1
D14,Auto Theft,2020,1,16,0,15
D14,Auto Theft,2020,2,15,0,13
D14,Auto Theft,2020,5,16,0,11
D14,Auto Theft,2020,1,6,0,5
D14,Auto Theft,2020,0,22,0,22
D14,Auto Theft,2020,0,12,0,12
D14,Break & Enter-Apartment,2020,3,12,0,9
D14,Break & Enter-Apartment,2020,2,7,0,5
D14,Break & Enter-Apartment,2020,1,3,0,2
D14,Break & Enter-Apartment,2020,6,27,0,21
D14,Break & Enter-Apartment,2020,4,25,0,21
D14,Break & Enter-Apartment,2020,9,21,0,12
D14,Break & Enter-Apartment,2020,5,13,0,8
D14,Break & Enter-Apartment,2020,2,9,0,7
D14,Break & Enter-Apartment,2020,15,42,0,27
D14,Break & Enter-Apartment,2020,5,24,0,19
D14,Break & Enter-Apartment,2020,0,4,0,4
D14,Break & Enter-Apartment,2020,17,55,0,38
D14,Break & Enter-Apartment,2020,12,26,0,14
D14,Break & Enter-Commercial,2020,5,36,0,31
D14,Break & Enter-Commercial,2020,5,18,0,13
D14,Break & Enter-Commercial,2020,3,11,0,8
D14,Break & Enter-Commercial,2020,5,15,0,10
D14,Break & Enter-Commercial,2020,0,9,0,9
D14,Break & Enter-Commercial,2020,8,41,0,33
D14,Break & Enter-Commercial,2020,4,18,0,14
D14,Break & Enter-Commercial,2020,1,1,1,0
D14,Break & Enter-Commercial,2020,6,26,0,20
D14,Break & Enter-Commercial,2020,12,26,0,14
D14,Break & Enter-Commercial,2020,12,40,0,28
D14,Break & Enter-Commercial,2020,7,29,0,22
D14,Break & Enter-Commercial,2020,10,29,0,19
D14,Break & Enter-Commercial,2020,9,29,0,20
D22,Break & Enter-Apartment,2020,1,7,0,6
D14,Sexual Violation,2020,1,4,0,3
D14,Break & Enter-Other,2020,1,3,0,2
D14,Theft Under $5000,2020,5,47,0,42
D22,Break & Enter-Apartment,2020,1,2,0,1
D14,Sexual Violation,2020,3,12,0,9
D14,Sexual Violation,2020,8,13,0,5
D14,Sexual Violation,2020,11,22,0,11
D14,Sexual Violation,2020,4,14,0,10
D14,Sexual Violation,2020,1,1,1,0
D14,Sexual Violation,2020,3,6,0,3
D14,Sexual Violation,2020,12,24,0,12
D14,Sexual Violation,2020,0,1,0,1
D14,Sexual Violation,2020,6,15,0,9
D14,Sexual Violation,2020,5,6,0,1
D14,Sexual Violation,2020,3,12,0,9
D14,Sexual Violation,2020,8,19,0,11
D14,Other,2020,4,4,1,0
D14,Other,2020,3,3,1,0
D14,Other,2020,2,2,1,0
D14,Other,2020,13,14,0,1
D14,Other,2020,7,8,0,1
D14,Other,2020,7,7,1,0
D14,Other,2020,4,6,0,2
D14,Other,2020,6,7,0,1
D14,Other,2020,27,28,0,1
D14,Other,2020,7,7,1,0
D14,Other,2020,2,2,1,0
D14,Other,2020,10,10,1,0
D13,Other,2020,1,5,0,4
D14,Break & Enter-Other,2020,0,1,0,1
D14,Theft Under $5000,2020,20,179,0,159
D22,Break & Enter-Apartment,2020,5,13,0,8
D14,Break & Enter-Other,2020,1,1,1,0
D13,Other,2020,9,15,0,6
D14,Theft Under $5000,2020,20,146,0,126
D22,Break & Enter-Apartment,2020,12,15,0,3
D14,Break & Enter-Other,2020,1,4,0,3
D13,Other,2020,5,6,0,1
D14,Theft Under $5000,2020,0,1,0,1
D22,Break & Enter-Apartment,2020,11,16,0,5
D14,Break & Enter-Other,2020,4,9,0,5
D13,Other,2020,2,4,0,2
D14,Theft Under $5000,2020,57,300,0,243
D22,Break & Enter-Apartment,2020,1,7,0,6
D14,Break & Enter-Other,2020,4,7,0,3
D13,Other,2020,1,3,0,2
D14,Theft Under $5000,2020,26,188,0,162
D22,Break & Enter-Commercial,2020,14,30,0,16
D14,Break & Enter-Other,2020,1,6,0,5
D14,Theft Under $5000,2020,0,3,0,3
D22,Break & Enter-Commercial,2020,0,6,0,6
D14,Break & Enter-Other,2020,0,4,0,4
D22,Break & Enter-Commercial,2020,0,4,0,4
D13,Other,2020,6,8,0,2
D14,Theft Under $5000,2020,38,224,0,186
D14,Break & Enter-Other,2020,0,2,0,2
D22,Break & Enter-Commercial,2020,9,38,0,29
D13,Other,2020,2,2,1,0
D14,Theft Under $5000,2020,109,383,0,274
D14,Fraud,2020,3,69,0,66
D22,Break & Enter-Commercial,2020,1,3,0,2
D13,Other,2020,14,23,0,9
D14,Theft Under $5000,2020,69,375,0,306
D14,Fraud,2020,1,57,0,56
D22,Break & Enter-Commercial,2020,1,4,0,3
D13,Other,2020,3,12,0,9
D14,Theft Under $5000,2020,13,229,0,216
D14,Fraud,2020,1,19,0,18
D22,Break & Enter-Commercial,2020,2,16,0,14
D13,Other,2020,5,9,0,4
D14,Theft Under $5000,2020,49,413,0,364
D14,Fraud,2020,4,90,0,86
D22,Break & Enter-Commercial,2020,4,10,0,6
D13,Robbery-Financial,2020,1,1,1,0
D14,Theft Under $5000,2020,29,238,0,209
D14,Fraud,2020,12,83,0,71
D22,Break & Enter-Commercial,2020,3,12,0,9
D13,Robbery-Financial,2020,1,1,1,0
D14,Assault,2020,38,77,0,39
D14,Fraud,2020,9,65,0,56
D22,Break & Enter-Commercial,2020,7,7,1,0
D13,Robbery-Financial,2020,1,1,1,0
D14,Assault,2020,41,67,0,26
D14,Fraud,2020,3,49,0,46
D22,Break & Enter-Commercial,2020,4,10,0,6
D13,Robbery-Other,2020,1,1,1,0
D14,Assault,2020,22,29,0,7
D14,Fraud,2020,5,55,0,50
D22,Break & Enter-Commercial,2020,3,14,0,11
D13,Robbery-Other,2020,4,7,0,3
D14,Assault,2020,64,88,0,24
D14,Fraud,2020,11,93,0,82
D22,Break & Enter-Commercial,2020,1,3,0,2
D13,Robbery-Other,2020,3,6,0,3
D14,Fraud,2020,8,83,0,75
D22,Break & Enter-Commercial,2020,2,15,0,13
D13,Robbery-Other,2020,1,3,0,2
D14,Assault,2020,68,105,0,37
D14,Fraud,2020,2,35,0,33
D22,Break & Enter-House,2020,3,5,0,2
D13,Robbery-Other,2020,3,9,0,6
D14,Assault,2020,107,186,0,79
D14,Fraud,2020,15,118,0,103
D22,Break & Enter-House,2020,2,15,0,13
D13,Robbery-Other,2020,1,1,1,0
D14,Assault,2020,35,53,0,18
D14,Fraud,2020,12,92,0,80
D22,Break & Enter-House,2020,2,8,0,6
D13,Robbery-Other,2020,3,11,0,8
D14,Assault,2020,1,1,1,0
D14,Other,2020,31,120,0,89
D22,Break & Enter-House,2020,0,1,0,1
D13,Robbery-Other,2020,0,4,0,4
D14,Assault,2020,26,59,0,33
D14,Other,2020,16,104,0,88
D22,Break & Enter-House,2020,1,5,0,4
D13,Robbery-Other,2020,3,6,0,3
D14,Assault,2020,155,217,0,62
D14,Other,2020,9,30,0,21
D22,Break & Enter-House,2020,4,16,0,12
D13,Robbery-Other,2020,2,2,1,0
D14,Assault,2020,56,96,0,40
D14,Other,2020,28,79,0,51
D22,Break & Enter-House,2020,0,7,0,7
D13,Robbery-Other,2020,7,21,0,14
D14,Assault,2020,16,42,0,26
D14,Other,2020,0,1,0,1
D22,Break & Enter-House,2020,2,5,0,3
D13,Robbery-Other,2020,7,14,0,7
D14,Assault,2020,76,137,0,61
D14,Other,2020,21,60,0,39
D22,Break & Enter-House,2020,0,3,0,3
D13,Robbery-Other,2020,3,10,0,7
D14,Assault,2020,60,101,0,41
D14,Other,2020,37,124,0,87
D22,Break & Enter-House,2020,2,8,0,6
D13,Sexual Violation,2020,5,9,0,4
D14,Attempt Murder,2020,1,2,0,1
D14,Other,2020,15,55,0,40
D22,Break & Enter-House,2020,3,7,0,4
D14,Other,2020,10,13,0,3
D14,Other,2020,2,4,0,2
D22,Break & Enter-House,2020,1,9,0,8
D14,Other,2020,4,15,0,11
D13,Sexual Violation,2020,0,1,0,1
D14,Other,2020,19,82,0,63
D22,Break & Enter-House,2020,2,11,0,9
D14,Other,2020,3,6,0,3
D13,Sexual Violation,2020,0,1,0,1
D14,Other,2020,54,134,0,80
D22,Break & Enter-Other,2020,2,2,1,0
D14,Other,2020,5,16,0,11
D13,Sexual Violation,2020,5,13,0,8
D14,Other,2020,30,99,0,69
D22,Break & Enter-Other,2020,4,11,0,7
D14,Other,2020,5,8,0,3
D13,Sexual Violation,2020,4,4,1,0
D14,Other,2020,10,64,0,54
D22,Break & Enter-Other,2020,1,2,0,1
D14,Other,2020,15,23,0,8
D13,Sexual Violation,2020,2,5,0,3
D13,Sexual Violation,2020,0,4,0,4
D31,Other,2020,2,3,0,1
D22,Break & Enter-Other,2020,0,1,0,1
D31,Other,2020,10,13,0,3
D22,Break & Enter-Other,2020,0,4,0,4
D31,Other,2020,0,1,0,1
D23,Other,2020,17,56,0,39
D23,Robbery-Other,2020,9,29,0,20
D22,Break & Enter-Other,2020,0,2,0,2
D22,Theft Over $5000,2020,1,5,0,4
D31,Other,2020,11,11,1,0
D23,Theft Over $5000,2020,0,2,0,2
D22,Break & Enter-Other,2020,1,4,0,3
D23,Robbery-Other,2020,5,8,0,3
D22,Theft Under $5000,2020,8,91,0,83
D31,Auto Theft,2020,4,83,0,79
D23,Theft Over $5000,2020,0,1,0,1
D22,Break & Enter-Other,2020,0,2,0,2
D23,Robbery-Other,2020,3,9,0,6
D22,Theft Under $5000,2020,7,78,0,71
D31,Auto Theft,2020,2,38,0,36
D23,Theft Over $5000,2020,1,7,0,6
D22,Break & Enter-Other,2020,0,1,0,1
D23,Robbery-Other,2020,23,65,0,42
D22,Theft Under $5000,2020,4,75,0,71
D22,Other,2020,18,21,0,3
D31,Auto Theft,2020,7,125,0,118
D31,Auto Theft,2020,6,111,0,105
D31,Auto Theft,2020,2,76,0,74
D31,Auto Theft,2020,0,4,0,4
D31,Auto Theft,2020,4,106,0,102
D31,Auto Theft,2020,0,34,0,34
D31,Auto Theft,2020,8,128,0,120
D31,Break & Enter-Apartment,2020,8,15,0,7
D31,Break & Enter-Apartment,2020,4,7,0,3
D31,Break & Enter-Apartment,2020,8,17,0,9
D31,Break & Enter-Apartment,2020,1,2,0,1
D31,Break & Enter-Apartment,2020,2,6,0,4
D31,Break & Enter-Apartment,2020,6,14,0,8
D31,Break & Enter-Apartment,2020,0,2,0,2
D31,Break & Enter-Apartment,2020,0,13,0,13
D31,Break & Enter-Commercial,2020,0,1,0,1
D31,Break & Enter-Commercial,2020,0,8,0,8
D31,Break & Enter-Commercial,2020,5,19,0,14
D31,Break & Enter-Commercial,2020,4,20,0,16
D31,Break & Enter-Commercial,2020,1,23,0,22
D31,Break & Enter-Commercial,2020,4,21,0,17
D31,Break & Enter-Commercial,2020,12,41,0,29
D31,Break & Enter-House,2020,1,6,0,5
D31,Break & Enter-House,2020,3,9,0,6
D31,Break & Enter-House,2020,2,10,0,8
D31,Break & Enter-House,2020,0,3,0,3
D31,Break & Enter-House,2020,2,3,0,1
D31,Break & Enter-House,2020,1,4,0,3
D31,Break & Enter-House,2020,1,7,0,6
D31,Break & Enter-House,2020,3,13,0,10
D31,Break & Enter-Other,2020,1,3,0,2
D31,Break & Enter-Other,2020,0,5,0,5
D31,Break & Enter-Other,2020,0,1,0,1
D31,Break & Enter-Other,2020,0,3,0,3
D31,Break & Enter-Other,2020,1,5,0,4
D31,Break & Enter-Other,2020,0,2,0,2
D31,Break & Enter-Other,2020,3,10,0,7
D31,Fraud,2020,7,88,0,81
D31,Fraud,2020,2,34,0,32
D31,Fraud,2020,4,139,0,135
D31,Fraud,2020,6,72,0,66
D31,Fraud,2020,1,50,0,49
D31,Fraud,2020,0,5,0,5
D31,Fraud,2020,10,101,0,91
D23,Break & Enter-Apartment,2020,0,2,0,2
D23,Theft Over $5000,2020,1,8,0,7
D22,Break & Enter-Other,2020,0,4,0,4
D22,Break & Enter-Other,2020,0,2,0,2
D23,Robbery-Other,2020,5,15,0,10
D22,Fraud,2020,6,30,0,24
D22,Other,2020,34,39,0,5
D23,Break & Enter-Apartment,2020,1,9,0,8
D22,Fraud,2020,4,25,0,21
D23,Sexual Violation,2020,5,8,0,3
D23,Theft Over $5000,2020,0,1,0,1
D22,Other,2020,26,38,0,12
D23,Break & Enter-Apartment,2020,0,2,0,2
D22,Fraud,2020,3,38,0,35
D23,Sexual Violation,2020,2,6,0,4
D23,Theft Over $5000,2020,0,5,0,5
D22,Other,2020,7,8,0,1
D23,Break & Enter-Commercial,2020,0,4,0,4
D22,Fraud,2020,25,171,0,146
D23,Sexual Violation,2020,2,8,0,6
D23,Theft Over $5000,2020,5,56,0,51
D22,Other,2020,59,61,0,2
D23,Break & Enter-Commercial,2020,0,3,0,3
D22,Fraud,2020,3,37,0,34
D23,Sexual Violation,2020,9,17,0,8
D23,Theft Over $5000,2020,1,4,0,3
D22,Other,2020,12,15,0,3
D23,Break & Enter-Commercial,2020,1,1,1,0
D22,Fraud,2020,3,63,0,60
D23,Sexual Violation,2020,1,2,0,1
D23,Theft Under $5000,2020,1,6,0,5
D22,Other,2020,213,230,0,17
D23,Break & Enter-Commercial,2020,2,4,0,2
D22,Fraud,2020,4,80,0,76
D23,Sexual Violation,2020,1,3,0,2
D23,Theft Under $5000,2020,17,108,0,91
D22,Other,2020,48,50,0,2
D23,Break & Enter-Commercial,2020,0,1,0,1
D22,Fraud,2020,1,22,0,21
D23,Sexual Violation,2020,6,10,0,4
D23,Theft Under $5000,2020,3,49,0,46
D22,Other,2020,48,53,0,5
D23,Break & Enter-Commercial,2020,0,3,0,3
D22,Fraud,2020,0,29,0,29
D23,Sexual Violation,2020,18,29,0,11
D23,Theft Under $5000,2020,10,118,0,108
D22,Other,2020,6,9,0,3
D22,Fraud,2020,1,30,0,29
D23,Break & Enter-Commercial,2020,1,6,0,5
D22,Fraud,2020,4,63,0,59
D23,Sexual Violation,2020,6,11,0,5
D23,Theft Under $5000,2020,33,301,0,268
D22,Other,2020,30,38,0,8
D23,Break & Enter-Commercial,2020,12,82,0,70
D22,Fraud,2020,4,37,0,33
D23,Other,2020,2,2,1,0
D23,Theft Under $5000,2020,0,12,0,12
D22,Other Criminal Violations - Offensive Weapons,2020,5,5,1,0
D23,Break & Enter-Commercial,2020,1,7,0,6
D22,Fraud,2020,1,24,0,23
D23,Other,2020,5,5,1,0
D23,Theft Under $5000,2020,0,1,0,1
D22,Other Criminal Violations - Offensive Weapons,2020,2,3,0,1
D23,Break & Enter-House,2020,1,6,0,5
D22,Fraud,2020,3,63,0,60
D23,Other,2020,8,9,0,1
D23,Theft Under $5000,2020,6,86,0,80
D22,Other Criminal Violations - Offensive Weapons,2020,10,11,0,1
D23,Break & Enter-House,2020,1,5,0,4
D22,Other,2020,13,32,0,19
D23,Other,2020,5,6,0,1
D23,Theft Under $5000,2020,8,80,0,72
D22,Other Criminal Violations - Offensive Weapons,2020,4,4,1,0
D23,Break & Enter-House,2020,1,6,0,5
D22,Other,2020,8,30,0,22
D23,Other,2020,17,18,0,1
D23,Theft Under $5000,2020,81,759,0,678
D22,Other Criminal Violations - Offensive Weapons,2020,5,6,0,1
D23,Break & Enter-House,2020,1,5,0,4
D22,Other,2020,15,51,0,36
D23,Other,2020,1,1,1,0
D23,Theft Under $5000,2020,22,148,0,126
D22,Other Criminal Violations - Offensive Weapons,2020,2,2,1,0
D23,Break & Enter-House,2020,5,9,0,4
D22,Other,2020,26,171,0,145
D23,Other,2020,7,8,0,1
D23,Assault,2020,4,4,1,0
D23,Break & Enter-House,2020,0,1,0,1
D22,Other Criminal Violations - Offensive Weapons,2020,1,1,1,0
D23,Break & Enter-House,2020,3,8,0,5
D22,Other,2020,18,42,0,24
D23,Other,2020,8,8,1,0
D23,Assault,2020,26,46,0,20
D22,Other Criminal Violations - Offensive Weapons,2020,2,2,1,0
D22,Theft Under $5000,2020,163,743,0,580
D23,Break & Enter-House,2020,3,9,0,6
D22,Other,2020,22,59,0,37
D23,Other,2020,34,39,0,5
D23,Assault,2020,0,1,0,1
D22,Theft Under $5000,2020,6,44,0,38
D22,Other Criminal Violations - Offensive Weapons,2020,6,7,0,1
D23,Break & Enter-Other,2020,0,1,0,1
D22,Other,2020,12,70,0,58
D23,Other,2020,3,3,1,0
D23,Assault,2020,14,22,0,8
D22,Theft Under $5000,2020,5,132,0,127
D22,Other Criminal Violations - Offensive Weapons,2020,38,46,0,8
D23,Break & Enter-Other,2020,0,1,0,1
D22,Other,2020,4,26,0,22
D23,Other,2020,11,13,0,2
D23,Assault,2020,0,1,0,1
D22,Theft Under $5000,2020,0,1,0,1
D22,Other Criminal Violations - Offensive Weapons,2020,7,7,1,0
D23,Break & Enter-Other,2020,1,3,0,2
D22,Other,2020,14,70,0,56
D23,Other,2020,7,7,1,0
D23,Assault,2020,70,92,0,22
D22,Theft Under $5000,2020,54,365,0,311
D22,Other Criminal Violations - Offensive Weapons,2020,3,3,1,0
D23,Break & Enter-Other,2020,0,2,0,2
D22,Other,2020,10,35,0,25
D23,Other,2020,0,1,0,1
D23,Assault,2020,114,185,0,71
D22,Theft Under $5000,2020,8,88,0,80
D22,Other Criminal Violations - Offensive Weapons,2020,4,6,0,2
D23,Break & Enter-Other,2020,1,1,1,0
D22,Other,2020,44,117,0,73
D23,Other,2020,19,25,0,6
D23,Assault,2020,1,1,1,0
D22,Theft Under $5000,2020,44,188,0,144
D22,Theft Under $5000,2020,21,92,0,71
D22,Theft Under $5000,2020,14,122,0,108
D22,Theft Under $5000,2020,0,4,0,4
D22,Theft Under $5000,2020,20,162,0,142
D22,Theft Under $5000,2020,8,86,0,78
D22,Theft Under $5000,2020,33,280,0,247
D22,Assault,2020,26,32,0,6
D22,Assault,2020,22,27,0,5
D22,Assault,2020,23,35,0,12
D22,Assault,2020,70,126,0,56
D22,Assault,2020,29,54,0,25
D22,Assault,2020,52,73,0,21
D22,Assault,2020,41,68,0,27
D22,Assault,2020,2,11,0,9
D22,Assault,2020,35,60,0,25
D22,Assault,2020,23,40,0,17
D22,Assault,2020,136,184,0,48
D22,Assault,2020,0,1,0,1
D22,Assault,2020,42,78,0,36
D22,Assault,2020,14,19,0,5
D22,Assault,2020,60,95,0,35
D22,Attempt Murder,2020,1,1,1,0
D22,Other,2020,7,9,0,2
D22,Other,2020,9,12,0,3
D22,Other,2020,5,13,0,8
D22,Other,2020,14,19,0,5
D22,Other,2020,3,6,0,3
D22,Other,2020,11,17,0,6
D22,Other,2020,8,10,0,2
D22,Other,2020,1,3,0,2
D22,Other,2020,9,16,0,7
D22,Other,2020,0,1,0,1
D22,Other,2020,35,42,0,7
D22,Other,2020,10,22,0,12
D22,Other,2020,3,7,0,4
D22,Other,2020,5,9,0,4
D22,Robbery-Financial,2020,4,4,1,0
D22,Robbery-Financial,2020,1,1,1,0
D22,Robbery-Financial,2020,1,1,1,0
D23,Break & Enter-Other,2020,0,2,0,2
D22,Other,2020,0,1,0,1
D22,Other,2020,0,4,0,4
D23,Other,2020,70,78,0,8
D23,Assault,2020,0,1,0,1
D23,Break & Enter-Other,2020,3,12,0,9
D22,Other,2020,26,86,0,60
D23,Other,2020,16,19,0,3
D23,Assault,2020,33,46,0,13
D23,Break & Enter-Other,2020,2,3,0,1
D23,Assault,2020,35,50,0,15
D22,Other,2020,2,2,1,0
D22,Other,2020,5,29,0,24
D23,Other,2020,13,18,0,5
D23,Fraud,2020,0,4,0,4
D23,Assault,2020,144,236,0,92
D22,Other,2020,1,1,1,0
D22,Other,2020,15,83,0,68
D23,Other,2020,10,13,0,3
D23,Fraud,2020,1,36,0,35
D23,Assault,2020,64,87,0,23
D22,Other,2020,2,2,1,0
D22,Theft Over $5000,2020,1,5,0,4
D23,Other,2020,84,98,0,14
D23,Fraud,2020,0,1,0,1
D23,Attempt Murder,2020,1,1,1,0
D22,Other,2020,1,1,1,0
D22,Theft Over $5000,2020,0,1,0,1
D23,Other,2020,19,23,0,4
D23,Fraud,2020,1,20,0,19
D23,Attempt Murder,2020,1,1,1,0
D23,Other,2020,1,1,1,0
D22,Theft Over $5000,2020,1,3,0,2
D23,Other Criminal Violations - Offensive Weapons,2020,1,1,1,0
D23,Fraud,2020,0,1,0,1
D23,Attempt Murder,2020,4,6,0,2
D23,Other,2020,5,5,1,0
D22,Theft Over $5000,2020,1,23,0,22
D23,Other Criminal Violations - Offensive Weapons,2020,2,3,0,1
D23,Fraud,2020,3,51,0,48
D23,Attempt Murder,2020,1,1,1,0
D23,Other,2020,2,2,1,0
D22,Theft Over $5000,2020,1,7,0,6
D23,Other Criminal Violations - Offensive Weapons,2020,1,1,1,0
D23,Fraud,2020,11,123,0,112
D23,Attempt Murder,2020,0,1,0,1
D23,Other,2020,3,3,1,0
D22,Theft Over $5000,2020,2,11,0,9
D23,Other Criminal Violations - Offensive Weapons,2020,5,8,0,3
D23,Other,2020,3,7,0,4
D23,Other,2020,2,2,1,0
D22,Theft Over $5000,2020,0,8,0,8
D23,Other Criminal Violations - Offensive Weapons,2020,2,2,1,0
D22,Theft Over $5000,2020,1,3,0,2
D23,Fraud,2020,0,6,0,6
D23,Other,2020,2,5,0,3
D23,Other,2020,15,19,0,4
D23,Other Criminal Violations - Offensive Weapons,2020,0,1,0,1
D22,Theft Over $5000,2020,0,4,0,4
D23,Fraud,2020,6,45,0,39
D23,Other,2020,13,19,0,6
D23,Other,2020,2,2,1,0
D23,Other Criminal Violations - Offensive Weapons,2020,13,16,0,3
D22,Theft Over $5000,2020,0,7,0,7
D23,Fraud,2020,4,38,0,34
D23,Other,2020,34,43,0,9
D23,Auto Theft,2020,0,8,0,8
D23,Other Criminal Violations - Offensive Weapons,2020,0,1,0,1
D22,Theft Over $5000,2020,1,8,0,7
D23,Fraud,2020,30,188,0,158
D23,Other,2020,7,13,0,6
D23,Auto Theft,2020,3,42,0,39
D23,Other,2020,1,2,0,1
D22,Theft Over $5000,2020,1,5,0,4
D23,Fraud,2020,4,57,0,53
D23,Other,2020,2,8,0,6
D23,Auto Theft,2020,0,23,0,23
D23,Other,2020,1,3,0,2
D22,Theft Over $5000,2020,0,4,0,4
D23,Other,2020,1,4,0,3
D23,Other,2020,24,34,0,10
D23,Auto Theft,2020,1,60,0,59
D23,Other,2020,1,1,1,0
D23,Other,2020,6,40,0,34
D23,Other,2020,6,22,0,16
D23,Auto Theft,2020,4,87,0,83
D31,Other,2020,7,10,0,3
D23,Other,2020,4,35,0,31
D23,Robbery-Financial,2020,1,1,1,0
D23,Auto Theft,2020,1,2,0,1
D31,Other,2020,4,4,1,0
D31,Other,2020,12,15,0,3
D31,Other,2020,4,5,0,1
D31,Other,2020,4,4,1,0
D23,Other,2020,11,57,0,46
D23,Robbery-Other,2020,1,6,0,5
D23,Auto Theft,2020,5,41,0,36
D23,Other,2020,20,91,0,71
D23,Robbery-Other,2020,1,2,0,1
D23,Auto Theft,2020,2,43,0,41
D23,Other,2020,0,1,0,1
D23,Robbery-Other,2020,3,4,0,1
D23,Auto Theft,2020,14,410,0,396
D23,Other,2020,0,3,0,3
D23,Auto Theft,2020,0,70,0,70
D23,Other,2020,9,49,0,40
D23,Break & Enter-Apartment,2020,1,2,0,1
D23,Other,2020,4,30,0,26
D23,Break & Enter-Apartment,2020,1,4,0,3
D23,Other,2020,36,190,0,154
D23,Break & Enter-Apartment,2020,2,7,0,5
D23,Break & Enter-Apartment,2020,1,5,0,4
D22,Robbery-Financial,2020,1,2,0,1
D22,Robbery-Financial,2020,2,2,1,0
D22,Robbery-Financial,2020,1,1,1,0
D22,Robbery-Other,2020,2,12,0,10
D22,Robbery-Other,2020,0,5,0,5
D22,Robbery-Other,2020,10,15,0,5
D22,Robbery-Other,2020,9,13,0,4
D22,Robbery-Other,2020,1,8,0,7
D22,Robbery-Other,2020,1,5,0,4
D22,Robbery-Other,2020,9,11,0,2
D22,Robbery-Other,2020,0,3,0,3
D22,Robbery-Other,2020,3,11,0,8
D22,Robbery-Other,2020,10,13,0,3
D22,Robbery-Other,2020,2,2,1,0
D22,Robbery-Other,2020,9,10,0,1
D22,Robbery-Other,2020,1,8,0,7
D22,Robbery-Other,2020,6,15,0,9
D22,Sexual Violation,2020,3,6,0,3
D22,Sexual Violation,2020,4,5,0,1
D22,Sexual Violation,2020,3,4,0,1
D22,Sexual Violation,2020,12,20,0,8
D22,Sexual Violation,2020,1,3,0,2
D22,Sexual Violation,2020,6,10,0,4
D22,Sexual Violation,2020,3,6,0,3
D22,Sexual Violation,2020,6,10,0,4
D22,Sexual Violation,2020,3,5,0,2
D22,Sexual Violation,2020,4,8,0,4
D22,Sexual Violation,2020,10,15,0,5
D22,Sexual Violation,2020,1,3,0,2
D22,Sexual Violation,2020,6,10,0,4
D22,Other,2020,4,5,0,1
D22,Other,2020,4,4,1,0
D22,Other,2020,3,3,1,0
D22,Other,2020,20,22,0,2
D22,Other,2020,9,10,0,1
D22,Other,2020,20,20,1,0
D22,Other,2020,10,10,1,0
D22,Other,2020,2,2,1,0
D22,Other,2020,1,1,1,0
D22,Other,2020,7,7,1,0
D22,Other,2020,2,2,1,0
D22,Other,2020,13,13,1,0
D22,Other,2020,4,4,1,0
D22,Other,2020,9,9,1,0
D22,Other,2020,4,4,1,0
D22,Other,2020,24,26,0,2
D22,Other,2020,13,15,0,2
D22,Other,2020,5,7,0,2
D22,Other,2020,19,21,0,2
D22,Other,2020,67,85,0,18
D32,Break & Enter-Other,2020,1,2,0,1
D32,Break & Enter-Other,2020,0,1,0,1
D31,Other,2020,3,3,1,0
D32,Break & Enter-Apartment,2020,2,8,0,6
D32,Attempt Murder,2020,4,4,1,0
D32,Fraud,2020,3,54,0,51
D31,Other,2020,26,48,0,22
D32,Fraud,2020,4,57,0,53
D32,Break & Enter-Apartment,2020,2,6,0,4
D32,Attempt Murder,2020,0,1,0,1
D31,Other,2020,7,10,0,3
D32,Fraud,2020,0,1,0,1
D32,Break & Enter-Apartment,2020,1,2,0,1
D32,Attempt Murder,2020,0,1,0,1
D31,Other,2020,32,64,0,32
D32,Fraud,2020,2,92,0,90
D32,Break & Enter-Apartment,2020,0,2,0,2
D32,Other,2020,2,10,0,8
D31,Robbery-Financial,2020,1,1,1,0
D32,Fraud,2020,0,14,0,14
D31,Other Criminal Violations - Offensive Weapons,2020,15,20,0,5
D32,Sexual Violation,2020,7,13,0,6
D32,Break & Enter-Apartment,2020,1,1,1,0
D32,Break & Enter-Commercial,2020,2,7,0,5
D32,Break & Enter-Commercial,2020,2,12,0,10
D32,Break & Enter-Commercial,2020,4,28,0,24
D32,Break & Enter-Commercial,2020,1,3,0,2
D32,Break & Enter-Commercial,2020,3,24,0,21
D32,Break & Enter-Commercial,2020,1,10,0,9
D32,Break & Enter-Commercial,2020,2,7,0,5
D32,Break & Enter-Commercial,2020,0,3,0,3
D32,Break & Enter-Commercial,2020,7,15,0,8
D32,Break & Enter-Commercial,2020,1,8,0,7
D32,Break & Enter-Commercial,2020,0,7,0,7
D32,Break & Enter-Commercial,2020,0,5,0,5
D32,Break & Enter-Commercial,2020,2,8,0,6
D32,Break & Enter-Commercial,2020,0,1,0,1
D32,Break & Enter-Commercial,2020,1,1,1,0
D32,Break & Enter-Commercial,2020,0,4,0,4
D32,Break & Enter-Commercial,2020,11,24,0,13
D32,Break & Enter-Commercial,2020,7,24,0,17
D32,Break & Enter-Commercial,2020,4,29,0,25
D32,Break & Enter-House,2020,0,3,0,3
D32,Break & Enter-House,2020,1,6,0,5
D32,Break & Enter-House,2020,1,11,0,10
D32,Break & Enter-House,2020,3,10,0,7
D32,Break & Enter-House,2020,0,6,0,6
D32,Break & Enter-House,2020,1,5,0,4
D32,Break & Enter-House,2020,2,28,0,26
D32,Break & Enter-House,2020,2,9,0,7
D32,Break & Enter-House,2020,0,19,0,19
D32,Break & Enter-House,2020,0,9,0,9
D32,Break & Enter-House,2020,3,19,0,16
D32,Break & Enter-House,2020,2,14,0,12
D32,Break & Enter-House,2020,1,30,0,29
D32,Break & Enter-House,2020,0,5,0,5
D32,Break & Enter-House,2020,2,13,0,11
D32,Break & Enter-House,2020,2,6,0,4
D32,Break & Enter-Other,2020,0,3,0,3
D32,Break & Enter-Other,2020,0,5,0,5
D32,Break & Enter-Other,2020,0,2,0,2
D32,Break & Enter-Other,2020,2,5,0,3
D32,Break & Enter-Other,2020,3,4,0,1
D32,Break & Enter-Other,2020,0,1,0,1
D32,Break & Enter-Other,2020,0,1,0,1
D32,Break & Enter-Other,2020,0,1,0,1
D32,Break & Enter-Other,2020,0,1,0,1
D32,Break & Enter-Other,2020,0,1,0,1
D31,Fraud,2020,0,13,0,13
D32,Theft Over $5000,2020,0,8,0,8
D31,Robbery-Other,2020,11,18,0,7
D32,Fraud,2020,9,71,0,62
D32,Fraud,2020,1,24,0,23
D32,Fraud,2020,5,67,0,62
D32,Fraud,2020,11,53,0,42
D32,Fraud,2020,6,73,0,67
D32,Other,2020,7,15,0,8
D32,Sexual Violation,2020,5,11,0,6
D32,Theft Over $5000,2020,0,1,0,1
D31,Other,2020,2,2,1,0
D32,Fraud,2020,1,48,0,47
D31,Robbery-Other,2020,1,5,0,4
D32,Other,2020,8,10,0,2
D32,Sexual Violation,2020,2,5,0,3
D32,Theft Over $5000,2020,0,10,0,10
D31,Other,2020,3,4,0,1
D32,Fraud,2020,1,7,0,6
D31,Robbery-Other,2020,19,40,0,21
D32,Other,2020,3,4,0,1
D32,Sexual Violation,2020,1,7,0,6
D32,Theft Over $5000,2020,3,9,0,6
D31,Other,2020,0,1,0,1
D32,Fraud,2020,3,52,0,49
D31,Robbery-Other,2020,6,21,0,15
D32,Other,2020,5,8,0,3
D32,Sexual Violation,2020,9,18,0,9
D32,Theft Over $5000,2020,0,1,0,1
D31,Other,2020,2,2,1,0
D32,Fraud,2020,8,110,0,102
D31,Robbery-Other,2020,6,13,0,7
D32,Other,2020,6,10,0,4
D31,Fraud,2020,14,184,0,170
D32,Sexual Violation,2020,1,3,0,2
D32,Theft Over $5000,2020,1,6,0,5
D31,Other,2020,1,1,1,0
D32,Fraud,2020,1,30,0,29
D31,Robbery-Other,2020,3,4,0,1
D32,Other,2020,6,9,0,3
D31,Other,2020,45,148,0,103
D32,Sexual Violation,2020,5,11,0,6
D32,Theft Over $5000,2020,0,9,0,9
D31,Other,2020,2,2,1,0
D32,Fraud,2020,2,64,0,62
D31,Robbery-Other,2020,22,41,0,19
D32,Other,2020,6,16,0,10
D31,Other,2020,14,54,0,40
D32,Sexual Violation,2020,3,11,0,8
D32,Theft Over $5000,2020,1,10,0,9
D32,Theft Over $5000,2020,1,11,0,10
D32,Theft Over $5000,2020,1,15,0,14
D32,Theft Under $5000,2020,20,143,0,123
D32,Theft Under $5000,2020,8,114,0,106
D32,Theft Under $5000,2020,0,1,0,1
D32,Theft Under $5000,2020,23,218,0,195
D32,Theft Under $5000,2020,3,38,0,35
D32,Theft Under $5000,2020,67,267,0,200
D32,Theft Under $5000,2020,7,58,0,51
D32,Theft Under $5000,2020,2,93,0,91
D32,Theft Under $5000,2020,29,156,0,127
D32,Theft Under $5000,2020,21,203,0,182
D32,Theft Under $5000,2020,27,158,0,131
D32,Theft Under $5000,2020,0,1,0,1
D32,Theft Under $5000,2020,1,11,0,10
D32,Theft Under $5000,2020,2,74,0,72
D32,Theft Under $5000,2020,27,243,0,216
D32,Theft Under $5000,2020,5,73,0,68
D32,Theft Under $5000,2020,9,133,0,124
D32,Theft Under $5000,2020,5,150,0,145
D32,Theft Under $5000,2020,64,435,0,371
D32,Theft Under $5000,2020,86,293,0,207
D32,Theft Under $5000,2020,179,623,0,444
D32,Assault,2020,28,38,0,10
D32,Assault,2020,39,57,0,18
D32,Assault,2020,18,34,0,16
D32,Assault,2020,14,19,0,5
D32,Assault,2020,48,72,0,24
D32,Assault,2020,20,37,0,17
D32,Assault,2020,20,35,0,15
D32,Assault,2020,39,76,0,37
D32,Assault,2020,44,89,0,45
D32,Assault,2020,16,40,0,24
D32,Assault,2020,3,6,0,3
D32,Assault,2020,28,56,0,28
D32,Assault,2020,79,156,0,77
D32,Assault,2020,16,19,0,3
D32,Assault,2020,52,84,0,32
D32,Assault,2020,37,75,0,38
D32,Assault,2020,36,58,0,22
D32,Assault,2020,33,55,0,22
D32,Assault,2020,53,82,0,29
D32,Fraud,2020,4,69,0,65
D32,Other,2020,7,16,0,9
D32,Other,2020,1,1,1,0
D31,Robbery-Other,2020,3,5,0,2
D32,Sexual Violation,2020,5,7,0,2
D32,Fraud,2020,20,117,0,97
D31,Other,2020,52,155,0,103
D32,Other,2020,7,9,0,2
D32,Fraud,2020,8,74,0,66
D32,Sexual Violation,2020,3,4,0,1
D31,Robbery-Other,2020,13,29,0,16
D32,Other,2020,3,3,1,0
D31,Other,2020,13,70,0,57
D32,Other,2020,1,1,1,0
D32,Fraud,2020,17,96,0,79
D32,Sexual Violation,2020,2,9,0,7
D31,Sexual Violation,2020,11,26,0,15
D32,Other,2020,3,3,1,0
D31,Other,2020,14,67,0,53
D32,Other,2020,8,20,0,12
D32,Other,2020,9,41,0,32
D32,Other,2020,5,6,0,1
D31,Sexual Violation,2020,8,14,0,6
D32,Other,2020,1,2,0,1
D31,Other,2020,0,3,0,3
D32,Other,2020,26,38,0,12
D32,Other,2020,15,60,0,45
D32,Other,2020,10,10,1,0
D31,Sexual Violation,2020,11,33,0,22
D31,Other,2020,48,115,0,67
D32,Other,2020,0,5,0,5
D32,Other,2020,6,56,0,50
D32,Other,2020,2,2,1,0
D31,Sexual Violation,2020,12,17,0,5
D32,Other,2020,2,2,1,0
D31,Other,2020,5,14,0,9
D32,Other,2020,4,4,1,0
D32,Other,2020,7,16,0,9
D32,Other,2020,4,14,0,10
D31,Sexual Violation,2020,4,11,0,7
D32,Other,2020,5,5,1,0
D31,Other,2020,1,1,1,0
D32,Other,2020,2,2,1,0
D32,Other,2020,11,25,0,14
D32,Other,2020,24,98,0,74
D32,Other,2020,2,2,1,0
D31,Sexual Violation,2020,1,1,1,0
D31,Other,2020,48,173,0,125
D32,Other,2020,1,2,0,1
D32,Other,2020,8,11,0,3
D32,Other,2020,5,31,0,26
D32,Other,2020,2,3,0,1
D31,Sexual Violation,2020,14,22,0,8
D31,Theft Over $5000,2020,1,17,0,16
D32,Other,2020,6,6,1,0
D32,Other,2020,6,12,0,6
D32,Other,2020,9,51,0,42
D32,Other,2020,1,2,0,1
D31,Sexual Violation,2020,8,8,1,0
D31,Theft Over $5000,2020,1,9,0,8
D32,Other,2020,4,4,1,0
D32,Other,2020,13,21,0,8
D32,Other,2020,16,49,0,33
D32,Other,2020,8,8,1,0
D31,Sexual Violation,2020,9,30,0,21
D31,Theft Over $5000,2020,6,19,0,13
D32,Other,2020,1,1,1,0
D32,Robbery-Financial,2020,0,1,0,1
D32,Other,2020,1,1,1,0
D32,Other,2020,19,67,0,48
D31,Other,2020,3,4,0,1
D32,Robbery-Financial,2020,1,1,1,0
D32,Other,2020,8,9,0,1
D32,Other,2020,1,1,1,0
D32,Other,2020,10,40,0,30
D31,Other,2020,14,14,1,0
D32,Robbery-Financial,2020,2,2,1,0
D32,Other,2020,3,3,1,0
D32,Other,2020,0,2,0,2
D31,Other,2020,34,41,0,7
D32,Robbery-Other,2020,2,8,0,6
D31,Other,2020,13,15,0,2
D32,Other,2020,8,9,0,1
D32,Auto Theft,2020,3,33,0,30
D32,Other,2020,0,5,0,5
D32,Robbery-Other,2020,3,5,0,2
D31,Other,2020,10,10,1,0
D32,Other,2020,6,6,1,0
D32,Auto Theft,2020,2,47,0,45
D32,Other,2020,6,39,0,33
D32,Robbery-Other,2020,5,11,0,6
D31,Other,2020,2,2,1,0
D32,Other,2020,9,11,0,2
D32,Auto Theft,2020,5,58,0,53
D32,Other,2020,22,99,0,77
D32,Robbery-Other,2020,2,4,0,2
D31,Other,2020,15,18,0,3
D32,Other,2020,11,12,0,1
D32,Auto Theft,2020,0,9,0,9
D32,Other,2020,4,16,0,12
D32,Robbery-Other,2020,5,10,0,5
D31,Other,2020,8,9,0,1
D32,Other,2020,11,12,0,1
D32,Auto Theft,2020,2,43,0,41
D32,Other,2020,13,83,0,70
D32,Robbery-Other,2020,1,14,0,13
D31,Other,2020,17,19,0,2
D32,Other,2020,6,6,1,0
D32,Auto Theft,2020,1,14,0,13
D32,Other,2020,26,78,0,52
D32,Robbery-Other,2020,8,17,0,9
D31,Other,2020,77,102,0,25
D32,Other,2020,12,14,0,2
D32,Auto Theft,2020,0,25,0,25
D31,Theft Over $5000,2020,3,21,0,18
D32,Robbery-Other,2020,6,9,0,3
D32,Auto Theft,2020,0,6,0,6
D31,Theft Over $5000,2020,1,12,0,11
D32,Robbery-Other,2020,7,11,0,4
D32,Other,2020,10,49,0,39
D31,Other,2020,26,31,0,5
D32,Auto Theft,2020,4,47,0,43
D32,Other,2020,20,24,0,4
D31,Theft Over $5000,2020,0,1,0,1
D32,Robbery-Other,2020,0,2,0,2
D32,Other,2020,19,73,0,54
D31,Other,2020,91,111,0,20
D32,Other,2020,23,29,0,6
D31,Theft Over $5000,2020,1,14,0,13
D32,Robbery-Other,2020,6,12,0,6
D32,Other,2020,145,209,0,64
D31,Other,2020,20,23,0,3
D32,Theft Over $5000,2020,1,3,0,2
D32,Other,2020,19,23,0,4
D32,Auto Theft,2020,0,23,0,23
D31,Theft Over $5000,2020,1,8,0,7
D32,Robbery-Other,2020,2,20,0,18
D31,Other,2020,124,141,0,17
D32,Theft Over $5000,2020,1,7,0,6
D32,Other,2020,3,4,0,1
D32,Auto Theft,2020,0,4,0,4
D31,Theft Over $5000,2020,3,31,0,28
D32,Robbery-Other,2020,0,6,0,6
D31,Other,2020,5,6,0,1
D32,Theft Over $5000,2020,1,8,0,7
D32,Other,2020,28,36,0,8
D32,Auto Theft,2020,3,40,0,37
D31,Theft Under $5000,2020,42,239,0,197
D32,Robbery-Other,2020,4,14,0,10
D31,Other,2020,76,111,0,35
D32,Theft Over $5000,2020,2,4,0,2
D32,Other,2020,14,16,0,2
D32,Auto Theft,2020,2,63,0,61
D31,Theft Under $5000,2020,8,101,0,93
D32,Robbery-Other,2020,7,17,0,10
D31,Other,2020,14,15,0,1
D32,Theft Over $5000,2020,2,5,0,3
D32,Other,2020,17,28,0,11
D32,Auto Theft,2020,2,23,0,21
D31,Theft Under $5000,2020,82,311,0,229
D32,Robbery-Other,2020,4,6,0,2
D31,Other,2020,54,72,0,18
D32,Theft Over $5000,2020,0,1,0,1
D32,Other,2020,40,48,0,8
D32,Auto Theft,2020,0,49,0,49
D31,Theft Under $5000,2020,21,176,0,155
D32,Robbery-Other,2020,1,5,0,4
D31,Other Criminal Violations - Offensive Weapons,2020,14,23,0,9
D32,Theft Over $5000,2020,0,4,0,4
D32,Other,2020,18,26,0,8
D32,Auto Theft,2020,2,45,0,43
D31,Theft Under $5000,2020,3,99,0,96
D32,Robbery-Other,2020,7,19,0,12
D32,Theft Over $5000,2020,2,4,0,2
D32,Other,2020,15,20,0,5
D32,Auto Theft,2020,2,24,0,22
D31,Theft Under $5000,2020,6,24,0,18
D32,Sexual Violation,2020,3,3,1,0
D31,Theft Under $5000,2020,111,410,0,299
D31,Other Criminal Violations - Offensive Weapons,2020,10,12,0,2
D32,Auto Theft,2020,8,61,0,53
D32,Other,2020,9,10,0,1
D32,Sexual Violation,2020,4,7,0,3
D31,Theft Under $5000,2020,2,43,0,41
D31,Other Criminal Violations - Offensive Weapons,2020,34,38,0,4
D32,Auto Theft,2020,9,60,0,51
D32,Other,2020,14,17,0,3
D32,Sexual Violation,2020,0,2,0,2
D31,Theft Under $5000,2020,101,524,0,423
D31,Other Criminal Violations - Offensive Weapons,2020,7,12,0,5
D32,Break & Enter-Apartment,2020,1,3,0,2
D32,Other,2020,42,48,0,6
D32,Sexual Violation,2020,1,1,1,0
D31,Assault,2020,176,227,0,51
D31,Other Criminal Violations - Offensive Weapons,2020,6,9,0,3
D32,Break & Enter-Apartment,2020,2,6,0,4
D32,Other,2020,10,10,1,0
D32,Sexual Violation,2020,10,18,0,8
D31,Assault,2020,46,81,0,35
D31,Other Criminal Violations - Offensive Weapons,2020,1,1,1,0
D32,Break & Enter-Apartment,2020,0,3,0,3
D32,Other,2020,34,44,0,10
D32,Sexual Violation,2020,0,1,0,1
D31,Assault,2020,144,237,0,93
D31,Other Criminal Violations - Offensive Weapons,2020,1,1,1,0
D32,Break & Enter-Apartment,2020,1,1,1,0
D32,Other,2020,63,71,0,8
D32,Sexual Violation,2020,6,6,1,0
D31,Assault,2020,37,76,0,39
D31,Other Criminal Violations - Offensive Weapons,2020,14,19,0,5
D32,Break & Enter-Apartment,2020,1,1,1,0
D32,Other,2020,21,26,0,5
D31,Assault,2020,48,74,0,26
D32,Other,2020,169,191,0,22
D31,Other Criminal Violations - Offensive Weapons,2020,2,4,0,2
D32,Break & Enter-Apartment,2020,0,1,0,1
D32,Other,2020,84,94,0,10
D31,Assault,2020,6,14,0,8
D32,Other Criminal Violations - Offensive Weapons,2020,1,1,1,0
D31,Assault,2020,120,199,0,79
D32,Other Criminal Violations - Offensive Weapons,2020,4,6,0,2
D31,Assault,2020,23,32,0,9
D32,Break & Enter-Apartment,2020,0,1,0,1
D31,Assault,2020,153,246,0,93
D32,Break & Enter-Apartment,2020,3,10,0,7
D31,Attempt Murder,2020,5,8,0,3
D32,Break & Enter-Apartment,2020,1,1,1,0
D31,Attempt Murder,2020,2,2,1,0
D32,Break & Enter-Apartment,2020,0,1,0,1
D31,Attempt Murder,2020,2,4,0,2
D32,Break & Enter-Apartment,2020,2,13,0,11
D31,Attempt Murder,2020,2,2,1,0
D32,Break & Enter-Apartment,2020,2,8,0,6
D31,Attempt Murder,2020,5,5,1,0
D31,Attempt Murder,2020,1,2,0,1
D31,Other,2020,23,43,0,20
D31,Other,2020,15,15,1,0
D31,Other,2020,18,39,0,21
D31,Other,2020,5,10,0,5
D31,Other,2020,16,26,0,10
D41,Break & Enter-House,2020,0,1,0,1
D33,Sexual Violation,2020,3,5,0,2
D33,Assault,2020,62,98,0,36
D33,Sexual Violation,2020,4,6,0,2
D41,Theft Under $5000,2020,46,215,0,169
D32,Other Criminal Violations - Offensive Weapons,2020,2,3,0,1
D41,Other,2020,1,1,1,0
D41,Break & Enter-House,2020,1,2,0,1
D33,Sexual Violation,2020,0,1,0,1
D33,Break & Enter-Apartment,2020,6,23,0,17
D33,Assault,2020,4,5,0,1
D41,Theft Under $5000,2020,109,321,0,212
D32,Other Criminal Violations - Offensive Weapons,2020,1,1,1,0
D41,Other,2020,2,2,1,0
D41,Break & Enter-House,2020,3,8,0,5
D33,Other,2020,16,18,0,2
D33,Break & Enter-Apartment,2020,3,3,1,0
D33,Assault,2020,45,78,0,33
D41,Theft Under $5000,2020,7,42,0,35
D41,Theft Under $5000,2020,62,323,0,261
D41,Theft Under $5000,2020,14,73,0,59
D41,Theft Under $5000,2020,8,76,0,68
D41,Theft Under $5000,2020,48,240,0,192
D41,Theft Under $5000,2020,40,64,0,24
D41,Theft Under $5000,2020,34,218,0,184
D41,Theft Under $5000,2020,216,594,0,378
D41,Assault,2020,12,19,0,7
D41,Assault,2020,25,42,0,17
D41,Assault,2020,86,136,0,50
D41,Assault,2020,118,181,0,63
D41,Assault,2020,19,26,0,7
D41,Assault,2020,77,109,0,32
D41,Assault,2020,16,23,0,7
D41,Assault,2020,51,70,0,19
D41,Assault,2020,99,166,0,67
D41,Assault,2020,4,13,0,9
D41,Assault,2020,86,140,0,54
D41,Assault,2020,100,140,0,40
D41,Attempt Murder,2020,1,1,1,0
D41,Attempt Murder,2020,2,2,1,0
D41,Other,2020,8,12,0,4
D41,Other,2020,4,6,0,2
D41,Other,2020,20,26,0,6
D41,Other,2020,20,36,0,16
D41,Other,2020,3,4,0,1
D41,Other,2020,23,37,0,14
D41,Other,2020,5,7,0,2
D41,Other,2020,11,14,0,3
D41,Other,2020,21,33,0,12
D41,Other,2020,0,1,0,1
D41,Other,2020,0,2,0,2
D41,Other,2020,13,22,0,9
D41,Other,2020,21,36,0,15
D41,Robbery-Financial,2020,1,1,1,0
D41,Robbery-Other,2020,3,4,0,1
D41,Robbery-Other,2020,3,16,0,13
D41,Robbery-Other,2020,13,22,0,9
D41,Robbery-Other,2020,4,6,0,2
D41,Robbery-Other,2020,8,21,0,13
D41,Robbery-Other,2020,7,7,1,0
D41,Robbery-Other,2020,1,2,0,1
D41,Robbery-Other,2020,13,24,0,11
D41,Robbery-Other,2020,0,1,0,1
D41,Robbery-Other,2020,16,24,0,8
D41,Robbery-Other,2020,8,23,0,15
D41,Sexual Violation,2020,3,4,0,1
D33,Break & Enter-Apartment,2020,2,8,0,6
D41,Other,2020,14,14,1,0
D33,Other,2020,2,4,0,2
D33,Break & Enter-Apartment,2020,0,5,0,5
D33,Assault,2020,25,40,0,15
D32,Other Criminal Violations - Offensive Weapons,2020,2,2,1,0
D41,Break & Enter-House,2020,2,7,0,5
D41,Other,2020,3,3,1,0
D33,Other,2020,2,2,1,0
D33,Assault,2020,1,1,1,0
D32,Other Criminal Violations - Offensive Weapons,2020,1,3,0,2
D41,Break & Enter-House,2020,4,16,0,12
D33,Break & Enter-Apartment,2020,1,2,0,1
D41,Other,2020,2,2,1,0
D33,Other,2020,5,6,0,1
D33,Assault,2020,15,32,0,17
D32,Other Criminal Violations - Offensive Weapons,2020,1,1,1,0
D41,Break & Enter-Other,2020,2,2,1,0
D33,Break & Enter-Apartment,2020,1,4,0,3
D41,Other,2020,6,6,1,0
D33,Other,2020,10,10,1,0
D33,Assault,2020,19,37,0,18
D32,Other Criminal Violations - Offensive Weapons,2020,2,3,0,1
D41,Break & Enter-Other,2020,2,3,0,1
D33,Break & Enter-Commercial,2020,3,10,0,7
D41,Other,2020,4,5,0,1
D33,Other,2020,4,5,0,1
D33,Assault,2020,14,26,0,12
D32,Other Criminal Violations - Offensive Weapons,2020,6,6,1,0
D41,Break & Enter-Other,2020,3,6,0,3
D33,Break & Enter-Commercial,2020,3,7,0,4
D41,Other,2020,6,6,1,0
D33,Other,2020,5,5,1,0
D33,Assault,2020,31,40,0,9
D32,Other Criminal Violations - Offensive Weapons,2020,3,3,1,0
D41,Break & Enter-Other,2020,1,5,0,4
D33,Break & Enter-Commercial,2020,0,6,0,6
D41,Other,2020,10,11,0,1
D33,Other,2020,5,5,1,0
D33,Assault,2020,2,3,0,1
D32,Other Criminal Violations - Offensive Weapons,2020,3,3,1,0
D41,Break & Enter-Other,2020,1,3,0,2
D33,Break & Enter-Commercial,2020,0,3,0,3
D41,Other,2020,1,1,1,0
D33,Other,2020,2,4,0,2
D33,Attempt Murder,2020,0,1,0,1
D32,Other Criminal Violations - Offensive Weapons,2020,13,15,0,2
D41,Break & Enter-Other,2020,2,7,0,5
D41,Break & Enter-Other,2020,0,1,0,1
D41,Break & Enter-Other,2020,1,2,0,1
D41,Break & Enter-Other,2020,0,3,0,3
D41,Break & Enter-Other,2020,1,2,0,1
D41,Fraud,2020,2,15,0,13
D41,Fraud,2020,6,35,0,29
D41,Fraud,2020,10,76,0,66
D41,Fraud,2020,14,84,0,70
D41,Fraud,2020,2,13,0,11
D41,Fraud,2020,36,125,0,89
D41,Fraud,2020,2,18,0,16
D41,Fraud,2020,5,53,0,48
D41,Fraud,2020,8,65,0,57
D41,Fraud,2020,3,9,0,6
D41,Fraud,2020,3,52,0,49
D41,Fraud,2020,35,129,0,94
D41,Other,2020,1,10,0,9
D41,Other,2020,8,35,0,27
D41,Other,2020,27,103,0,76
D41,Other,2020,41,120,0,79
D41,Other,2020,11,30,0,19
D41,Other,2020,35,114,0,79
D41,Other,2020,4,25,0,21
D41,Other,2020,14,32,0,18
D41,Other,2020,41,116,0,75
D41,Other,2020,4,9,0,5
D41,Other,2020,35,112,0,77
D41,Other,2020,44,144,0,100
D41,Theft Over $5000,2020,1,5,0,4
D41,Theft Over $5000,2020,2,6,0,4
D41,Theft Over $5000,2020,0,3,0,3
D41,Theft Over $5000,2020,1,5,0,4
D41,Theft Over $5000,2020,0,2,0,2
D41,Theft Over $5000,2020,1,9,0,8
D41,Theft Over $5000,2020,0,3,0,3
D41,Theft Over $5000,2020,1,4,0,3
D41,Theft Over $5000,2020,1,11,0,10
D41,Theft Under $5000,2020,4,23,0,19
D41,Theft Under $5000,2020,14,77,0,63
D41,Other,2020,22,24,0,2
D33,Other,2020,9,20,0,11
D33,Other,2020,1,1,1,0
D32,Other Criminal Violations - Offensive Weapons,2020,2,2,1,0
D41,Other,2020,9,10,0,1
D33,Other,2020,14,22,0,8
D33,Other,2020,3,3,1,0
D41,Auto Theft,2020,0,4,0,4
D32,Other Criminal Violations - Offensive Weapons,2020,5,6,0,1
D41,Auto Theft,2020,5,20,0,15
D33,Break & Enter-Commercial,2020,0,1,0,1
D33,Other,2020,5,7,0,2
D33,Other,2020,4,4,1,0
D32,Other Criminal Violations - Offensive Weapons,2020,8,10,0,2
D33,Other,2020,0,1,0,1
D33,Break & Enter-Commercial,2020,1,5,0,4
D33,Other,2020,1,1,1,0
D41,Auto Theft,2020,4,21,0,17
D32,Other Criminal Violations - Offensive Weapons,2020,6,6,1,0
D33,Other,2020,7,12,0,5
D33,Break & Enter-Commercial,2020,0,5,0,5
D33,Other,2020,2,3,0,1
D41,Auto Theft,2020,3,54,0,51
D32,Other Criminal Violations - Offensive Weapons,2020,4,6,0,2
D33,Other,2020,6,11,0,5
D33,Break & Enter-Commercial,2020,0,2,0,2
D33,Other,2020,1,2,0,1
D41,Auto Theft,2020,1,7,0,6
D32,Other Criminal Violations - Offensive Weapons,2020,16,18,0,2
D33,Other,2020,0,1,0,1
D33,Break & Enter-Commercial,2020,0,7,0,7
D33,Other,2020,1,1,1,0
D41,Auto Theft,2020,10,73,0,63
D32,Other,2020,0,1,0,1
D33,Other,2020,12,18,0,6
D33,Break & Enter-Commercial,2020,1,3,0,2
D33,Other,2020,31,41,0,10
D41,Auto Theft,2020,3,11,0,8
D32,Other,2020,1,2,0,1
D33,Other,2020,9,15,0,6
D33,Break & Enter-Commercial,2020,1,5,0,4
D33,Other,2020,10,13,0,3
D41,Auto Theft,2020,0,6,0,6
D32,Other,2020,1,1,1,0
D33,Other,2020,11,18,0,7
D33,Break & Enter-House,2020,0,22,0,22
D33,Other,2020,10,13,0,3
D41,Auto Theft,2020,4,31,0,27
D32,Other,2020,1,1,1,0
D33,Other,2020,8,8,1,0
D33,Break & Enter-House,2020,0,12,0,12
D33,Other,2020,0,1,0,1
D33,Other,2020,24,33,0,9
D33,Other,2020,29,34,0,5
D33,Other,2020,1,2,0,1
D33,Other,2020,22,24,0,2
D33,Other,2020,17,22,0,5
D33,Other,2020,1,2,0,1
D33,Other,2020,20,25,0,5
D33,Other,2020,10,15,0,5
D33,Other,2020,18,20,0,2
D33,Other,2020,1,1,1,0
D33,Other,2020,12,14,0,2
D33,Other Criminal Violations - Offensive Weapons,2020,6,6,1,0
D33,Other Criminal Violations - Offensive Weapons,2020,2,2,1,0
D33,Other Criminal Violations - Offensive Weapons,2020,2,2,1,0
D33,Other Criminal Violations - Offensive Weapons,2020,1,2,0,1
D33,Other Criminal Violations - Offensive Weapons,2020,8,10,0,2
D33,Other Criminal Violations - Offensive Weapons,2020,1,2,0,1
D33,Other Criminal Violations - Offensive Weapons,2020,5,7,0,2
D33,Other Criminal Violations - Offensive Weapons,2020,3,3,1,0
D33,Other Criminal Violations - Offensive Weapons,2020,4,4,1,0
D33,Other Criminal Violations - Offensive Weapons,2020,2,2,1,0
D33,Other Criminal Violations - Offensive Weapons,2020,1,1,1,0
D33,Other Criminal Violations - Offensive Weapons,2020,4,4,1,0
D33,Other,2020,1,2,0,1
D33,Other,2020,1,1,1,0
D33,Other,2020,0,1,0,1
D33,Other,2020,2,2,1,0
D41,Auto Theft,2020,0,6,0,6
D32,Other,2020,3,3,1,0
D33,Other,2020,3,8,0,5
D33,Break & Enter-House,2020,1,21,0,20
D41,Auto Theft,2020,10,21,0,11
D32,Other,2020,1,1,1,0
D33,Other,2020,1,1,1,0
D33,Break & Enter-House,2020,0,5,0,5
D41,Auto Theft,2020,7,88,0,81
D32,Other,2020,1,1,1,0
D33,Other,2020,6,9,0,3
D33,Break & Enter-House,2020,1,11,0,10
D41,Break & Enter-Apartment,2020,6,13,0,7
D41,Break & Enter-Apartment,2020,3,10,0,7
D41,Break & Enter-Apartment,2020,1,1,1,0
D41,Break & Enter-Apartment,2020,2,5,0,3
D41,Break & Enter-Apartment,2020,1,1,1,0
D41,Break & Enter-Apartment,2020,4,10,0,6
D41,Break & Enter-Apartment,2020,7,15,0,8
D41,Break & Enter-Apartment,2020,1,8,0,7
D41,Break & Enter-Apartment,2020,4,15,0,11
D41,Break & Enter-Commercial,2020,1,3,0,2
D41,Break & Enter-Commercial,2020,5,15,0,10
D41,Break & Enter-Commercial,2020,5,33,0,28
D41,Break & Enter-Commercial,2020,0,1,0,1
D41,Break & Enter-Commercial,2020,15,52,0,37
D41,Break & Enter-Commercial,2020,2,5,0,3
D41,Break & Enter-Commercial,2020,0,2,0,2
D41,Break & Enter-Commercial,2020,3,8,0,5
D41,Break & Enter-Commercial,2020,0,1,0,1
D41,Break & Enter-Commercial,2020,8,18,0,10
D41,Break & Enter-Commercial,2020,22,47,0,25
D41,Break & Enter-House,2020,1,2,0,1
D41,Break & Enter-House,2020,0,1,0,1
D41,Break & Enter-House,2020,2,12,0,10
D41,Break & Enter-House,2020,1,12,0,11
D41,Break & Enter-House,2020,1,4,0,3
D41,Break & Enter-House,2020,2,7,0,5
D33,Other,2020,3,8,0,5
D33,Robbery-Financial,2020,2,2,1,0
D33,Break & Enter-House,2020,1,16,0,15
D33,Other,2020,3,4,0,1
D33,Robbery-Financial,2020,2,2,1,0
D33,Other,2020,5,8,0,3
D33,Robbery-Other,2020,0,6,0,6
D33,Other,2020,4,5,0,1
D33,Robbery-Other,2020,3,15,0,12
D33,Break & Enter-House,2020,0,3,0,3
D33,Other,2020,2,2,1,0
D33,Robbery-Other,2020,0,2,0,2
D33,Break & Enter-House,2020,0,6,0,6
D33,Other,2020,1,1,1,0
D33,Robbery-Other,2020,6,16,0,10
D33,Break & Enter-House,2020,0,13,0,13
D33,Robbery-Other,2020,1,5,0,4
D33,Break & Enter-House,2020,1,7,0,6
D33,Robbery-Other,2020,1,5,0,4
D33,Other,2020,4,5,0,1
D33,Break & Enter-House,2020,0,13,0,13
D33,Robbery-Other,2020,2,10,0,8
D33,Auto Theft,2020,0,51,0,51
D33,Break & Enter-House,2020,0,5,0,5
D33,Robbery-Other,2020,0,1,0,1
D33,Auto Theft,2020,2,29,0,27
D33,Break & Enter-Other,2020,0,1,0,1
D33,Robbery-Other,2020,0,3,0,3
D33,Auto Theft,2020,0,16,0,16
D33,Break & Enter-Other,2020,1,2,0,1
D33,Robbery-Other,2020,4,5,0,1
D33,Auto Theft,2020,0,2,0,2
D33,Break & Enter-Other,2020,0,3,0,3
D33,Robbery-Other,2020,0,2,0,2
D33,Auto Theft,2020,5,36,0,31
D33,Break & Enter-Other,2020,1,1,1,0
D33,Robbery-Other,2020,2,5,0,3
D33,Auto Theft,2020,1,23,0,22
D33,Break & Enter-Other,2020,2,3,0,1
D33,Sexual Violation,2020,7,15,0,8
D33,Auto Theft,2020,0,2,0,2
D33,Break & Enter-Other,2020,1,4,0,3
D33,Sexual Violation,2020,1,11,0,10
D33,Auto Theft,2020,3,21,0,18
D33,Break & Enter-Other,2020,0,1,0,1
D33,Sexual Violation,2020,2,7,0,5
D33,Auto Theft,2020,1,24,0,23
D33,Break & Enter-Other,2020,0,1,0,1
D33,Sexual Violation,2020,1,1,1,0
D33,Auto Theft,2020,0,3,0,3
D33,Break & Enter-Other,2020,0,1,0,1
D33,Sexual Violation,2020,9,17,0,8
D33,Auto Theft,2020,1,23,0,22
D33,Fraud,2020,7,128,0,121
D33,Sexual Violation,2020,4,8,0,4
D33,Auto Theft,2020,0,28,0,28
D33,Fraud,2020,9,91,0,82
D33,Sexual Violation,2020,3,11,0,8
D33,Auto Theft,2020,0,8,0,8
D33,Fraud,2020,1,39,0,38
D33,Sexual Violation,2020,7,8,0,1
D33,Sexual Violation,2020,0,1,0,1
D33,Sexual Violation,2020,5,8,0,3
D33,Sexual Violation,2020,0,5,0,5
D33,Auto Theft,2020,1,1,1,0
D33,Fraud,2020,2,9,0,7
D33,Auto Theft,2020,0,9,0,9
D33,Break & Enter-Apartment,2020,0,8,0,8
D33,Fraud,2020,1,109,0,108
D33,Break & Enter-Apartment,2020,1,9,0,8
D33,Fraud,2020,1,52,0,51
D33,Break & Enter-Apartment,2020,2,12,0,10
D33,Fraud,2020,4,75,0,71
D33,Break & Enter-Apartment,2020,4,10,0,6
D33,Fraud,2020,1,70,0,69
D33,Break & Enter-Apartment,2020,0,4,0,4
D33,Fraud,2020,2,42,0,40
D33,Fraud,2020,2,38,0,36
D33,Fraud,2020,0,29,0,29
D33,Fraud,2020,1,29,0,28
D33,Other,2020,17,79,0,62
D33,Other,2020,11,93,0,82
D33,Other,2020,5,25,0,20
D33,Other,2020,2,4,0,2
D33,Other,2020,1,3,0,2
D33,Other,2020,19,91,0,72
D33,Other,2020,24,86,0,62
D33,Other,2020,2,6,0,4
D33,Other,2020,6,63,0,57
D33,Other,2020,7,47,0,40
D33,Other,2020,0,1,0,1
D33,Other,2020,0,1,0,1
D33,Other,2020,4,39,0,35
D33,Other,2020,4,50,0,46
D33,Other,2020,8,43,0,35
D33,Other,2020,0,2,0,2
D33,Other,2020,8,48,0,40
D33,Other,2020,0,3,0,3
D33,Theft Over $5000,2020,1,7,0,6
D33,Theft Over $5000,2020,3,12,0,9
D33,Theft Over $5000,2020,0,2,0,2
D33,Theft Over $5000,2020,2,6,0,4
D33,Theft Over $5000,2020,1,1,1,0
D33,Theft Over $5000,2020,0,1,0,1
D33,Theft Over $5000,2020,0,6,0,6
D33,Theft Over $5000,2020,0,8,0,8
D33,Theft Over $5000,2020,0,1,0,1
D33,Theft Over $5000,2020,0,6,0,6
D33,Theft Over $5000,2020,0,3,0,3
D33,Theft Over $5000,2020,0,2,0,2
D33,Theft Under $5000,2020,36,218,0,182
D33,Theft Under $5000,2020,73,344,0,271
D33,Theft Under $5000,2020,15,92,0,77
D33,Theft Under $5000,2020,3,18,0,15
D33,Theft Under $5000,2020,65,259,0,194
D33,Theft Under $5000,2020,7,139,0,132
D33,Theft Under $5000,2020,0,2,0,2
D33,Theft Under $5000,2020,7,103,0,96
D33,Theft Under $5000,2020,10,80,0,70
D33,Theft Under $5000,2020,0,6,0,6
D33,Theft Under $5000,2020,3,71,0,68
D33,Theft Under $5000,2020,10,118,0,108
D33,Theft Under $5000,2020,25,127,0,102
D33,Theft Under $5000,2020,7,42,0,35
D33,Theft Under $5000,2020,0,3,0,3
D33,Assault,2020,40,69,0,29
D33,Assault,2020,42,60,0,18
D33,Assault,2020,16,32,0,16
D33,Assault,2020,1,7,0,6
D33,Assault,2020,54,91,0,37
D43,Break & Enter-Commercial,2020,1,1,1,0
D43,Break & Enter-Commercial,2020,1,3,0,2
D43,Break & Enter-Commercial,2020,1,1,1,0
D43,Break & Enter-Commercial,2020,2,9,0,7
D43,Break & Enter-Commercial,2020,13,22,0,9
D43,Break & Enter-Commercial,2020,4,14,0,10
D43,Break & Enter-House,2020,1,2,0,1
D43,Break & Enter-House,2020,1,4,0,3
D43,Break & Enter-House,2020,1,6,0,5
D43,Break & Enter-House,2020,2,10,0,8
D43,Break & Enter-House,2020,3,5,0,2
D43,Break & Enter-House,2020,4,10,0,6
D43,Break & Enter-House,2020,1,2,0,1
D43,Break & Enter-House,2020,0,6,0,6
D43,Break & Enter-House,2020,3,10,0,7
D43,Break & Enter-House,2020,3,7,0,4
D43,Break & Enter-House,2020,5,14,0,9
D43,Break & Enter-House,2020,0,2,0,2
D43,Break & Enter-House,2020,2,3,0,1
D43,Break & Enter-Other,2020,0,1,0,1
D43,Break & Enter-Other,2020,1,1,1,0
D43,Break & Enter-Other,2020,1,4,0,3
D43,Break & Enter-Other,2020,1,2,0,1
D43,Other,2020,12,38,0,26
D43,Break & Enter-Other,2020,1,4,0,3
D43,Break & Enter-Other,2020,0,1,0,1
D43,Break & Enter-Other,2020,1,3,0,2
D43,Break & Enter-Other,2020,6,13,0,7
D43,Break & Enter-Other,2020,1,1,1,0
D43,Fraud,2020,7,18,0,11
D43,Fraud,2020,11,63,0,52
D43,Fraud,2020,6,26,0,20
D43,Fraud,2020,5,34,0,29
D43,Fraud,2020,8,58,0,50
D43,Fraud,2020,12,99,0,87
D43,Fraud,2020,1,16,0,15
D43,Fraud,2020,5,51,0,46
D43,Fraud,2020,2,33,0,31
D43,Fraud,2020,1,3,0,2
D43,Fraud,2020,10,47,0,37
D43,Fraud,2020,19,114,0,95
D43,Fraud,2020,1,16,0,15
D43,Fraud,2020,14,101,0,87
D43,Other,2020,3,12,0,9
D43,Other,2020,15,47,0,32
D43,Other,2020,4,28,0,24
D43,Other,2020,25,53,0,28
D43,Other,2020,16,63,0,47
D43,Other,2020,27,87,0,60
D43,Other,2020,9,32,0,23
D43,Other,2020,7,47,0,40
D42,Other Criminal Violations - Offensive Weapons,2020,4,4,1,0
D42,Break & Enter-House,2020,1,21,0,20
D42,Robbery-Other,2020,11,28,0,17
D43,Other,2020,1,6,0,5
D43,Other,2020,27,98,0,71
D43,Other,2020,59,172,0,113
D43,Other,2020,2,16,0,14
D43,Other,2020,16,79,0,63
D43,Theft Over $5000,2020,0,1,0,1
D43,Theft Over $5000,2020,1,4,0,3
D43,Theft Over $5000,2020,0,1,0,1
D43,Theft Over $5000,2020,2,6,0,4
D43,Theft Over $5000,2020,2,6,0,4
D43,Theft Over $5000,2020,3,4,0,1
D43,Theft Over $5000,2020,0,1,0,1
D42,Robbery-Other,2020,9,14,0,5
D43,Theft Over $5000,2020,1,2,0,1
D42,Robbery-Other,2020,3,5,0,2
D43,Theft Over $5000,2020,0,2,0,2
D42,Robbery-Other,2020,5,13,0,8
D42,Robbery-Other,2020,11,21,0,10
D42,Sexual Violation,2020,4,14,0,10
D42,Sexual Violation,2020,10,20,0,10
D42,Sexual Violation,2020,1,1,1,0
D42,Sexual Violation,2020,2,4,0,2
D42,Sexual Violation,2020,7,13,0,6
D42,Sexual Violation,2020,14,23,0,9
D42,Sexual Violation,2020,2,5,0,3
D42,Sexual Violation,2020,2,6,0,4
D42,Sexual Violation,2020,3,5,0,2
D42,Sexual Violation,2020,0,1,0,1
D42,Sexual Violation,2020,3,3,1,0
D42,Sexual Violation,2020,5,12,0,7
D42,Sexual Violation,2020,1,7,0,6
D42,Other,2020,7,7,1,0
D42,Other,2020,17,21,0,4
D42,Other,2020,2,2,1,0
D42,Other,2020,2,3,0,1
D42,Other,2020,8,8,1,0
D42,Other,2020,6,6,1,0
D42,Other,2020,12,13,0,1
D42,Other,2020,15,15,1,0
D42,Other,2020,8,10,0,2
D42,Other,2020,26,27,0,1
D42,Other,2020,3,4,0,1
D42,Other,2020,2,3,0,1
D42,Other,2020,10,10,1,0
D42,Other,2020,12,13,0,1
D42,Other,2020,12,19,0,7
D42,Other,2020,38,55,0,17
D42,Other,2020,1,1,1,0
D42,Other,2020,34,46,0,12
D42,Other,2020,27,32,0,5
D42,Other,2020,61,76,0,15
D42,Other,2020,19,24,0,5
D42,Other,2020,19,23,0,4
D42,Other,2020,39,41,0,2
D42,Other,2020,4,5,0,1
D42,Other,2020,8,10,0,2
D42,Other,2020,30,42,0,12
D42,Other,2020,14,17,0,3
D42,Other Criminal Violations - Offensive Weapons,2020,3,5,0,2
D42,Other Criminal Violations - Offensive Weapons,2020,7,7,1,0
D42,Other Criminal Violations - Offensive Weapons,2020,3,3,1,0
D42,Other Criminal Violations - Offensive Weapons,2020,5,6,0,1
D42,Other Criminal Violations - Offensive Weapons,2020,5,6,0,1
D42,Other,2020,3,4,0,1
D42,Theft Under $5000,2020,0,7,0,7
D42,Break & Enter-House,2020,4,15,0,11
D42,Other Criminal Violations - Offensive Weapons,2020,6,6,1,0
D43,Theft Over $5000,2020,1,7,0,6
D42,Other,2020,4,4,1,0
D42,Theft Under $5000,2020,4,60,0,56
D43,Theft Over $5000,2020,3,10,0,7
D42,Break & Enter-House,2020,1,5,0,4
D42,Other Criminal Violations - Offensive Weapons,2020,6,6,1,0
D42,Other,2020,4,4,1,0
D42,Theft Under $5000,2020,21,151,0,130
D43,Theft Over $5000,2020,0,1,0,1
D42,Break & Enter-Other,2020,0,2,0,2
D42,Other Criminal Violations - Offensive Weapons,2020,1,1,1,0
D42,Other,2020,3,3,1,0
D42,Theft Under $5000,2020,55,173,0,118
D43,Theft Over $5000,2020,4,13,0,9
D42,Break & Enter-Other,2020,1,1,1,0
D42,Other Criminal Violations - Offensive Weapons,2020,6,8,0,2
D42,Other,2020,4,5,0,1
D42,Theft Under $5000,2020,21,96,0,75
D43,Theft Under $5000,2020,3,21,0,18
D42,Break & Enter-Other,2020,1,1,1,0
D42,Other Criminal Violations - Offensive Weapons,2020,1,1,1,0
D42,Other,2020,3,3,1,0
D42,Theft Under $5000,2020,42,273,0,231
D43,Theft Under $5000,2020,121,348,0,227
D42,Break & Enter-Other,2020,0,1,0,1
D42,Other,2020,0,1,0,1
D42,Other,2020,3,3,1,0
D42,Theft Under $5000,2020,22,214,0,192
D43,Theft Under $5000,2020,14,79,0,65
D42,Break & Enter-Other,2020,1,1,1,0
D42,Other,2020,0,1,0,1
D42,Other,2020,8,9,0,1
D42,Theft Under $5000,2020,0,2,0,2
D43,Theft Under $5000,2020,40,180,0,140
D42,Break & Enter-Other,2020,2,4,0,2
D42,Other,2020,1,1,1,0
D42,Other,2020,1,1,1,0
D42,Theft Under $5000,2020,2,41,0,39
D43,Theft Under $5000,2020,52,162,0,110
D42,Break & Enter-Other,2020,0,2,0,2
D42,Other,2020,2,2,1,0
D42,Auto Theft,2020,5,63,0,58
D42,Auto Theft,2020,6,63,0,57
D42,Auto Theft,2020,2,14,0,12
D42,Auto Theft,2020,0,20,0,20
D42,Auto Theft,2020,2,42,0,40
D42,Auto Theft,2020,2,24,0,22
D42,Auto Theft,2020,3,72,0,69
D42,Auto Theft,2020,1,45,0,44
D42,Auto Theft,2020,0,1,0,1
D42,Auto Theft,2020,1,29,0,28
D42,Auto Theft,2020,2,38,0,36
D42,Auto Theft,2020,2,16,0,14
D42,Break & Enter-Apartment,2020,0,3,0,3
D42,Break & Enter-Apartment,2020,1,18,0,17
D42,Break & Enter-Apartment,2020,4,8,0,4
D42,Break & Enter-Apartment,2020,3,5,0,2
D42,Break & Enter-Apartment,2020,1,2,0,1
D42,Break & Enter-Apartment,2020,1,3,0,2
D42,Break & Enter-Apartment,2020,0,8,0,8
D42,Break & Enter-Apartment,2020,0,1,0,1
D42,Break & Enter-Apartment,2020,3,13,0,10
D42,Break & Enter-Apartment,2020,1,1,1,0
D42,Break & Enter-Commercial,2020,2,3,0,1
D42,Break & Enter-Commercial,2020,12,52,0,40
D42,Break & Enter-Commercial,2020,1,2,0,1
D42,Break & Enter-Commercial,2020,3,10,0,7
D42,Break & Enter-Commercial,2020,1,3,0,2
D42,Break & Enter-Commercial,2020,0,4,0,4
D42,Break & Enter-Commercial,2020,12,30,0,18
D42,Break & Enter-Commercial,2020,1,11,0,10
D42,Break & Enter-Commercial,2020,1,2,0,1
D42,Break & Enter-Commercial,2020,12,23,0,11
D42,Break & Enter-Commercial,2020,2,9,0,7
D42,Break & Enter-House,2020,0,11,0,11
D42,Break & Enter-House,2020,3,9,0,6
D42,Break & Enter-House,2020,1,12,0,11
D42,Break & Enter-House,2020,3,9,0,6
D42,Break & Enter-House,2020,5,8,0,3
D42,Break & Enter-House,2020,1,4,0,3
D42,Break & Enter-House,2020,4,18,0,14
D42,Break & Enter-House,2020,2,6,0,4
D42,Theft Under $5000,2020,42,265,0,223
D42,Other,2020,2,2,1,0
D43,Theft Under $5000,2020,55,207,0,152
D42,Break & Enter-Other,2020,0,1,0,1
D42,Theft Under $5000,2020,2,100,0,98
D43,Other,2020,6,7,0,1
D43,Other,2020,2,2,1,0
D42,Assault,2020,40,67,0,27
D42,Break & Enter-Other,2020,2,3,0,1
D42,Assault,2020,65,113,0,48
D43,Theft Under $5000,2020,5,47,0,42
D42,Break & Enter-Other,2020,0,2,0,2
D43,Other,2020,3,3,1,0
D42,Assault,2020,0,1,0,1
D43,Theft Under $5000,2020,3,99,0,96
D42,Fraud,2020,6,55,0,49
D43,Other,2020,9,9,1,0
D42,Assault,2020,70,92,0,22
D43,Theft Under $5000,2020,19,116,0,97
D42,Fraud,2020,7,98,0,91
D43,Other,2020,7,7,1,0
D42,Assault,2020,44,71,0,27
D43,Theft Under $5000,2020,0,7,0,7
D42,Fraud,2020,0,48,0,48
D43,Other,2020,3,3,1,0
D42,Assault,2020,104,148,0,44
D43,Theft Under $5000,2020,33,176,0,143
D42,Fraud,2020,3,55,0,52
D43,Other,2020,2,2,1,0
D42,Assault,2020,39,66,0,27
D43,Theft Under $5000,2020,61,308,0,247
D42,Fraud,2020,5,70,0,65
D43,Other,2020,11,12,0,1
D42,Assault,2020,44,78,0,34
D43,Theft Under $5000,2020,2,28,0,26
D42,Fraud,2020,1,45,0,44
D43,Other,2020,26,27,0,1
D42,Assault,2020,54,72,0,18
D43,Theft Under $5000,2020,12,193,0,181
D42,Fraud,2020,4,70,0,66
D43,Other,2020,2,2,1,0
D42,Assault,2020,2,6,0,4
D43,Assault,2020,32,55,0,23
D42,Fraud,2020,15,82,0,67
D43,Auto Theft,2020,0,4,0,4
D42,Assault,2020,20,34,0,14
D43,Assault,2020,37,83,0,46
D42,Fraud,2020,1,44,0,43
D43,Auto Theft,2020,6,26,0,20
D42,Assault,2020,75,117,0,42
D43,Assault,2020,34,41,0,7
D42,Fraud,2020,8,97,0,89
D43,Auto Theft,2020,1,10,0,9
D42,Assault,2020,25,41,0,16
D42,Attempt Murder,2020,0,1,0,1
D42,Attempt Murder,2020,5,5,1,0
D42,Attempt Murder,2020,0,1,0,1
D42,Other,2020,7,25,0,18
D42,Other,2020,20,33,0,13
D42,Other,2020,12,16,0,4
D42,Other,2020,3,13,0,10
D42,Other,2020,20,37,0,17
D42,Other,2020,5,18,0,13
D42,Other,2020,11,18,0,7
D42,Other,2020,10,20,0,10
D42,Other,2020,0,1,0,1
D42,Other,2020,4,8,0,4
D42,Other,2020,14,23,0,9
D42,Other,2020,5,9,0,4
D42,Robbery-Financial,2020,1,1,1,0
D42,Robbery-Financial,2020,4,4,1,0
D42,Robbery-Financial,2020,1,1,1,0
D42,Robbery-Financial,2020,1,1,1,0
D42,Robbery-Financial,2020,1,2,0,1
D42,Robbery-Other,2020,6,14,0,8
D42,Robbery-Other,2020,4,15,0,11
D42,Robbery-Other,2020,3,10,0,7
D42,Robbery-Other,2020,2,9,0,7
D42,Robbery-Other,2020,9,15,0,6
D42,Robbery-Other,2020,1,6,0,5
D43,Assault,2020,34,71,0,37
D43,Auto Theft,2020,3,13,0,10
D42,Fraud,2020,3,30,0,27
D43,Assault,2020,77,105,0,28
D43,Auto Theft,2020,7,22,0,15
D42,Other,2020,9,49,0,40
D43,Assault,2020,92,155,0,63
D43,Auto Theft,2020,3,38,0,35
D42,Other,2020,18,87,0,69
D43,Assault,2020,21,33,0,12
D43,Auto Theft,2020,5,11,0,6
D42,Other,2020,19,43,0,24
D43,Assault,2020,18,29,0,11
D43,Auto Theft,2020,4,16,0,12
D42,Other,2020,21,74,0,53
D43,Assault,2020,61,99,0,38
D43,Auto Theft,2020,1,32,0,31
D42,Other,2020,21,79,0,58
D43,Assault,2020,3,7,0,4
D43,Auto Theft,2020,1,23,0,22
D43,Auto Theft,2020,8,55,0,47
D43,Auto Theft,2020,0,4,0,4
D43,Auto Theft,2020,9,65,0,56
D43,Break & Enter-Apartment,2020,0,1,0,1
D43,Break & Enter-Apartment,2020,1,4,0,3
D43,Break & Enter-Apartment,2020,3,4,0,1
D43,Break & Enter-Apartment,2020,3,6,0,3
D43,Break & Enter-Apartment,2020,6,23,0,17
D43,Break & Enter-Apartment,2020,0,1,0,1
D43,Break & Enter-Apartment,2020,1,6,0,5
D43,Break & Enter-Apartment,2020,6,9,0,3
D43,Break & Enter-Apartment,2020,4,8,0,4
D43,Break & Enter-Apartment,2020,3,7,0,4
D43,Break & Enter-Commercial,2020,0,3,0,3
D43,Break & Enter-Commercial,2020,1,4,0,3
D43,Break & Enter-Commercial,2020,1,2,0,1
D43,Break & Enter-Commercial,2020,3,9,0,6
D43,Break & Enter-Commercial,2020,1,5,0,4
D43,Break & Enter-Commercial,2020,2,5,0,3
D43,Assault,2020,115,170,0,55
D43,Assault,2020,226,306,0,80
D43,Assault,2020,12,17,0,5
D43,Assault,2020,105,159,0,54
D43,Attempt Murder,2020,3,3,1,0
D43,Attempt Murder,2020,0,2,0,2
D43,Attempt Murder,2020,1,1,1,0
D42,Other,2020,7,38,0,31
D42,Other,2020,9,68,0,59
D42,Other,2020,19,76,0,57
D42,Other,2020,1,3,0,2
D42,Other,2020,7,31,0,24
D42,Other,2020,28,81,0,53
D42,Other,2020,7,32,0,25
D42,Theft Over $5000,2020,0,5,0,5
D42,Theft Over $5000,2020,2,8,0,6
D42,Theft Over $5000,2020,1,2,0,1
D42,Theft Over $5000,2020,0,3,0,3
D42,Theft Over $5000,2020,0,4,0,4
D42,Theft Over $5000,2020,0,2,0,2
D42,Theft Over $5000,2020,2,12,0,10
D42,Theft Over $5000,2020,1,7,0,6
D42,Theft Over $5000,2020,0,1,0,1
D42,Theft Over $5000,2020,0,1,0,1
D42,Theft Over $5000,2020,0,3,0,3
D42,Theft Over $5000,2020,0,2,0,2
D42,Theft Under $5000,2020,11,199,0,188
D42,Theft Under $5000,2020,24,172,0,148
D41,Sexual Violation,2020,0,1,0,1
D41,Sexual Violation,2020,7,15,0,8
D41,Sexual Violation,2020,10,17,0,7
D41,Sexual Violation,2020,7,11,0,4
D41,Sexual Violation,2020,9,16,0,7
D41,Sexual Violation,2020,3,6,0,3
D41,Sexual Violation,2020,13,20,0,7
D41,Sexual Violation,2020,9,19,0,10
D41,Sexual Violation,2020,5,13,0,8
D41,Sexual Violation,2020,7,10,0,3
D41,Other,2020,4,6,0,2
D41,Other,2020,2,2,1,0
D41,Other,2020,9,11,0,2
D41,Other,2020,18,24,0,6
D41,Other,2020,4,5,0,1
D41,Other,2020,27,27,1,0
D41,Other,2020,6,7,0,1
D41,Other,2020,5,6,0,1
D41,Other,2020,5,8,0,3
D41,Other,2020,1,1,1,0
D41,Other,2020,15,15,1,0
D41,Other,2020,29,30,0,1
D41,Other,2020,4,4,1,0
D41,Other,2020,13,14,0,1
D41,Other,2020,94,107,0,13
D41,Other,2020,220,237,0,17
D41,Other,2020,12,13,0,1
D41,Other,2020,282,353,0,71
D41,Other,2020,5,6,0,1
D41,Other,2020,47,51,0,4
D41,Other,2020,87,98,0,11
D41,Other,2020,5,7,0,2
D41,Other,2020,100,111,0,11
D41,Other,2020,86,106,0,20
D41,Other Criminal Violations - Offensive Weapons,2020,1,1,1,0
D41,Other Criminal Violations - Offensive Weapons,2020,3,7,0,4
D41,Other Criminal Violations - Offensive Weapons,2020,10,10,1,0
D41,Other Criminal Violations - Offensive Weapons,2020,5,5,1,0
D41,Other Criminal Violations - Offensive Weapons,2020,14,16,0,2
D41,Other Criminal Violations - Offensive Weapons,2020,2,4,0,2
D41,Other Criminal Violations - Offensive Weapons,2020,6,7,0,1
D41,Other Criminal Violations - Offensive Weapons,2020,17,18,0,1
D41,Other Criminal Violations - Offensive Weapons,2020,10,10,1,0
D41,Other Criminal Violations - Offensive Weapons,2020,16,21,0,5
D41,Other,2020,0,1,0,1
D41,Other,2020,1,1,1,0
D41,Other,2020,1,1,1,0
D41,Other,2020,0,1,0,1
D42,Other,2020,3,3,1,0
D42,Other,2020,3,4,0,1
D51,Other,2020,190,449,0,259
D51,Other,2020,10,10,1,0
D51,Other,2020,3,5,0,2
D51,Auto Theft,2020,1,15,0,14
D52,Auto Theft,2020,1,1,1,0
D52,Robbery-Other,2020,2,8,0,6
D52,Other,2020,24,122,0,98
D51,Other,2020,52,157,0,105
D43,Other,2020,5,7,0,2
D51,Auto Theft,2020,0,10,0,10
D52,Auto Theft,2020,1,10,0,9
D52,Robbery-Other,2020,6,14,0,8
D52,Other,2020,83,354,0,271
D51,Other,2020,41,86,0,45
D43,Other,2020,6,8,0,2
D51,Auto Theft,2020,8,24,0,16
D52,Auto Theft,2020,3,27,0,24
D52,Robbery-Other,2020,4,8,0,4
D52,Theft Over $5000,2020,3,7,0,4
D51,Other,2020,6,18,0,12
D43,Other,2020,11,14,0,3
D51,Auto Theft,2020,11,42,0,31
D52,Auto Theft,2020,0,5,0,5
D52,Robbery-Other,2020,1,2,0,1
D52,Theft Over $5000,2020,0,1,0,1
D51,Other,2020,35,126,0,91
D43,Other,2020,1,2,0,1
D51,Auto Theft,2020,1,26,0,25
D52,Auto Theft,2020,5,19,0,14
D52,Robbery-Other,2020,7,13,0,6
D52,Theft Over $5000,2020,2,11,0,9
D51,Theft Over $5000,2020,1,3,0,2
D43,Other,2020,14,16,0,2
D51,Auto Theft,2020,6,12,0,6
D52,Auto Theft,2020,3,15,0,12
D52,Robbery-Other,2020,24,52,0,28
D52,Theft Over $5000,2020,1,18,0,17
D51,Theft Over $5000,2020,3,19,0,16
D43,Other,2020,27,30,0,3
D51,Auto Theft,2020,1,5,0,4
D52,Break & Enter-Apartment,2020,4,19,0,15
D52,Sexual Violation,2020,8,20,0,12
D52,Sexual Violation,2020,1,2,0,1
D52,Sexual Violation,2020,4,7,0,3
D52,Sexual Violation,2020,16,26,0,10
D52,Sexual Violation,2020,17,34,0,17
D52,Sexual Violation,2020,0,2,0,2
D52,Sexual Violation,2020,7,9,0,2
D52,Sexual Violation,2020,3,6,0,3
D52,Sexual Violation,2020,5,10,0,5
D52,Sexual Violation,2020,15,31,0,16
D52,Other,2020,1,1,1,0
D52,Other,2020,1,1,1,0
D52,Other,2020,2,2,1,0
D52,Other,2020,12,12,1,0
D52,Other,2020,12,13,0,1
D52,Other,2020,7,9,0,2
D52,Other,2020,17,17,1,0
D52,Other,2020,8,9,0,1
D52,Other,2020,51,743,0,692
D52,Other,2020,5,6,0,1
D52,Other,2020,30,35,0,5
D52,Other,2020,30,36,0,6
D52,Other,2020,193,224,0,31
D52,Other,2020,8,8,1,0
D52,Other,2020,30,36,0,6
D52,Other,2020,16,19,0,3
D52,Other,2020,46,58,0,12
D52,Other,2020,348,372,0,24
D52,Other Criminal Violations - Offensive Weapons,2020,11,11,1,0
D52,Other Criminal Violations - Offensive Weapons,2020,4,4,1,0
D52,Other Criminal Violations - Offensive Weapons,2020,5,7,0,2
D52,Other Criminal Violations - Offensive Weapons,2020,11,12,0,1
D52,Other Criminal Violations - Offensive Weapons,2020,9,11,0,2
D52,Other Criminal Violations - Offensive Weapons,2020,1,1,1,0
D52,Other Criminal Violations - Offensive Weapons,2020,15,17,0,2
D52,Other Criminal Violations - Offensive Weapons,2020,11,13,0,2
D52,Other Criminal Violations - Offensive Weapons,2020,24,27,0,3
D52,Other,2020,9,17,0,8
D52,Other,2020,2,2,1,0
D52,Other,2020,1,1,1,0
D52,Other,2020,1,2,0,1
D52,Other,2020,2,5,0,3
D53,Other,2020,2,2,1,0
D53,Other,2020,1,1,1,0
D43,Attempt Murder,2020,0,1,0,1
D51,Robbery-Other,2020,0,3,0,3
D43,Other,2020,3,3,1,0
D52,Theft Over $5000,2020,0,1,0,1
D51,Auto Theft,2020,3,11,0,8
D52,Break & Enter-Apartment,2020,7,23,0,16
D51,Robbery-Other,2020,18,27,0,9
D52,Theft Over $5000,2020,1,5,0,4
D43,Other,2020,16,17,0,1
D51,Break & Enter-Apartment,2020,3,22,0,19
D51,Theft Over $5000,2020,2,23,0,21
D52,Break & Enter-Apartment,2020,9,27,0,18
D51,Sexual Violation,2020,8,16,0,8
D51,Break & Enter-Apartment,2020,10,43,0,33
D52,Theft Over $5000,2020,0,1,0,1
D51,Theft Over $5000,2020,5,16,0,11
D43,Other,2020,10,11,0,1
D52,Break & Enter-Apartment,2020,3,13,0,10
D51,Sexual Violation,2020,9,29,0,20
D51,Break & Enter-Apartment,2020,15,39,0,24
D52,Theft Over $5000,2020,5,12,0,7
D51,Theft Over $5000,2020,0,9,0,9
D43,Other,2020,19,22,0,3
D52,Break & Enter-Apartment,2020,1,4,0,3
D51,Sexual Violation,2020,13,35,0,22
D51,Break & Enter-Apartment,2020,34,99,0,65
D52,Theft Over $5000,2020,11,35,0,24
D51,Theft Over $5000,2020,1,4,0,3
D43,Other,2020,22,31,0,9
D52,Break & Enter-Apartment,2020,5,25,0,20
D51,Sexual Violation,2020,29,67,0,38
D51,Break & Enter-Apartment,2020,0,2,0,2
D52,Theft Under $5000,2020,18,266,0,248
D51,Theft Over $5000,2020,0,4,0,4
D43,Other,2020,45,57,0,12
D52,Break & Enter-Apartment,2020,4,20,0,16
D51,Sexual Violation,2020,13,20,0,7
D51,Break & Enter-Apartment,2020,16,40,0,24
D52,Theft Under $5000,2020,1,11,0,10
D51,Theft Over $5000,2020,3,14,0,11
D43,Other,2020,50,60,0,10
D52,Break & Enter-Commercial,2020,21,56,0,35
D51,Sexual Violation,2020,4,9,0,5
D51,Break & Enter-Apartment,2020,8,19,0,11
D52,Theft Under $5000,2020,4,36,0,32
D51,Theft Under $5000,2020,18,211,0,193
D52,Break & Enter-Commercial,2020,6,14,0,8
D51,Sexual Violation,2020,1,3,0,2
D51,Break & Enter-Apartment,2020,6,21,0,15
D52,Theft Under $5000,2020,36,196,0,160
D51,Theft Under $5000,2020,144,690,0,546
D52,Theft Under $5000,2020,36,367,0,331
D52,Break & Enter-Commercial,2020,23,59,0,36
D51,Sexual Violation,2020,9,15,0,6
D51,Break & Enter-Commercial,2020,10,28,0,18
D51,Theft Under $5000,2020,180,766,0,586
D43,Other,2020,78,90,0,12
D52,Theft Under $5000,2020,1,8,0,7
D52,Break & Enter-Commercial,2020,0,1,0,1
D51,Other,2020,5,5,1,0
D51,Break & Enter-Commercial,2020,15,51,0,36
D51,Theft Under $5000,2020,83,604,0,521
D43,Other,2020,9,12,0,3
D52,Theft Under $5000,2020,10,143,0,133
D52,Break & Enter-Commercial,2020,2,7,0,5
D51,Other,2020,3,4,0,1
D51,Break & Enter-Commercial,2020,30,84,0,54
D51,Theft Under $5000,2020,0,10,0,10
D43,Other,2020,5,7,0,2
D52,Theft Under $5000,2020,3,137,0,134
D52,Break & Enter-Commercial,2020,0,2,0,2
D51,Other,2020,10,10,1,0
D51,Break & Enter-Commercial,2020,13,63,0,50
D51,Theft Under $5000,2020,50,361,0,311
D43,Other,2020,44,56,0,12
D52,Theft Under $5000,2020,25,286,0,261
D52,Break & Enter-Commercial,2020,25,63,0,38
D51,Other,2020,22,26,0,4
D51,Break & Enter-Commercial,2020,6,14,0,8
D51,Theft Under $5000,2020,51,197,0,146
D43,Other,2020,1,2,0,1
D52,Theft Under $5000,2020,320,1438,0,1118
D52,Break & Enter-Commercial,2020,54,112,0,58
D51,Other,2020,0,1,0,1
D51,Break & Enter-Commercial,2020,2,3,0,1
D51,Theft Under $5000,2020,3,70,0,67
D43,Other,2020,87,94,0,7
D52,Assault,2020,53,88,0,35
D52,Break & Enter-House,2020,1,1,1,0
D51,Other,2020,4,4,1,0
D51,Other,2020,1,1,1,0
D51,Other,2020,9,9,1,0
D51,Other,2020,17,21,0,4
D51,Other,2020,66,76,0,10
D51,Other,2020,149,174,0,25
D51,Other,2020,168,192,0,24
D51,Other,2020,653,699,0,46
D51,Other,2020,8,8,1,0
D51,Other,2020,109,123,0,14
D51,Other,2020,120,133,0,13
D51,Other,2020,10,11,0,1
D51,Other,2020,40,53,0,13
D51,Other Criminal Violations - Offensive Weapons,2020,12,15,0,3
D51,Other Criminal Violations - Offensive Weapons,2020,26,33,0,7
D51,Other Criminal Violations - Offensive Weapons,2020,26,31,0,5
D51,Other Criminal Violations - Offensive Weapons,2020,77,84,0,7
D51,Other Criminal Violations - Offensive Weapons,2020,19,28,0,9
D51,Other Criminal Violations - Offensive Weapons,2020,8,10,0,2
D51,Other Criminal Violations - Offensive Weapons,2020,7,7,1,0
D51,Other Criminal Violations - Offensive Weapons,2020,6,6,1,0
D51,Other,2020,1,1,1,0
D51,Other,2020,2,5,0,3
D51,Other,2020,3,4,0,1
D51,Other,2020,1,3,0,2
D51,Other,2020,1,1,1,0
D52,Other,2020,14,15,0,1
D52,Other,2020,3,3,1,0
D52,Other,2020,6,6,1,0
D52,Other,2020,9,9,1,0
D52,Other,2020,1,1,1,0
D52,Other,2020,9,9,1,0
D52,Other,2020,22,24,0,2
D52,Auto Theft,2020,0,10,0,10
D52,Auto Theft,2020,0,1,0,1
D43,Other,2020,208,243,0,35
D52,Assault,2020,6,12,0,6
D51,Break & Enter-Commercial,2020,2,5,0,3
D52,Break & Enter-House,2020,2,7,0,5
D43,Other,2020,6,10,0,4
D51,Theft Under $5000,2020,56,474,0,418
D52,Assault,2020,63,89,0,26
D51,Break & Enter-Commercial,2020,15,43,0,28
D52,Break & Enter-House,2020,1,3,0,2
D43,Other,2020,84,100,0,16
D51,Assault,2020,84,126,0,42
D52,Assault,2020,65,105,0,40
D51,Break & Enter-House,2020,1,8,0,7
D51,Assault,2020,155,270,0,115
D52,Break & Enter-House,2020,0,4,0,4
D43,Other Criminal Violations - Offensive Weapons,2020,4,4,1,0
D52,Assault,2020,102,170,0,68
D51,Break & Enter-House,2020,4,18,0,14
D51,Assault,2020,225,374,0,149
D52,Break & Enter-Other,2020,2,3,0,1
D43,Other Criminal Violations - Offensive Weapons,2020,4,6,0,2
D52,Assault,2020,1,2,0,1
D51,Break & Enter-House,2020,0,1,0,1
D51,Assault,2020,439,686,0,247
D52,Break & Enter-Other,2020,1,2,0,1
D43,Other Criminal Violations - Offensive Weapons,2020,4,4,1,0
D52,Assault,2020,70,106,0,36
D51,Break & Enter-House,2020,1,3,0,2
D51,Break & Enter-Other,2020,3,12,0,9
D51,Break & Enter-Other,2020,2,4,0,2
D51,Break & Enter-Other,2020,9,21,0,12
D51,Break & Enter-Other,2020,8,22,0,14
D51,Break & Enter-Other,2020,0,1,0,1
D51,Break & Enter-Other,2020,3,5,0,2
D51,Break & Enter-Other,2020,2,3,0,1
D51,Break & Enter-Other,2020,0,1,0,1
D51,Break & Enter-Other,2020,0,5,0,5
D51,Fraud,2020,2,55,0,53
D51,Fraud,2020,14,171,0,157
D51,Fraud,2020,14,189,0,175
D51,Fraud,2020,12,139,0,127
D51,Fraud,2020,1,5,0,4
D51,Fraud,2020,9,80,0,71
D51,Fraud,2020,3,51,0,48
D51,Fraud,2020,1,5,0,4
D51,Fraud,2020,10,120,0,110
D51,Other,2020,34,151,0,117
D51,Other,2020,94,271,0,177
D51,Other,2020,116,344,0,228
D43,Attempt Murder,2020,1,1,1,0
D52,Break & Enter-Other,2020,2,6,0,4
D51,Assault,2020,1,4,0,3
D43,Other,2020,0,2,0,2
D52,Assault,2020,18,24,0,6
D43,Other Criminal Violations - Offensive Weapons,2020,10,12,0,2
D52,Break & Enter-Other,2020,0,6,0,6
D51,Assault,2020,127,204,0,77
D43,Other,2020,8,14,0,6
D52,Assault,2020,92,156,0,64
D43,Other Criminal Violations - Offensive Weapons,2020,7,8,0,1
D52,Break & Enter-Other,2020,1,6,0,5
D51,Assault,2020,85,132,0,47
D43,Other,2020,5,11,0,6
D52,Assault,2020,210,346,0,136
D43,Other Criminal Violations - Offensive Weapons,2020,15,17,0,2
D52,Break & Enter-Other,2020,1,2,0,1
D51,Assault,2020,16,27,0,11
D43,Other,2020,18,32,0,14
D52,Attempt Murder,2020,1,1,1,0
D43,Other Criminal Violations - Offensive Weapons,2020,1,1,1,0
D52,Break & Enter-Other,2020,5,14,0,9
D51,Assault,2020,91,142,0,51
D51,Attempt Murder,2020,1,1,1,0
D51,Attempt Murder,2020,0,1,0,1
D51,Attempt Murder,2020,1,1,1,0
D51,Other,2020,10,25,0,15
D51,Other,2020,19,39,0,20
D51,Other,2020,26,42,0,16
D51,Other,2020,50,73,0,23
D51,Other,2020,1,2,0,1
D51,Other,2020,19,37,0,18
D51,Other,2020,12,25,0,13
D51,Other,2020,1,1,1,0
D51,Other,2020,13,37,0,24
D51,Robbery-Other,2020,6,15,0,9
D51,Robbery-Other,2020,28,45,0,17
D51,Robbery-Other,2020,35,64,0,29
D51,Robbery-Other,2020,38,113,0,75
D51,Robbery-Other,2020,13,26,0,13
D51,Robbery-Other,2020,6,12,0,6
D52,Attempt Murder,2020,2,2,1,0
D52,Fraud,2020,18,156,0,138
D52,Attempt Murder,2020,1,1,1,0
D43,Other,2020,6,10,0,4
D52,Other,2020,16,30,0,14
D52,Fraud,2020,0,2,0,2
D43,Other,2020,18,32,0,14
D52,Other,2020,2,2,1,0
D52,Fraud,2020,1,12,0,11
D43,Other,2020,2,8,0,6
D52,Other,2020,0,1,0,1
D52,Fraud,2020,12,109,0,97
D43,Other,2020,3,8,0,5
D52,Other,2020,9,11,0,2
D52,Fraud,2020,12,108,0,96
D43,Other,2020,16,23,0,7
D52,Other,2020,18,28,0,10
D52,Fraud,2020,1,6,0,5
D43,Other,2020,1,3,0,2
D52,Other,2020,0,1,0,1
D52,Fraud,2020,15,76,0,61
D43,Other Criminal Violations - Offensive Weapons,2020,2,3,0,1
D43,Other,2020,15,29,0,14
D52,Other,2020,22,28,0,6
D52,Fraud,2020,3,26,0,23
D43,Other Criminal Violations - Offensive Weapons,2020,8,9,0,1
D43,Other,2020,55,92,0,37
D52,Fraud,2020,14,150,0,136
D43,Other Criminal Violations - Offensive Weapons,2020,1,1,1,0
D43,Other,2020,5,7,0,2
D52,Other,2020,11,13,0,2
D43,Other,2020,24,43,0,19
D52,Other,2020,12,23,0,11
D52,Fraud,2020,44,307,0,263
D43,Robbery-Financial,2020,1,1,1,0
D52,Other,2020,18,50,0,32
D52,Other,2020,30,116,0,86
D43,Robbery-Financial,2020,1,1,1,0
D52,Robbery-Financial,2020,1,1,1,0
D52,Other,2020,3,7,0,4
D43,Robbery-Other,2020,0,3,0,3
D52,Robbery-Financial,2020,1,1,1,0
D52,Other,2020,9,18,0,9
D43,Robbery-Other,2020,10,15,0,5
D52,Robbery-Financial,2020,0,1,0,1
D52,Other,2020,19,63,0,44
D43,Robbery-Other,2020,0,3,0,3
D52,Robbery-Other,2020,9,17,0,8
D52,Other,2020,40,160,0,120
D43,Robbery-Other,2020,10,12,0,2
D52,Robbery-Other,2020,0,2,0,2
D52,Other,2020,1,8,0,7
D43,Robbery-Other,2020,4,12,0,8
D52,Robbery-Other,2020,2,9,0,7
D52,Other,2020,17,188,0,171
D43,Robbery-Other,2020,11,25,0,14
D52,Other,2020,7,76,0,69
D43,Other Criminal Violations - Offensive Weapons,2020,7,8,0,1
D43,Robbery-Other,2020,0,3,0,3
D43,Other Criminal Violations - Offensive Weapons,2020,26,30,0,4
D43,Robbery-Other,2020,2,2,1,0
D43,Other Criminal Violations - Offensive Weapons,2020,16,18,0,2
D43,Robbery-Other,2020,5,7,0,2
D43,Other,2020,1,1,1,0
D43,Robbery-Other,2020,3,10,0,7
D43,Other,2020,1,1,1,0
D43,Robbery-Other,2020,15,31,0,16
D43,Other,2020,1,1,1,0
D43,Robbery-Other,2020,2,4,0,2
D43,Other,2020,2,3,0,1
D43,Other,2020,1,1,1,0
D43,Robbery-Other,2020,12,21,0,9
D43,Other,2020,3,5,0,2
D43,Sexual Violation,2020,2,3,0,1
D43,Sexual Violation,2020,5,9,0,4
D43,Other,2020,2,2,1,0
D43,Sexual Violation,2020,3,8,0,5
D51,Other,2020,9,9,1,0
D43,Sexual Violation,2020,3,7,0,4
D51,Other,2020,38,38,1,0
D43,Sexual Violation,2020,3,5,0,2
D51,Other,2020,51,57,0,6
D43,Sexual Violation,2020,7,14,0,7
D51,Other,2020,159,166,0,7
D43,Sexual Violation,2020,4,14,0,10
D51,Other,2020,1,1,1,0
D43,Sexual Violation,2020,3,5,0,2
D51,Other,2020,27,31,0,4
D43,Sexual Violation,2020,6,10,0,4
D51,Other,2020,35,36,0,1
D43,Sexual Violation,2020,13,24,0,11
D51,Other,2020,4,4,1,0
D43,Sexual Violation,2020,35,52,0,17
D43,Sexual Violation,2020,0,1,0,1
D43,Sexual Violation,2020,8,12,0,4
D43,Other,2020,5,6,0,1
D43,Other,2020,9,9,1,0
D43,Other,2020,3,3,1,0
D43,Other,2020,10,12,0,2
D43,Other,2020,13,14,0,1
D43,Other,2020,27,29,0,2
D53,Fraud,2020,0,1,0,1
D53,Fraud,2020,5,50,0,45
D53,Fraud,2020,2,46,0,44
D53,Other,2020,27,168,0,141
D53,Other,2020,0,13,0,13
D53,Other,2020,0,6,0,6
D53,Other,2020,1,12,0,11
D53,Other,2020,1,4,0,3
D53,Other,2020,5,23,0,18
D53,Other,2020,1,7,0,6
D53,Other,2020,4,40,0,36
D53,Other,2020,8,47,0,39
D53,Other,2020,7,57,0,50
D53,Other,2020,0,1,0,1
D53,Other,2020,1,1,1,0
D53,Other,2020,16,50,0,34
D53,Other,2020,25,120,0,95
D53,Other,2020,17,50,0,33
D53,Other,2020,10,55,0,45
D53,Other,2020,0,1,0,1
D53,Other,2020,18,64,0,46
D53,Other,2020,1,25,0,24
D53,Theft Over $5000,2020,1,21,0,20
D53,Theft Over $5000,2020,0,2,0,2
D53,Theft Over $5000,2020,0,2,0,2
D53,Theft Over $5000,2020,0,6,0,6
D53,Theft Over $5000,2020,0,7,0,7
D53,Theft Over $5000,2020,1,3,0,2
D53,Theft Over $5000,2020,0,12,0,12
D53,Theft Over $5000,2020,1,6,0,5
D53,Theft Over $5000,2020,1,4,0,3
D53,Theft Over $5000,2020,1,6,0,5
D53,Theft Over $5000,2020,0,10,0,10
D53,Theft Over $5000,2020,1,5,0,4
D53,Theft Over $5000,2020,0,4,0,4
D53,Theft Over $5000,2020,0,7,0,7
D53,Theft Over $5000,2020,0,3,0,3
D53,Theft Under $5000,2020,86,633,0,547
D53,Theft Under $5000,2020,0,3,0,3
D53,Theft Under $5000,2020,3,31,0,28
D53,Theft Under $5000,2020,1,37,0,36
D53,Theft Under $5000,2020,3,42,0,39
D53,Theft Under $5000,2020,0,4,0,4
D53,Theft Under $5000,2020,3,48,0,45
D53,Theft Under $5000,2020,4,33,0,29
D53,Theft Under $5000,2020,3,96,0,93
D53,Theft Under $5000,2020,2,101,0,99
D53,Theft Under $5000,2020,34,216,0,182
D53,Theft Under $5000,2020,0,2,0,2
D53,Theft Under $5000,2020,17,135,0,118
D55,Break & Enter-House,2020,2,7,0,5
D53,Robbery-Other,2020,0,1,0,1
D55,Break & Enter-House,2020,0,12,0,12
D55,Break & Enter-House,2020,0,12,0,12
D53,Robbery-Other,2020,3,3,1,0
D55,Auto Theft,2020,5,28,0,23
D53,Break & Enter-Commercial,2020,6,24,0,18
D55,Break & Enter-House,2020,1,3,0,2
D53,Robbery-Other,2020,7,15,0,8
D53,Break & Enter-Commercial,2020,3,29,0,26
D55,Auto Theft,2020,2,17,0,15
D55,Break & Enter-House,2020,4,17,0,13
D53,Robbery-Other,2020,6,9,0,3
D53,Theft Under $5000,2020,74,347,0,273
D53,Other,2020,0,1,0,1
D53,Break & Enter-Commercial,2020,5,28,0,23
D53,Break & Enter-Commercial,2020,8,24,0,16
D53,Break & Enter-Commercial,2020,5,17,0,12
D53,Break & Enter-Commercial,2020,1,11,0,10
D53,Break & Enter-House,2020,7,20,0,13
D53,Break & Enter-House,2020,0,4,0,4
D53,Break & Enter-House,2020,0,6,0,6
D53,Break & Enter-House,2020,0,6,0,6
D53,Break & Enter-House,2020,0,6,0,6
D53,Break & Enter-House,2020,0,9,0,9
D53,Break & Enter-House,2020,1,31,0,30
D53,Break & Enter-House,2020,6,27,0,21
D53,Break & Enter-House,2020,1,10,0,9
D53,Break & Enter-House,2020,2,34,0,32
D53,Break & Enter-House,2020,0,4,0,4
D53,Break & Enter-House,2020,3,11,0,8
D53,Break & Enter-House,2020,2,7,0,5
D53,Break & Enter-Other,2020,3,12,0,9
D53,Break & Enter-Other,2020,2,2,1,0
D53,Break & Enter-Other,2020,0,2,0,2
D53,Break & Enter-Other,2020,0,2,0,2
D53,Break & Enter-Other,2020,1,1,1,0
D53,Break & Enter-Other,2020,0,3,0,3
D53,Break & Enter-Other,2020,0,5,0,5
D53,Break & Enter-Other,2020,0,8,0,8
D53,Break & Enter-Other,2020,0,6,0,6
D53,Break & Enter-Other,2020,1,9,0,8
D53,Break & Enter-Other,2020,2,10,0,8
D53,Break & Enter-Other,2020,0,5,0,5
D53,Break & Enter-Other,2020,1,3,0,2
D53,Break & Enter-Other,2020,0,4,0,4
D53,Fraud,2020,16,119,0,103
D53,Fraud,2020,0,2,0,2
D53,Fraud,2020,1,16,0,15
D53,Fraud,2020,1,15,0,14
D53,Fraud,2020,4,17,0,13
D53,Fraud,2020,0,2,0,2
D53,Fraud,2020,0,17,0,17
D53,Fraud,2020,1,10,0,9
D53,Fraud,2020,0,26,0,26
D53,Fraud,2020,11,39,0,28
D53,Fraud,2020,5,52,0,47
D53,Fraud,2020,1,1,1,0
D53,Fraud,2020,5,66,0,61
D53,Other,2020,16,22,0,6
D53,Fraud,2020,6,88,0,82
D53,Fraud,2020,11,104,0,93
D53,Fraud,2020,5,52,0,47
D53,Fraud,2020,0,1,0,1
D55,Break & Enter-House,2020,0,1,0,1
D53,Robbery-Other,2020,1,4,0,3
D53,Other,2020,1,1,1,0
D55,Break & Enter-House,2020,4,18,0,14
D53,Theft Under $5000,2020,42,304,0,262
D53,Theft Under $5000,2020,76,254,0,178
D53,Theft Under $5000,2020,0,1,0,1
D53,Theft Under $5000,2020,29,234,0,205
D53,Theft Under $5000,2020,19,116,0,97
D53,Assault,2020,80,160,0,80
D53,Other,2020,2,2,1,0
D55,Auto Theft,2020,2,30,0,28
D53,Other,2020,2,2,1,0
D53,Assault,2020,2,4,0,2
D55,Break & Enter-House,2020,5,7,0,2
D53,Robbery-Other,2020,3,7,0,4
D53,Other,2020,32,34,0,2
D55,Auto Theft,2020,0,14,0,14
D53,Other,2020,2,2,1,0
D53,Assault,2020,1,10,0,9
D55,Break & Enter-House,2020,1,10,0,9
D53,Robbery-Other,2020,1,1,1,0
D53,Other,2020,59,68,0,9
D55,Auto Theft,2020,2,20,0,18
D53,Other,2020,1,1,1,0
D53,Assault,2020,7,15,0,8
D55,Break & Enter-House,2020,2,11,0,9
D53,Sexual Violation,2020,10,23,0,13
D53,Other,2020,28,40,0,12
D55,Auto Theft,2020,0,8,0,8
D53,Other,2020,10,10,1,0
D53,Assault,2020,15,18,0,3
D55,Break & Enter-House,2020,9,37,0,28
D53,Sexual Violation,2020,2,3,0,1
D53,Other,2020,35,49,0,14
D55,Auto Theft,2020,0,7,0,7
D53,Other,2020,5,5,1,0
D53,Assault,2020,1,1,1,0
D55,Break & Enter-House,2020,2,5,0,3
D53,Sexual Violation,2020,1,7,0,6
D53,Other,2020,83,90,0,7
D55,Auto Theft,2020,3,34,0,31
D53,Other,2020,4,4,1,0
D53,Assault,2020,7,17,0,10
D55,Break & Enter-House,2020,10,23,0,13
D53,Sexual Violation,2020,1,3,0,2
D53,Other,2020,9,17,0,8
D53,Other Criminal Violations - Offensive Weapons,2020,7,10,0,3
D53,Other Criminal Violations - Offensive Weapons,2020,2,2,1,0
D53,Other Criminal Violations - Offensive Weapons,2020,2,2,1,0
D53,Other Criminal Violations - Offensive Weapons,2020,0,2,0,2
D53,Other Criminal Violations - Offensive Weapons,2020,1,1,1,0
D53,Other Criminal Violations - Offensive Weapons,2020,1,1,1,0
D53,Other Criminal Violations - Offensive Weapons,2020,1,1,1,0
D53,Other Criminal Violations - Offensive Weapons,2020,1,1,1,0
D53,Other Criminal Violations - Offensive Weapons,2020,10,15,0,5
D53,Other Criminal Violations - Offensive Weapons,2020,12,15,0,3
D53,Other Criminal Violations - Offensive Weapons,2020,2,2,1,0
D53,Other Criminal Violations - Offensive Weapons,2020,6,7,0,1
D53,Other Criminal Violations - Offensive Weapons,2020,5,5,1,0
D53,Other Criminal Violations - Offensive Weapons,2020,1,1,1,0
D53,Other,2020,1,1,1,0
D53,Other,2020,1,1,1,0
D53,Other,2020,1,1,1,0
D53,Other,2020,0,1,0,1
D53,Other,2020,1,1,1,0
D53,Other,2020,2,2,1,0
D55,Other,2020,3,3,1,0
D55,Other,2020,3,6,0,3
D55,Other,2020,2,2,1,0
D55,Other,2020,2,2,1,0
D55,Other,2020,13,13,1,0
D55,Other,2020,3,3,1,0
D55,Other,2020,2,2,1,0
D55,Other,2020,3,3,1,0
D55,Other,2020,9,9,1,0
D55,Other,2020,2,2,1,0
D55,Other,2020,5,5,1,0
D55,Other,2020,18,18,1,0
D55,Other,2020,9,9,1,0
D55,Other,2020,1,1,1,0
D55,Other,2020,7,7,1,0
D55,Other,2020,4,4,1,0
D55,Other,2020,2,3,0,1
D55,Auto Theft,2020,2,7,0,5
D55,Auto Theft,2020,2,7,0,5
D55,Auto Theft,2020,0,7,0,7
D55,Auto Theft,2020,3,16,0,13
D55,Auto Theft,2020,0,14,0,14
D55,Break & Enter-House,2020,1,1,1,0
D53,Other,2020,4,4,1,0
D53,Sexual Violation,2020,1,2,0,1
D53,Assault,2020,1,5,0,4
D55,Break & Enter-House,2020,4,17,0,13
D55,Auto Theft,2020,5,24,0,19
D53,Other,2020,1,1,1,0
D53,Sexual Violation,2020,1,2,0,1
D53,Assault,2020,11,24,0,13
D55,Break & Enter-House,2020,1,5,0,4
D55,Auto Theft,2020,2,9,0,7
D53,Auto Theft,2020,4,24,0,20
D53,Sexual Violation,2020,2,7,0,5
D53,Assault,2020,15,24,0,9
D55,Break & Enter-Other,2020,1,2,0,1
D55,Auto Theft,2020,1,11,0,10
D53,Auto Theft,2020,0,1,0,1
D53,Sexual Violation,2020,1,5,0,4
D53,Assault,2020,29,38,0,9
D55,Break & Enter-Other,2020,0,2,0,2
D55,Auto Theft,2020,1,4,0,3
D53,Auto Theft,2020,3,23,0,20
D53,Sexual Violation,2020,5,11,0,6
D53,Assault,2020,2,3,0,1
D55,Break & Enter-Other,2020,1,3,0,2
D55,Break & Enter-Apartment,2020,1,7,0,6
D53,Auto Theft,2020,0,6,0,6
D53,Sexual Violation,2020,1,2,0,1
D53,Assault,2020,46,67,0,21
D55,Break & Enter-Other,2020,0,6,0,6
D55,Break & Enter-Apartment,2020,3,10,0,7
D53,Auto Theft,2020,2,14,0,12
D53,Sexual Violation,2020,1,10,0,9
D53,Assault,2020,60,134,0,74
D55,Break & Enter-Other,2020,0,6,0,6
D55,Break & Enter-Apartment,2020,2,7,0,5
D53,Auto Theft,2020,2,16,0,14
D53,Sexual Violation,2020,5,13,0,8
D53,Assault,2020,40,75,0,35
D55,Break & Enter-Other,2020,0,4,0,4
D55,Break & Enter-Apartment,2020,0,6,0,6
D53,Auto Theft,2020,0,15,0,15
D53,Sexual Violation,2020,7,18,0,11
D53,Assault,2020,46,82,0,36
D55,Break & Enter-Other,2020,0,1,0,1
D55,Break & Enter-Apartment,2020,4,18,0,14
D53,Auto Theft,2020,5,31,0,26
D53,Auto Theft,2020,2,43,0,41
D53,Auto Theft,2020,1,19,0,18
D53,Auto Theft,2020,1,1,1,0
D53,Auto Theft,2020,0,13,0,13
D53,Auto Theft,2020,4,52,0,48
D53,Auto Theft,2020,4,16,0,12
D53,Auto Theft,2020,1,20,0,19
D53,Auto Theft,2020,0,18,0,18
D53,Auto Theft,2020,3,9,0,6
D53,Break & Enter-Apartment,2020,17,54,0,37
D53,Break & Enter-Apartment,2020,0,1,0,1
D53,Break & Enter-Apartment,2020,0,1,0,1
D53,Break & Enter-Apartment,2020,2,14,0,12
D53,Break & Enter-Apartment,2020,0,2,0,2
D53,Break & Enter-Apartment,2020,0,3,0,3
D53,Break & Enter-Apartment,2020,2,10,0,8
D53,Break & Enter-Apartment,2020,0,3,0,3
D53,Break & Enter-Apartment,2020,4,9,0,5
D53,Break & Enter-Apartment,2020,11,58,0,47
D53,Break & Enter-Apartment,2020,2,27,0,25
D53,Break & Enter-Apartment,2020,1,28,0,27
D53,Break & Enter-Apartment,2020,3,12,0,9
D53,Break & Enter-Apartment,2020,2,3,0,1
D53,Break & Enter-Apartment,2020,2,5,0,3
D53,Break & Enter-Commercial,2020,15,57,0,42
D53,Break & Enter-Commercial,2020,1,9,0,8
D53,Break & Enter-Commercial,2020,0,2,0,2
D53,Break & Enter-Commercial,2020,0,2,0,2
D53,Break & Enter-Commercial,2020,1,2,0,1
D53,Break & Enter-Commercial,2020,1,1,1,0
D53,Break & Enter-Commercial,2020,1,14,0,13
D53,Break & Enter-Commercial,2020,1,5,0,4
D53,Break & Enter-Commercial,2020,2,10,0,8
D53,Sexual Violation,2020,5,12,0,7
D53,Assault,2020,2,4,0,2
D55,Break & Enter-Other,2020,0,2,0,2
D55,Break & Enter-Apartment,2020,1,6,0,5
D53,Sexual Violation,2020,0,1,0,1
D53,Assault,2020,43,87,0,44
D55,Break & Enter-Other,2020,0,1,0,1
D55,Break & Enter-Apartment,2020,1,4,0,3
D53,Sexual Violation,2020,2,9,0,7
D53,Sexual Violation,2020,3,3,1,0
D53,Other,2020,9,9,1,0
D53,Other,2020,2,2,1,0
D53,Other,2020,1,2,0,1
D53,Other,2020,1,2,0,1
D53,Other,2020,2,3,0,1
D53,Other,2020,5,5,1,0
D53,Other,2020,5,5,1,0
D53,Other,2020,4,5,0,1
D53,Other,2020,5,5,1,0
D53,Other,2020,2,2,1,0
D53,Other,2020,6,9,0,3
D53,Other,2020,3,3,1,0
D53,Other,2020,4,6,0,2
D53,Other,2020,7,7,1,0
D53,Other,2020,0,2,0,2
D53,Other,2020,65,77,0,12
D53,Other,2020,1,1,1,0
D53,Other,2020,1,1,1,0
D53,Other,2020,4,4,1,0
D53,Other,2020,2,3,0,1
D53,Other,2020,2,2,1,0
D53,Other,2020,6,9,0,3
D53,Other,2020,4,6,0,2
D53,Other,2020,1,1,1,0
D53,Other,2020,9,11,0,2
D53,Other,2020,10,14,0,4
D55,Break & Enter-Apartment,2020,0,1,0,1
D55,Break & Enter-Apartment,2020,2,6,0,4
D55,Break & Enter-Apartment,2020,5,12,0,7
D55,Break & Enter-Apartment,2020,0,2,0,2
D55,Break & Enter-Apartment,2020,2,12,0,10
D55,Break & Enter-Apartment,2020,4,21,0,17
D55,Break & Enter-Apartment,2020,3,15,0,12
D55,Break & Enter-Apartment,2020,7,13,0,6
D55,Break & Enter-Apartment,2020,1,6,0,5
D55,Break & Enter-Apartment,2020,2,8,0,6
D55,Break & Enter-Apartment,2020,1,5,0,4
D55,Break & Enter-Commercial,2020,4,11,0,7
D55,Break & Enter-Commercial,2020,1,8,0,7
D55,Break & Enter-Commercial,2020,3,23,0,20
D55,Break & Enter-Commercial,2020,1,9,0,8
D55,Break & Enter-Commercial,2020,3,26,0,23
D55,Break & Enter-Commercial,2020,0,2,0,2
D55,Break & Enter-Commercial,2020,5,16,0,11
D55,Break & Enter-Commercial,2020,0,2,0,2
D55,Break & Enter-Commercial,2020,1,8,0,7
D55,Break & Enter-Commercial,2020,2,6,0,4
D55,Break & Enter-Commercial,2020,1,2,0,1
D55,Break & Enter-Commercial,2020,6,24,0,18
D55,Break & Enter-Commercial,2020,18,68,0,50
D53,Assault,2020,9,21,0,12
D55,Break & Enter-Commercial,2020,2,10,0,8
D53,Other,2020,12,36,0,24
D55,Break & Enter-Commercial,2020,9,23,0,14
D53,Other,2020,0,1,0,1
D55,Break & Enter-Commercial,2020,3,11,0,8
D55,Break & Enter-Commercial,2020,4,6,0,2
D53,Other,2020,5,9,0,4
D55,Break & Enter-House,2020,4,7,0,3
D53,Other,2020,2,5,0,3
D55,Break & Enter-House,2020,0,5,0,5
D53,Other,2020,3,10,0,7
D53,Other,2020,5,7,0,2
D53,Other,2020,1,5,0,4
D53,Other,2020,2,6,0,4
D53,Other,2020,4,14,0,10
D53,Other,2020,3,3,1,0
D53,Other,2020,13,17,0,4
D53,Other,2020,7,18,0,11
D53,Other,2020,6,15,0,9
D53,Other,2020,16,23,0,7
D53,Other,2020,10,19,0,9
D53,Other,2020,5,12,0,7
D53,Robbery-Other,2020,11,24,0,13
D53,Robbery-Other,2020,0,1,0,1
D53,Robbery-Other,2020,1,1,1,0
D53,Robbery-Other,2020,2,2,1,0
D53,Robbery-Other,2020,1,4,0,3
D53,Robbery-Other,2020,6,9,0,3
D53,Robbery-Other,2020,3,7,0,4
D53,Robbery-Other,2020,7,11,0,4
D53,Robbery-Other,2020,0,2,0,2
D55,Break & Enter-Other,2020,0,3,0,3
D55,Break & Enter-Other,2020,2,12,0,10
D55,Break & Enter-Other,2020,0,1,0,1
D55,Break & Enter-Other,2020,0,7,0,7
D55,Break & Enter-Other,2020,0,1,0,1
D55,Break & Enter-Other,2020,0,3,0,3
D55,Break & Enter-Other,2020,0,2,0,2
D55,Fraud,2020,1,22,0,21
D55,Fraud,2020,4,32,0,28
D55,Fraud,2020,5,39,0,34
D55,Fraud,2020,1,36,0,35
D55,Fraud,2020,4,80,0,76
D55,Fraud,2020,0,57,0,57
D55,Fraud,2020,0,43,0,43
D55,Fraud,2020,1,3,0,2
D55,Fraud,2020,2,48,0,46
D55,Fraud,2020,7,75,0,68
D55,Fraud,2020,0,1,0,1
D55,Fraud,2020,2,22,0,20
D55,Fraud,2020,5,30,0,25
D55,Fraud,2020,13,122,0,109
D55,Fraud,2020,2,44,0,42
D55,Fraud,2020,1,65,0,64
D55,Fraud,2020,3,27,0,24
D55,Fraud,2020,2,34,0,32
D55,Fraud,2020,0,23,0,23
D55,Other,2020,11,62,0,51
D55,Other,2020,9,44,0,35
D55,Other,2020,12,67,0,55
D55,Other,2020,12,50,0,38
D55,Other,2020,45,146,0,101
D55,Other,2020,18,62,0,44
D55,Other,2020,35,119,0,84
D55,Other,2020,3,7,0,4
D55,Other,2020,5,40,0,35
D55,Other,2020,19,71,0,52
D55,Other,2020,5,28,0,23
D55,Other,2020,14,62,0,48
D55,Other,2020,55,231,0,176
D55,Other,2020,22,94,0,72
D55,Other,2020,15,97,0,82
D55,Other,2020,10,32,0,22
D55,Other,2020,17,66,0,49
D55,Other,2020,6,24,0,18
D55,Theft Over $5000,2020,0,5,0,5
D55,Theft Over $5000,2020,1,6,0,5
D55,Theft Over $5000,2020,0,2,0,2
D55,Theft Over $5000,2020,2,5,0,3
D55,Theft Over $5000,2020,1,5,0,4
D55,Theft Over $5000,2020,0,2,0,2
D55,Theft Over $5000,2020,0,4,0,4
D55,Theft Over $5000,2020,0,2,0,2
D55,Theft Over $5000,2020,1,10,0,9
D55,Theft Over $5000,2020,0,4,0,4
D55,Theft Over $5000,2020,0,7,0,7
D55,Theft Over $5000,2020,5,18,0,13
D55,Other,2020,13,20,0,7
D11,Break & Enter-Other,2021,3,7,0,4
D11,Other,2021,2,2,1,0
D55,Other,2020,1,3,0,2
D55,Theft Over $5000,2020,3,8,0,5
D55,Theft Over $5000,2020,1,10,0,9
D55,Theft Over $5000,2020,0,3,0,3
D55,Theft Over $5000,2020,1,4,0,3
D55,Theft Over $5000,2020,0,1,0,1
D55,Theft Under $5000,2020,48,171,0,123
D55,Theft Under $5000,2020,23,102,0,79
D55,Theft Under $5000,2020,0,1,0,1
D55,Theft Under $5000,2020,41,223,0,182
D55,Theft Under $5000,2020,5,124,0,119
D55,Theft Under $5000,2020,47,328,0,281
D55,Theft Under $5000,2020,11,78,0,67
D55,Theft Under $5000,2020,29,238,0,209
D55,Theft Under $5000,2020,1,3,0,2
D55,Theft Under $5000,2020,9,140,0,131
D55,Theft Under $5000,2020,26,149,0,123
D55,Theft Under $5000,2020,0,3,0,3
D55,Theft Under $5000,2020,11,100,0,89
D55,Theft Under $5000,2020,64,214,0,150
D11,Theft Under $5000,2021,1,22,0,21
D55,Other,2020,1,1,1,0
D11,Break & Enter-Other,2021,0,1,0,1
D11,Other,2021,1,1,1,0
D55,Other,2020,6,10,0,4
D55,Other,2020,0,1,0,1
D11,Theft Under $5000,2021,1,29,0,28
D55,Other,2020,2,3,0,1
D11,Break & Enter-Other,2021,2,4,0,2
D11,Other,2021,2,2,1,0
D55,Robbery-Financial,2020,0,3,0,3
D55,Other,2020,2,2,1,0
D11,Theft Under $5000,2021,0,2,0,2
D55,Other,2020,6,6,1,0
D11,Break & Enter-Other,2021,1,8,0,7
D11,Other,2021,8,8,1,0
D55,Robbery-Financial,2020,1,1,1,0
D55,Other,2020,1,1,1,0
D11,Theft Under $5000,2021,12,74,0,62
D55,Other,2020,1,1,1,0
D11,Break & Enter-Other,2021,1,2,0,1
D11,Auto Theft,2021,0,12,0,12
D55,Robbery-Financial,2020,1,1,1,0
D55,Other,2020,0,1,0,1
D11,Theft Under $5000,2021,19,351,0,332
D55,Other,2020,8,8,1,0
D11,Break & Enter-Other,2021,1,6,0,5
D11,Auto Theft,2021,2,23,0,21
D55,Robbery-Financial,2020,1,2,0,1
D55,Robbery-Other,2020,4,5,0,1
D55,Robbery-Other,2020,0,2,0,2
D55,Robbery-Other,2020,4,10,0,6
D55,Robbery-Other,2020,3,8,0,5
D55,Robbery-Other,2020,8,26,0,18
D55,Robbery-Other,2020,1,4,0,3
D55,Robbery-Other,2020,7,20,0,13
D55,Robbery-Other,2020,0,1,0,1
D55,Robbery-Other,2020,12,13,0,1
D55,Robbery-Other,2020,5,15,0,10
D55,Robbery-Other,2020,0,1,0,1
D55,Robbery-Other,2020,1,3,0,2
D55,Robbery-Other,2020,2,6,0,4
D55,Robbery-Other,2020,17,26,0,9
D55,Robbery-Other,2020,9,21,0,12
D55,Robbery-Other,2020,1,6,0,5
D55,Robbery-Other,2020,2,4,0,2
D55,Robbery-Other,2020,3,6,0,3
D55,Robbery-Other,2020,4,6,0,2
D55,Sexual Violation,2020,11,12,0,1
D55,Sexual Violation,2020,2,5,0,3
D55,Sexual Violation,2020,4,6,0,2
D55,Sexual Violation,2020,2,8,0,6
D55,Sexual Violation,2020,6,16,0,10
D55,Sexual Violation,2020,7,14,0,7
D55,Sexual Violation,2020,9,14,0,5
D55,Sexual Violation,2020,0,2,0,2
D55,Sexual Violation,2020,4,8,0,4
D55,Sexual Violation,2020,5,15,0,10
D55,Sexual Violation,2020,3,5,0,2
D55,Sexual Violation,2020,3,5,0,2
D55,Sexual Violation,2020,11,26,0,15
D55,Sexual Violation,2020,10,16,0,6
D55,Sexual Violation,2020,7,10,0,3
D55,Sexual Violation,2020,1,2,0,1
D55,Sexual Violation,2020,3,10,0,7
D55,Sexual Violation,2020,5,7,0,2
D55,Other,2020,4,4,1,0
D55,Other,2020,8,8,1,0
D55,Other,2020,1,1,1,0
D55,Other,2020,5,6,0,1
D55,Other,2020,15,15,1,0
D55,Other,2020,9,11,0,2
D55,Other,2020,5,5,1,0
NSA,Other,2020,76,89,0,13
D55,Other,2020,21,21,1,0
D11,Theft Under $5000,2021,16,236,0,220
D11,Break & Enter-Other,2021,1,1,1,0
NSA,Auto Theft,2020,2,28,0,26
D11,Theft Under $5000,2021,1,14,0,13
D55,Other,2020,7,8,0,1
NSA,Auto Theft,2020,2,2,1,0
D11,Break & Enter-Other,2021,1,1,1,0
D11,Theft Under $5000,2021,1,25,0,24
D55,Other,2020,4,4,1,0
NSA,Break & Enter-Apartment,2020,3,17,0,14
D11,Auto Theft,2021,2,28,0,26
D11,Fraud,2021,0,35,0,35
D55,Other,2020,2,2,1,0
NSA,Break & Enter-Commercial,2020,3,27,0,24
D11,Auto Theft,2021,0,18,0,18
D11,Assault,2021,0,1,0,1
D11,Fraud,2021,4,44,0,40
D55,Other,2020,3,4,0,1
NSA,Break & Enter-House,2020,1,5,0,4
D11,Auto Theft,2021,5,28,0,23
D11,Assault,2021,24,46,0,22
D11,Fraud,2021,9,69,0,60
D55,Other,2020,15,17,0,2
NSA,Break & Enter-Other,2020,1,2,0,1
D11,Auto Theft,2021,0,11,0,11
D11,Assault,2021,52,87,0,35
D11,Fraud,2021,9,58,0,49
D11,Fraud,2021,2,47,0,45
D11,Fraud,2021,0,13,0,13
D11,Fraud,2021,0,9,0,9
D11,Fraud,2021,0,1,0,1
D11,Fraud,2021,1,9,0,8
D11,Fraud,2021,3,59,0,56
D11,Fraud,2021,2,31,0,29
D11,Fraud,2021,0,4,0,4
D11,Fraud,2021,1,19,0,18
D11,Other,2021,1,1,1,0
D11,Other,2021,6,53,0,47
D11,Other,2021,25,89,0,64
D11,Other,2021,18,65,0,47
D11,Other,2021,13,54,0,41
D11,Other,2021,24,115,0,91
D11,Other,2021,7,22,0,15
D11,Other,2021,4,26,0,22
D11,Other,2021,1,3,0,2
D11,Other,2021,2,4,0,2
D11,Other,2021,28,105,0,77
D11,Other,2021,5,30,0,25
D11,Other,2021,4,13,0,9
D11,Other,2021,13,35,0,22
D11,Theft Over $5000,2021,1,2,0,1
D11,Theft Over $5000,2021,1,5,0,4
D11,Theft Over $5000,2021,0,4,0,4
D11,Theft Over $5000,2021,1,4,0,3
D11,Theft Over $5000,2021,3,6,0,3
D11,Theft Over $5000,2021,0,1,0,1
D11,Theft Over $5000,2021,0,2,0,2
D11,Theft Over $5000,2021,1,1,1,0
D11,Theft Over $5000,2021,1,8,0,7
D11,Theft Over $5000,2021,1,8,0,7
D11,Theft Under $5000,2021,33,257,0,224
D11,Theft Under $5000,2021,49,420,0,371
D11,Theft Under $5000,2021,27,158,0,131
D11,Theft Under $5000,2021,82,431,0,349
D11,Theft Under $5000,2021,37,272,0,235
D11,Assault,2021,51,78,0,27
D11,Auto Theft,2021,0,5,0,5
NSA,Fraud,2020,0,1,0,1
D11,Assault,2021,51,82,0,31
D55,Other,2020,16,19,0,3
D11,Auto Theft,2021,1,1,1,0
NSA,Fraud,2020,0,1,0,1
D11,Assault,2021,83,142,0,59
D55,Other,2020,1,1,1,0
D55,Other,2020,28,33,0,5
D55,Other,2020,21,28,0,7
D55,Other,2020,61,75,0,14
D55,Other,2020,55,67,0,12
D55,Other,2020,55,68,0,13
D55,Other,2020,3,4,0,1
D55,Other,2020,15,18,0,3
D55,Other,2020,38,45,0,7
D55,Other,2020,2,2,1,0
D55,Other,2020,16,19,0,3
D55,Other,2020,27,30,0,3
D55,Other,2020,71,89,0,18
D55,Other,2020,69,82,0,13
D55,Other,2020,32,40,0,8
D55,Other,2020,30,30,1,0
D55,Other,2020,129,142,0,13
D55,Other,2020,11,13,0,2
D55,Other Criminal Violations - Offensive Weapons,2020,7,8,0,1
D55,Other Criminal Violations - Offensive Weapons,2020,3,4,0,1
D55,Other Criminal Violations - Offensive Weapons,2020,6,6,1,0
D55,Other Criminal Violations - Offensive Weapons,2020,3,3,1,0
D55,Other Criminal Violations - Offensive Weapons,2020,6,8,0,2
D55,Other Criminal Violations - Offensive Weapons,2020,8,9,0,1
D55,Other Criminal Violations - Offensive Weapons,2020,6,6,1,0
D55,Other Criminal Violations - Offensive Weapons,2020,3,4,0,1
D55,Other Criminal Violations - Offensive Weapons,2020,4,5,0,1
D55,Other Criminal Violations - Offensive Weapons,2020,1,1,1,0
D55,Other Criminal Violations - Offensive Weapons,2020,3,3,1,0
D55,Other Criminal Violations - Offensive Weapons,2020,5,7,0,2
D55,Other Criminal Violations - Offensive Weapons,2020,11,15,0,4
D55,Other Criminal Violations - Offensive Weapons,2020,4,4,1,0
D55,Other Criminal Violations - Offensive Weapons,2020,3,3,1,0
D55,Other Criminal Violations - Offensive Weapons,2020,3,4,0,1
D55,Other Criminal Violations - Offensive Weapons,2020,2,3,0,1
D55,Other,2020,0,1,0,1
D55,Other,2020,1,1,1,0
D55,Other,2020,0,1,0,1
D11,Auto Theft,2021,0,5,0,5
NSA,Fraud,2020,0,1,0,1
D11,Auto Theft,2021,2,20,0,18
D11,Auto Theft,2021,0,20,0,20
NSA,Fraud,2020,1,1,1,0
D11,Auto Theft,2021,0,4,0,4
NSA,Fraud,2020,20,184,0,164
D11,Auto Theft,2021,1,7,0,6
NSA,Fraud,2020,0,2,0,2
D11,Break & Enter-Apartment,2021,0,6,0,6
NSA,Other,2020,0,1,0,1
D11,Break & Enter-Apartment,2021,1,14,0,13
NSA,Other,2020,59,153,0,94
D11,Break & Enter-Apartment,2021,4,10,0,6
NSA,Other,2020,0,1,0,1
D11,Break & Enter-Apartment,2021,4,8,0,4
NSA,Theft Over $5000,2020,4,13,0,9
D11,Break & Enter-Apartment,2021,2,21,0,19
D11,Assault,2021,22,29,0,7
NSA,Theft Under $5000,2020,0,1,0,1
D11,Assault,2021,18,23,0,5
NSA,Theft Under $5000,2020,31,201,0,170
D11,Break & Enter-Apartment,2021,0,2,0,2
D11,Assault,2021,0,2,0,2
NSA,Theft Under $5000,2020,0,1,0,1
D11,Break & Enter-Apartment,2021,0,3,0,3
D11,Assault,2021,2,7,0,5
NSA,Assault,2020,0,1,0,1
D11,Break & Enter-Apartment,2021,9,22,0,13
D11,Assault,2021,53,81,0,28
NSA,Assault,2020,109,243,0,134
D11,Break & Enter-Apartment,2021,1,2,0,1
D11,Assault,2021,16,22,0,6
NSA,Assault,2020,0,1,0,1
D11,Break & Enter-Apartment,2021,5,9,0,4
D11,Assault,2021,5,14,0,9
NSA,Assault,2020,0,1,0,1
D11,Break & Enter-Commercial,2021,1,5,0,4
D11,Assault,2021,35,54,0,19
NSA,Attempt Murder,2020,1,1,1,0
D11,Break & Enter-Commercial,2021,1,7,0,6
D11,Attempt Murder,2021,1,1,1,0
NSA,Other,2020,19,69,0,50
D11,Break & Enter-Commercial,2021,3,9,0,6
D11,Other,2021,3,4,0,1
NSA,Robbery-Financial,2020,17,17,1,0
D11,Break & Enter-Commercial,2021,5,18,0,13
D11,Other,2021,8,11,0,3
NSA,Robbery-Other,2020,0,1,0,1
D11,Break & Enter-Commercial,2021,8,21,0,13
D11,Other,2021,7,13,0,6
D11,Other,2021,5,10,0,5
D11,Other,2021,17,30,0,13
D11,Other,2021,2,2,1,0
D11,Other,2021,6,9,0,3
D11,Other,2021,1,1,1,0
D11,Other,2021,12,17,0,5
D11,Other,2021,1,3,0,2
D11,Other,2021,2,3,0,1
D11,Other,2021,6,10,0,4
D11,Robbery-Financial,2021,1,1,1,0
D11,Robbery-Other,2021,1,2,0,1
D11,Robbery-Other,2021,6,8,0,2
D11,Robbery-Other,2021,7,10,0,3
D11,Robbery-Other,2021,2,4,0,2
D11,Robbery-Other,2021,8,10,0,2
D11,Robbery-Other,2021,0,1,0,1
D11,Robbery-Other,2021,3,11,0,8
D11,Robbery-Other,2021,2,2,1,0
D11,Robbery-Other,2021,1,1,1,0
D11,Robbery-Other,2021,0,4,0,4
D11,Sexual Violation,2021,5,10,0,5
D11,Sexual Violation,2021,7,20,0,13
D11,Sexual Violation,2021,5,15,0,10
D11,Sexual Violation,2021,2,7,0,5
D55,Theft Under $5000,2020,174,652,0,478
NSA,Robbery-Other,2020,22,45,0,23
D11,Break & Enter-Commercial,2021,0,2,0,2
D55,Theft Under $5000,2020,14,132,0,118
NSA,Sexual Violation,2020,0,1,0,1
D11,Break & Enter-Commercial,2021,6,8,0,2
D55,Theft Under $5000,2020,54,230,0,176
NSA,Sexual Violation,2020,0,1,0,1
D11,Break & Enter-Commercial,2021,0,1,0,1
D55,Theft Under $5000,2020,1,34,0,33
NSA,Sexual Violation,2020,33,128,0,95
D11,Break & Enter-Commercial,2021,7,28,0,21
D55,Theft Under $5000,2020,17,162,0,145
NSA,Sexual Violation,2020,1,1,1,0
D11,Break & Enter-Commercial,2021,2,7,0,5
D55,Theft Under $5000,2020,3,68,0,65
NSA,Sexual Violation,2020,0,1,0,1
D11,Break & Enter-Commercial,2021,0,1,0,1
D55,Assault,2020,0,1,0,1
NSA,Other,2020,72,81,0,9
D11,Break & Enter-Commercial,2021,0,2,0,2
D11,Break & Enter-House,2021,0,4,0,4
D11,Break & Enter-House,2021,1,10,0,9
D11,Break & Enter-House,2021,2,10,0,8
D11,Break & Enter-House,2021,2,6,0,4
D11,Break & Enter-House,2021,4,16,0,12
D11,Break & Enter-House,2021,2,2,1,0
D11,Break & Enter-House,2021,1,2,0,1
D11,Break & Enter-House,2021,5,12,0,7
D11,Break & Enter-House,2021,1,2,0,1
D11,Break & Enter-House,2021,2,5,0,3
D11,Break & Enter-Other,2021,0,1,0,1
NSA,Other,2020,0,1,0,1
NSA,Other,2020,181,202,0,21
D55,Assault,2020,30,52,0,22
NSA,Other Criminal Violations - Offensive Weapons,2020,51,58,0,7
D55,Assault,2020,40,55,0,15
NSA,Other,2020,4,11,0,7
D55,Assault,2020,2,4,0,2
D11,Other,2021,3,3,1,0
D55,Assault,2020,30,55,0,25
D11,Other,2021,4,4,1,0
D55,Assault,2020,36,55,0,19
D11,Other,2021,3,4,0,1
D55,Assault,2020,74,130,0,56
D55,Assault,2020,67,108,0,41
D11,Other,2021,3,5,0,2
D55,Assault,2020,79,111,0,32
D11,Other,2021,12,14,0,2
D55,Assault,2020,1,4,0,3
D11,Other,2021,2,2,1,0
D55,Assault,2020,23,35,0,12
D55,Assault,2020,72,101,0,29
D55,Assault,2020,2,2,1,0
D55,Assault,2020,19,25,0,6
D55,Assault,2020,44,66,0,22
D55,Assault,2020,105,179,0,74
D55,Assault,2020,58,100,0,42
D55,Assault,2020,45,80,0,35
D55,Assault,2020,25,57,0,32
D55,Assault,2020,50,64,0,14
D55,Assault,2020,15,28,0,13
D55,Attempt Murder,2020,2,2,1,0
D55,Attempt Murder,2020,1,1,1,0
D55,Attempt Murder,2020,1,2,0,1
D55,Attempt Murder,2020,0,2,0,2
D55,Attempt Murder,2020,1,3,0,2
D55,Attempt Murder,2020,1,1,1,0
D55,Other,2020,10,17,0,7
D55,Other,2020,1,2,0,1
D55,Other,2020,9,13,0,4
D55,Other,2020,9,16,0,7
D55,Other,2020,13,23,0,10
D55,Other,2020,7,18,0,11
D55,Other,2020,14,16,0,2
D55,Other,2020,1,1,1,0
D55,Other,2020,0,1,0,1
D55,Other,2020,4,6,0,2
D55,Other,2020,17,31,0,14
D55,Other,2020,5,9,0,4
D55,Other,2020,5,9,0,4
D55,Other,2020,27,42,0,15
D55,Other,2020,6,15,0,9
D55,Other,2020,3,11,0,8
D55,Other,2020,6,10,0,4
D13,Break & Enter-House,2021,1,6,0,5
D13,Break & Enter-House,2021,0,2,0,2
D13,Break & Enter-House,2021,1,5,0,4
D13,Break & Enter-House,2021,0,5,0,5
D13,Break & Enter-House,2021,6,16,0,10
D13,Break & Enter-House,2021,1,8,0,7
D13,Break & Enter-House,2021,1,7,0,6
D13,Break & Enter-Other,2021,3,5,0,2
D13,Break & Enter-Other,2021,0,2,0,2
D13,Break & Enter-Other,2021,2,5,0,3
D13,Break & Enter-Other,2021,0,2,0,2
D13,Break & Enter-Other,2021,1,5,0,4
D13,Break & Enter-Other,2021,1,2,0,1
D13,Break & Enter-Other,2021,2,4,0,2
D13,Break & Enter-Other,2021,2,6,0,4
D13,Break & Enter-Other,2021,0,2,0,2
D13,Fraud,2021,4,42,0,38
D13,Fraud,2021,1,16,0,15
D13,Fraud,2021,1,12,0,11
D13,Fraud,2021,0,36,0,36
D13,Fraud,2021,1,14,0,13
D13,Fraud,2021,1,14,0,13
D13,Fraud,2021,1,25,0,24
D13,Fraud,2021,2,27,0,25
D13,Fraud,2021,1,11,0,10
D13,Fraud,2021,0,1,0,1
D12,Other,2021,4,4,1,0
D13,Fraud,2021,3,49,0,46
D13,Fraud,2021,1,54,0,53
D13,Fraud,2021,3,29,0,26
D13,Other,2021,0,1,0,1
D13,Other,2021,11,48,0,37
D13,Other,2021,10,40,0,30
D13,Other,2021,6,27,0,21
D13,Other,2021,25,81,0,56
D13,Other,2021,4,13,0,9
D13,Other,2021,3,25,0,22
D13,Other,2021,3,28,0,25
D13,Other,2021,17,47,0,30
D13,Other,2021,2,15,0,13
D13,Other,2021,1,6,0,5
D13,Other,2021,31,94,0,63
D13,Other,2021,13,65,0,52
D13,Other,2021,13,61,0,48
D13,Theft Over $5000,2021,1,3,0,2
D13,Theft Over $5000,2021,0,5,0,5
D13,Theft Over $5000,2021,0,2,0,2
D13,Theft Over $5000,2021,0,4,0,4
D13,Theft Over $5000,2021,0,3,0,3
D13,Theft Over $5000,2021,0,1,0,1
D13,Theft Over $5000,2021,0,2,0,2
D13,Other,2021,6,6,1,0
D11,Sexual Violation,2021,9,15,0,6
D13,Theft Over $5000,2021,1,2,0,1
D12,Sexual Violation,2021,9,17,0,8
D12,Theft Under $5000,2021,0,27,0,27
D13,Theft Over $5000,2021,0,3,0,3
D13,Theft Over $5000,2021,1,8,0,7
D13,Theft Over $5000,2021,1,2,0,1
D13,Theft Over $5000,2021,0,5,0,5
D13,Theft Under $5000,2021,13,109,0,96
D13,Theft Under $5000,2021,6,49,0,43
D13,Theft Under $5000,2021,38,305,0,267
D13,Theft Under $5000,2021,6,72,0,66
D13,Other,2021,3,3,1,0
D13,Theft Under $5000,2021,2,51,0,49
D12,Theft Under $5000,2021,22,185,0,163
D13,Other,2021,2,2,1,0
D12,Other,2021,8,10,0,2
D12,Sexual Violation,2021,1,5,0,4
D11,Sexual Violation,2021,1,3,0,2
D13,Theft Under $5000,2021,5,39,0,34
D12,Theft Under $5000,2021,3,28,0,25
D13,Other,2021,5,5,1,0
D12,Other,2021,1,1,1,0
D12,Sexual Violation,2021,13,31,0,18
D11,Sexual Violation,2021,0,1,0,1
D13,Theft Under $5000,2021,8,148,0,140
D12,Assault,2021,34,50,0,16
D12,Assault,2021,84,126,0,42
D12,Assault,2021,18,28,0,10
D12,Assault,2021,44,66,0,22
D12,Assault,2021,18,27,0,9
D12,Assault,2021,61,87,0,26
D12,Assault,2021,5,17,0,12
D12,Assault,2021,63,106,0,43
D12,Assault,2021,36,49,0,13
D12,Assault,2021,113,173,0,60
D12,Assault,2021,11,26,0,15
D12,Attempt Murder,2021,0,1,0,1
D12,Attempt Murder,2021,1,1,1,0
D12,Attempt Murder,2021,0,1,0,1
D12,Attempt Murder,2021,2,2,1,0
D12,Other,2021,7,13,0,6
D12,Other,2021,9,24,0,15
D12,Other,2021,0,1,0,1
D12,Other,2021,5,10,0,5
D12,Other,2021,2,5,0,3
D12,Other,2021,18,27,0,9
D12,Other,2021,1,2,0,1
D12,Other,2021,0,4,0,4
D12,Other,2021,13,24,0,11
D12,Other,2021,2,6,0,4
D12,Other,2021,22,35,0,13
D12,Other,2021,2,11,0,9
D12,Robbery-Financial,2021,2,2,1,0
D12,Robbery-Other,2021,8,10,0,2
D12,Robbery-Other,2021,2,9,0,7
D12,Robbery-Other,2021,0,1,0,1
D12,Robbery-Other,2021,2,5,0,3
D12,Robbery-Other,2021,0,1,0,1
D12,Robbery-Other,2021,4,9,0,5
D12,Robbery-Other,2021,2,3,0,1
D12,Robbery-Other,2021,8,12,0,4
D12,Robbery-Other,2021,1,5,0,4
D12,Robbery-Other,2021,11,20,0,9
D12,Robbery-Other,2021,0,2,0,2
D12,Sexual Violation,2021,4,9,0,5
D12,Sexual Violation,2021,9,14,0,5
D12,Sexual Violation,2021,2,2,1,0
D12,Sexual Violation,2021,3,5,0,2
D12,Sexual Violation,2021,3,7,0,4
D12,Sexual Violation,2021,9,14,0,5
D12,Sexual Violation,2021,1,2,0,1
D12,Sexual Violation,2021,1,2,0,1
D12,Other,2021,11,16,0,5
D12,Sexual Violation,2021,4,10,0,6
D13,Theft Under $5000,2021,18,93,0,75
D11,Sexual Violation,2021,0,1,0,1
D12,Other,2021,3,6,0,3
D12,Other,2021,14,17,0,3
D13,Theft Under $5000,2021,2,23,0,21
D11,Sexual Violation,2021,4,13,0,9
D13,Other,2021,1,2,0,1
D12,Other,2021,16,18,0,2
D11,Sexual Violation,2021,1,7,0,6
D13,Theft Under $5000,2021,0,2,0,2
D13,Other,2021,1,1,1,0
D12,Other,2021,1,1,1,0
D12,Other,2021,6,7,0,1
D11,Sexual Violation,2021,0,1,0,1
D13,Theft Under $5000,2021,31,160,0,129
D13,Other,2021,2,3,0,1
D12,Other,2021,15,16,0,1
D12,Other,2021,11,11,1,0
D11,Sexual Violation,2021,3,8,0,5
D13,Theft Under $5000,2021,28,242,0,214
D13,Other,2021,1,1,1,0
D12,Other,2021,3,3,1,0
D12,Other,2021,3,3,1,0
D11,Other,2021,5,5,1,0
D13,Theft Under $5000,2021,20,140,0,120
D13,Other,2021,7,11,0,4
D12,Auto Theft,2021,1,18,0,17
D12,Other,2021,8,8,1,0
D11,Other,2021,9,10,0,1
D13,Assault,2021,39,63,0,24
D13,Other,2021,1,1,1,0
D12,Auto Theft,2021,2,50,0,48
D12,Other,2021,7,9,0,2
D11,Other,2021,28,30,0,2
D13,Assault,2021,36,59,0,23
D13,Other,2021,1,2,0,1
D12,Auto Theft,2021,3,9,0,6
D12,Other,2021,20,20,1,0
D11,Other,2021,9,10,0,1
D13,Assault,2021,10,31,0,21
D13,Auto Theft,2021,0,28,0,28
D12,Auto Theft,2021,3,24,0,21
D12,Other,2021,5,5,1,0
D11,Other,2021,8,9,0,1
D13,Assault,2021,67,100,0,33
D13,Auto Theft,2021,1,9,0,8
D12,Auto Theft,2021,0,12,0,12
D12,Other,2021,18,21,0,3
D11,Other,2021,2,2,1,0
D13,Assault,2021,9,18,0,9
D13,Assault,2021,5,10,0,5
D13,Assault,2021,8,16,0,8
D13,Assault,2021,32,45,0,13
D13,Assault,2021,9,12,0,3
D13,Assault,2021,51,98,0,47
D13,Assault,2021,34,55,0,21
D13,Assault,2021,32,51,0,19
D13,Other,2021,5,13,0,8
D13,Other,2021,5,8,0,3
D13,Other,2021,2,5,0,3
D13,Other,2021,11,18,0,7
D13,Other,2021,3,4,0,1
D13,Other,2021,6,6,1,0
D13,Other,2021,3,11,0,8
D13,Other,2021,1,2,0,1
D13,Other,2021,16,23,0,7
D13,Other,2021,16,20,0,4
D13,Other,2021,6,6,1,0
D13,Robbery-Other,2021,8,11,0,3
D13,Robbery-Other,2021,0,2,0,2
D13,Robbery-Other,2021,1,1,1,0
D13,Robbery-Other,2021,0,2,0,2
D13,Robbery-Other,2021,0,1,0,1
D13,Robbery-Other,2021,0,1,0,1
D13,Robbery-Other,2021,0,3,0,3
D13,Robbery-Other,2021,2,11,0,9
D13,Robbery-Other,2021,1,2,0,1
D12,Auto Theft,2021,0,26,0,26
D12,Auto Theft,2021,3,23,0,20
D12,Other,2021,4,4,1,0
D12,Auto Theft,2021,1,42,0,41
D12,Auto Theft,2021,2,16,0,14
D12,Other,2021,38,46,0,8
D12,Auto Theft,2021,3,60,0,57
D12,Other,2021,60,71,0,11
D13,Auto Theft,2021,1,3,0,2
D12,Auto Theft,2021,0,10,0,10
D12,Other,2021,1,1,1,0
D13,Auto Theft,2021,3,22,0,19
D12,Break & Enter-Apartment,2021,1,3,0,2
D12,Other,2021,17,20,0,3
D13,Auto Theft,2021,1,22,0,21
D12,Break & Enter-Apartment,2021,1,7,0,6
D12,Other,2021,30,35,0,5
D13,Auto Theft,2021,1,19,0,18
D11,Other,2021,1,1,1,0
D12,Break & Enter-Apartment,2021,1,1,1,0
D12,Other,2021,13,20,0,7
D13,Auto Theft,2021,0,39,0,39
D11,Other,2021,8,9,0,1
D12,Other,2021,33,41,0,8
D13,Auto Theft,2021,1,34,0,33
D12,Break & Enter-Apartment,2021,4,6,0,2
D11,Other,2021,3,3,1,0
D12,Other,2021,23,25,0,2
D13,Auto Theft,2021,0,8,0,8
D12,Break & Enter-Apartment,2021,0,2,0,2
D11,Other,2021,14,15,0,1
D12,Other,2021,12,15,0,3
D13,Auto Theft,2021,2,30,0,28
D12,Break & Enter-Apartment,2021,1,5,0,4
D11,Other,2021,1,1,1,0
D12,Other,2021,59,72,0,13
D13,Auto Theft,2021,2,13,0,11
D12,Break & Enter-Apartment,2021,0,1,0,1
D11,Other,2021,3,3,1,0
D12,Other,2021,17,22,0,5
D13,Auto Theft,2021,1,32,0,31
D11,Other,2021,3,3,1,0
D12,Other,2021,82,98,0,16
D13,Break & Enter-Apartment,2021,4,12,0,8
D12,Other,2021,10,16,0,6
D13,Break & Enter-Apartment,2021,1,2,0,1
D12,Other Criminal Violations - Offensive Weapons,2021,4,4,1,0
D13,Break & Enter-Apartment,2021,0,1,0,1
D12,Other Criminal Violations - Offensive Weapons,2021,11,17,0,6
D13,Break & Enter-Apartment,2021,4,7,0,3
D12,Other Criminal Violations - Offensive Weapons,2021,3,6,0,3
D13,Break & Enter-Apartment,2021,0,2,0,2
D12,Other Criminal Violations - Offensive Weapons,2021,3,5,0,2
D13,Break & Enter-Apartment,2021,0,9,0,9
D12,Other Criminal Violations - Offensive Weapons,2021,1,1,1,0
D13,Break & Enter-Apartment,2021,3,8,0,5
D12,Other Criminal Violations - Offensive Weapons,2021,4,8,0,4
D13,Break & Enter-Apartment,2021,1,2,0,1
D12,Other Criminal Violations - Offensive Weapons,2021,4,5,0,1
D13,Break & Enter-Apartment,2021,6,8,0,2
D12,Other Criminal Violations - Offensive Weapons,2021,5,10,0,5
D13,Break & Enter-Apartment,2021,2,4,0,2
D12,Other Criminal Violations - Offensive Weapons,2021,2,2,1,0
D13,Break & Enter-Apartment,2021,2,9,0,7
D12,Other Criminal Violations - Offensive Weapons,2021,13,15,0,2
D13,Break & Enter-Commercial,2021,8,17,0,9
D12,Other Criminal Violations - Offensive Weapons,2021,1,3,0,2
D13,Break & Enter-Commercial,2021,4,4,1,0
D12,Other,2021,2,2,1,0
D13,Break & Enter-Commercial,2021,0,2,0,2
D12,Other,2021,2,2,1,0
D13,Break & Enter-Commercial,2021,6,14,0,8
D12,Other,2021,1,1,1,0
D11,Other,2021,27,31,0,4
D13,Break & Enter-Commercial,2021,1,3,0,2
D12,Other,2021,0,1,0,1
D12,Break & Enter-Apartment,2021,3,9,0,6
D11,Other,2021,30,37,0,7
D13,Break & Enter-Commercial,2021,0,1,0,1
D12,Other,2021,2,3,0,1
D11,Other,2021,48,52,0,4
D13,Break & Enter-Commercial,2021,2,3,0,1
D12,Other,2021,1,1,1,0
D12,Other,2021,0,1,0,1
D12,Other,2021,3,4,0,1
D12,Other,2021,1,1,1,0
D12,Other,2021,2,2,1,0
D12,Other,2021,1,1,1,0
D13,Break & Enter-Commercial,2021,1,2,0,1
D13,Break & Enter-Commercial,2021,3,8,0,5
D13,Break & Enter-Commercial,2021,5,15,0,10
D13,Break & Enter-Commercial,2021,12,19,0,7
D13,Break & Enter-House,2021,1,5,0,4
D13,Break & Enter-House,2021,0,4,0,4
D13,Break & Enter-House,2021,1,1,1,0
D13,Break & Enter-House,2021,0,5,0,5
D13,Break & Enter-House,2021,2,6,0,4
D12,Break & Enter-Apartment,2021,1,1,1,0
D12,Break & Enter-Apartment,2021,5,15,0,10
D12,Break & Enter-Apartment,2021,0,2,0,2
D12,Break & Enter-Commercial,2021,0,3,0,3
D12,Break & Enter-Commercial,2021,3,13,0,10
D12,Break & Enter-Commercial,2021,3,4,0,1
D12,Break & Enter-Commercial,2021,6,16,0,10
D12,Break & Enter-Commercial,2021,3,3,1,0
D12,Break & Enter-Commercial,2021,0,1,0,1
D12,Break & Enter-Commercial,2021,1,9,0,8
D12,Break & Enter-Commercial,2021,0,3,0,3
D12,Break & Enter-Commercial,2021,4,13,0,9
D12,Break & Enter-Commercial,2021,0,2,0,2
D12,Break & Enter-House,2021,1,3,0,2
D12,Break & Enter-House,2021,1,3,0,2
D12,Break & Enter-House,2021,0,2,0,2
D12,Break & Enter-House,2021,2,8,0,6
D12,Break & Enter-House,2021,2,4,0,2
D12,Break & Enter-House,2021,2,4,0,2
D12,Break & Enter-House,2021,3,10,0,7
D12,Break & Enter-House,2021,0,1,0,1
D12,Break & Enter-House,2021,0,4,0,4
D12,Break & Enter-House,2021,1,2,0,1
D11,Other,2021,2,2,1,0
D11,Other,2021,58,66,0,8
D11,Other,2021,93,106,0,13
D11,Other,2021,6,8,0,2
D11,Other,2021,18,22,0,4
D11,Other,2021,17,17,1,0
D11,Other,2021,6,7,0,1
D11,Other,2021,97,118,0,21
D11,Other,2021,18,21,0,3
D11,Other,2021,9,12,0,3
D11,Other,2021,71,77,0,6
D11,Other Criminal Violations - Offensive Weapons,2021,1,1,1,0
D11,Other Criminal Violations - Offensive Weapons,2021,1,1,1,0
D11,Other Criminal Violations - Offensive Weapons,2021,8,10,0,2
D11,Other Criminal Violations - Offensive Weapons,2021,3,4,0,1
D11,Other Criminal Violations - Offensive Weapons,2021,7,8,0,1
D11,Other Criminal Violations - Offensive Weapons,2021,8,9,0,1
D11,Other Criminal Violations - Offensive Weapons,2021,2,2,1,0
D11,Other Criminal Violations - Offensive Weapons,2021,9,10,0,1
D11,Other Criminal Violations - Offensive Weapons,2021,3,3,1,0
D11,Other Criminal Violations - Offensive Weapons,2021,3,3,1,0
D11,Other Criminal Violations - Offensive Weapons,2021,6,6,1,0
D11,Other,2021,0,1,0,1
D12,Other,2021,2,2,1,0
D12,Other,2021,8,8,1,0
D12,Other,2021,6,6,1,0
D12,Break & Enter-Other,2021,0,1,0,1
D12,Break & Enter-Other,2021,0,2,0,2
D12,Break & Enter-Other,2021,0,1,0,1
D12,Break & Enter-Other,2021,0,3,0,3
D12,Break & Enter-Other,2021,2,3,0,1
D12,Break & Enter-Other,2021,0,1,0,1
D12,Break & Enter-Other,2021,1,6,0,5
D12,Break & Enter-Other,2021,1,2,0,1
D12,Break & Enter-Other,2021,0,4,0,4
D12,Fraud,2021,0,23,0,23
D12,Fraud,2021,1,59,0,58
D12,Fraud,2021,1,19,0,18
D12,Fraud,2021,2,26,0,24
D12,Fraud,2021,1,24,0,23
D12,Fraud,2021,2,33,0,31
D12,Fraud,2021,0,34,0,34
D12,Fraud,2021,2,68,0,66
D12,Fraud,2021,0,27,0,27
D12,Fraud,2021,2,53,0,51
D12,Fraud,2021,2,10,0,8
D12,Other,2021,13,32,0,19
D12,Other,2021,21,78,0,57
D12,Other,2021,2,20,0,18
D12,Other,2021,13,42,0,29
D12,Other,2021,9,25,0,16
D12,Other,2021,18,56,0,38
D12,Other,2021,1,1,1,0
D12,Other,2021,2,16,0,14
D12,Other,2021,20,85,0,65
D12,Other,2021,9,26,0,17
D12,Other,2021,28,107,0,79
D12,Other,2021,15,23,0,8
D12,Theft Over $5000,2021,1,5,0,4
D12,Theft Over $5000,2021,0,1,0,1
D12,Theft Over $5000,2021,0,1,0,1
D12,Theft Over $5000,2021,0,3,0,3
D12,Theft Over $5000,2021,0,3,0,3
D12,Theft Over $5000,2021,1,1,1,0
D12,Theft Over $5000,2021,0,4,0,4
D12,Theft Over $5000,2021,2,5,0,3
D12,Theft Over $5000,2021,1,1,1,0
D12,Theft Under $5000,2021,9,77,0,68
D12,Theft Under $5000,2021,27,223,0,196
D12,Theft Under $5000,2021,7,76,0,69
D12,Theft Under $5000,2021,8,89,0,81
D12,Theft Under $5000,2021,0,32,0,32
D12,Theft Under $5000,2021,8,66,0,58
D12,Theft Under $5000,2021,0,2,0,2
D12,Theft Under $5000,2021,29,294,0,265
D12,Theft Under $5000,2021,10,126,0,116
D22,Break & Enter-House,2021,2,4,0,2
D22,Break & Enter-House,2021,0,2,0,2
D22,Break & Enter-House,2021,0,11,0,11
D22,Break & Enter-House,2021,1,1,1,0
D22,Break & Enter-House,2021,1,3,0,2
D22,Break & Enter-House,2021,0,1,0,1
D22,Break & Enter-House,2021,1,5,0,4
D22,Break & Enter-House,2021,2,4,0,2
D22,Break & Enter-House,2021,0,6,0,6
D22,Break & Enter-House,2021,1,8,0,7
D22,Break & Enter-Other,2021,0,4,0,4
D22,Break & Enter-Other,2021,0,2,0,2
D22,Break & Enter-Other,2021,0,4,0,4
D22,Break & Enter-Other,2021,0,2,0,2
D22,Break & Enter-Other,2021,0,1,0,1
D22,Break & Enter-Other,2021,0,1,0,1
D22,Break & Enter-Other,2021,0,1,0,1
D22,Break & Enter-Other,2021,0,1,0,1
D22,Break & Enter-Other,2021,1,2,0,1
D22,Fraud,2021,4,36,0,32
D22,Fraud,2021,1,23,0,22
D22,Fraud,2021,1,35,0,34
D22,Fraud,2021,7,164,0,157
D22,Fraud,2021,3,29,0,26
D22,Fraud,2021,4,81,0,77
D22,Fraud,2021,5,69,0,64
D22,Fraud,2021,1,15,0,14
D22,Fraud,2021,1,28,0,27
D22,Fraud,2021,1,19,0,18
D22,Fraud,2021,3,58,0,55
D22,Fraud,2021,0,2,0,2
D22,Fraud,2021,10,42,0,32
D22,Fraud,2021,1,34,0,33
D22,Fraud,2021,11,89,0,78
D22,Other,2021,7,42,0,35
D22,Other,2021,5,22,0,17
D22,Other,2021,4,35,0,31
D22,Other,2021,31,159,0,128
D22,Other,2021,10,32,0,22
D22,Other,2021,0,1,0,1
D22,Other,2021,28,78,0,50
D22,Other,2021,12,79,0,67
D22,Other,2021,10,46,0,36
D22,Other,2021,19,71,0,52
D22,Other,2021,6,23,0,17
D22,Other,2021,42,122,0,80
D22,Other,2021,1,8,0,7
D22,Other,2021,18,65,0,47
D22,Other,2021,8,30,0,22
D22,Other,2021,20,64,0,44
D13,Other Criminal Violations - Offensive Weapons,2021,3,4,0,1
D13,Other Criminal Violations - Offensive Weapons,2021,4,7,0,3
D13,Other Criminal Violations - Offensive Weapons,2021,6,7,0,1
D13,Other,2021,4,5,0,1
D13,Other,2021,1,1,1,0
D14,Other,2021,6,6,1,0
D14,Other,2021,3,3,1,0
D14,Other,2021,1,1,1,0
D14,Other,2021,8,9,0,1
D14,Other,2021,13,14,0,1
D14,Other,2021,9,9,1,0
D14,Other,2021,2,2,1,0
D14,Other,2021,2,5,0,3
D14,Other,2021,1,1,1,0
D14,Other,2021,31,33,0,2
D14,Other,2021,5,6,0,1
D14,Other,2021,2,2,1,0
D14,Other,2021,9,10,0,1
D14,Other,2021,4,4,1,0
D14,Auto Theft,2021,3,18,0,15
D14,Auto Theft,2021,1,8,0,7
D14,Auto Theft,2021,1,8,0,7
D14,Auto Theft,2021,2,17,0,15
D14,Auto Theft,2021,3,19,0,16
D14,Auto Theft,2021,0,16,0,16
D14,Auto Theft,2021,0,2,0,2
D14,Auto Theft,2021,2,11,0,9
D14,Auto Theft,2021,0,14,0,14
D14,Auto Theft,2021,3,20,0,17
D14,Auto Theft,2021,0,6,0,6
D14,Auto Theft,2021,0,22,0,22
D14,Auto Theft,2021,2,13,0,11
D14,Break & Enter-Apartment,2021,4,11,0,7
D14,Break & Enter-Apartment,2021,0,4,0,4
D14,Break & Enter-Apartment,2021,2,5,0,3
D14,Break & Enter-Apartment,2021,6,20,0,14
D14,Break & Enter-Apartment,2021,2,19,0,17
D14,Break & Enter-Apartment,2021,3,12,0,9
D14,Break & Enter-Apartment,2021,0,7,0,7
D14,Break & Enter-Apartment,2021,6,14,0,8
D14,Break & Enter-Apartment,2021,15,27,0,12
D14,Break & Enter-Apartment,2021,3,9,0,6
D14,Break & Enter-Apartment,2021,1,4,0,3
D14,Break & Enter-Apartment,2021,4,24,0,20
D14,Break & Enter-Apartment,2021,8,23,0,15
D14,Break & Enter-Commercial,2021,0,10,0,10
D14,Break & Enter-Commercial,2021,1,11,0,10
D14,Break & Enter-Commercial,2021,0,3,0,3
D14,Break & Enter-Commercial,2021,5,16,0,11
D14,Break & Enter-Commercial,2021,2,10,0,8
D14,Other,2021,6,8,0,2
D14,Break & Enter-Commercial,2021,4,20,0,16
D22,Other,2021,1,1,1,0
D13,Robbery-Other,2021,3,5,0,2
D14,Break & Enter-Commercial,2021,5,8,0,3
D14,Break & Enter-Commercial,2021,3,11,0,8
D14,Break & Enter-Commercial,2021,5,22,0,17
D14,Break & Enter-Commercial,2021,10,28,0,18
D14,Break & Enter-Commercial,2021,0,5,0,5
D14,Break & Enter-Commercial,2021,7,36,0,29
D14,Break & Enter-Commercial,2021,4,24,0,20
D14,Break & Enter-House,2021,4,12,0,8
D14,Break & Enter-House,2021,1,1,1,0
D14,Break & Enter-House,2021,1,4,0,3
D14,Break & Enter-House,2021,0,2,0,2
D14,Break & Enter-House,2021,0,4,0,4
D14,Break & Enter-House,2021,1,4,0,3
D14,Break & Enter-House,2021,3,4,0,1
D14,Break & Enter-House,2021,1,5,0,4
D14,Break & Enter-House,2021,1,7,0,6
D14,Break & Enter-House,2021,1,10,0,9
D14,Break & Enter-House,2021,1,3,0,2
D14,Break & Enter-House,2021,1,4,0,3
D14,Break & Enter-Other,2021,2,6,0,4
D14,Break & Enter-Other,2021,1,3,0,2
D14,Break & Enter-Other,2021,1,1,1,0
D14,Break & Enter-Other,2021,1,4,0,3
D14,Break & Enter-Other,2021,0,1,0,1
D14,Break & Enter-Other,2021,0,1,0,1
D14,Break & Enter-Other,2021,1,6,0,5
D14,Break & Enter-Other,2021,1,3,0,2
D14,Break & Enter-Other,2021,4,10,0,6
D14,Break & Enter-Other,2021,3,5,0,2
D14,Break & Enter-Other,2021,3,4,0,1
D14,Break & Enter-Other,2021,1,5,0,4
D14,Break & Enter-Other,2021,1,1,1,0
D14,Fraud,2021,4,55,0,51
D14,Fraud,2021,3,44,0,41
D14,Fraud,2021,0,10,0,10
D14,Fraud,2021,15,87,0,72
D14,Fraud,2021,4,80,0,76
D14,Fraud,2021,6,54,0,48
D14,Fraud,2021,7,35,0,28
D14,Fraud,2021,7,43,0,36
D14,Fraud,2021,0,1,0,1
D14,Fraud,2021,4,79,0,75
D14,Fraud,2021,11,62,0,51
D14,Fraud,2021,4,31,0,27
D14,Fraud,2021,17,111,0,94
D14,Fraud,2021,4,62,0,58
D14,Other,2021,20,99,0,79
D14,Other,2021,27,114,0,87
D14,Other,2021,3,31,0,28
D13,Sexual Violation,2021,3,7,0,4
D22,Other,2021,3,4,0,1
D14,Other,2021,1,1,1,0
D14,Other,2021,9,11,0,2
D14,Other,2021,33,36,0,3
D14,Other,2021,8,10,0,2
D14,Other,2021,5,5,1,0
D14,Other,2021,20,25,0,5
D14,Other,2021,12,16,0,4
D14,Other,2021,37,50,0,13
D14,Other,2021,28,43,0,15
D14,Other,2021,12,14,0,2
D14,Other,2021,70,81,0,11
D14,Other,2021,52,64,0,12
D14,Other,2021,79,93,0,14
D14,Other,2021,102,110,0,8
D14,Other,2021,2,3,0,1
D14,Other,2021,20,26,0,6
D14,Other,2021,176,200,0,24
D14,Other,2021,1,1,1,0
D14,Other,2021,52,63,0,11
D14,Other,2021,25,30,0,5
D14,Other,2021,44,50,0,6
D14,Other,2021,53,67,0,14
D14,Assault,2021,51,102,0,51
D14,Other,2021,40,111,0,71
D14,Other Criminal Violations - Offensive Weapons,2021,6,10,0,4
D14,Other Criminal Violations - Offensive Weapons,2021,6,6,1,0
D14,Other Criminal Violations - Offensive Weapons,2021,1,2,0,1
D14,Other Criminal Violations - Offensive Weapons,2021,14,17,0,3
D14,Other Criminal Violations - Offensive Weapons,2021,11,11,1,0
D14,Other Criminal Violations - Offensive Weapons,2021,13,14,0,1
D14,Other Criminal Violations - Offensive Weapons,2021,5,6,0,1
D14,Other Criminal Violations - Offensive Weapons,2021,4,4,1,0
D14,Other Criminal Violations - Offensive Weapons,2021,20,23,0,3
D14,Other Criminal Violations - Offensive Weapons,2021,8,10,0,2
D14,Other Criminal Violations - Offensive Weapons,2021,3,4,0,1
D14,Other Criminal Violations - Offensive Weapons,2021,14,16,0,2
D14,Other Criminal Violations - Offensive Weapons,2021,11,13,0,2
D14,Other,2021,1,1,1,0
D14,Other,2021,1,1,1,0
D14,Other,2021,1,1,1,0
D14,Other,2021,0,1,0,1
D14,Other,2021,0,1,0,1
D14,Other,2021,1,1,1,0
D14,Other,2021,1,2,0,1
D22,Other,2021,3,3,1,0
D22,Other,2021,1,1,1,0
D22,Other,2021,1,1,1,0
D22,Other,2021,8,13,0,5
D22,Other,2021,6,6,1,0
D22,Other,2021,5,5,1,0
D22,Other,2021,1,2,0,1
D22,Other,2021,11,15,0,4
D13,Sexual Violation,2021,1,5,0,4
D14,Attempt Murder,2021,1,1,1,0
D22,Other,2021,2,2,1,0
D13,Sexual Violation,2021,1,1,1,0
D14,Other,2021,6,21,0,15
D14,Other,2021,20,62,0,42
D22,Other,2021,1,1,1,0
D13,Sexual Violation,2021,5,11,0,6
D14,Other,2021,4,17,0,13
D14,Other,2021,51,164,0,113
D22,Other,2021,1,1,1,0
D13,Sexual Violation,2021,1,1,1,0
D14,Other,2021,2,3,0,1
D14,Other,2021,15,24,0,9
D14,Other,2021,13,31,0,18
D14,Other,2021,11,26,0,15
D14,Other,2021,3,17,0,14
D14,Other,2021,0,1,0,1
D14,Other,2021,14,19,0,5
D14,Other,2021,14,22,0,8
D14,Other,2021,8,22,0,14
D14,Other,2021,2,2,1,0
D14,Other,2021,2,19,0,17
D14,Other,2021,10,18,0,8
D14,Robbery-Financial,2021,1,1,1,0
D14,Robbery-Other,2021,3,10,0,7
D14,Robbery-Other,2021,13,17,0,4
D14,Robbery-Other,2021,0,2,0,2
D14,Robbery-Other,2021,5,6,0,1
D14,Robbery-Other,2021,1,7,0,6
D14,Robbery-Other,2021,4,12,0,8
D14,Robbery-Other,2021,6,7,0,1
D14,Robbery-Other,2021,3,7,0,4
D14,Robbery-Other,2021,11,15,0,4
D14,Robbery-Other,2021,6,14,0,8
D14,Robbery-Other,2021,2,6,0,4
D14,Robbery-Other,2021,2,9,0,7
D14,Robbery-Other,2021,5,10,0,5
D14,Sexual Violation,2021,6,11,0,5
D14,Sexual Violation,2021,7,12,0,5
D14,Sexual Violation,2021,4,5,0,1
D14,Sexual Violation,2021,8,21,0,13
D14,Sexual Violation,2021,4,22,0,18
D14,Sexual Violation,2021,8,27,0,19
D14,Sexual Violation,2021,10,20,0,10
D14,Sexual Violation,2021,1,1,1,0
D14,Sexual Violation,2021,9,16,0,7
D14,Sexual Violation,2021,9,20,0,11
D14,Sexual Violation,2021,20,31,0,11
D14,Sexual Violation,2021,16,24,0,8
D14,Sexual Violation,2021,5,15,0,10
D14,Sexual Violation,2021,5,21,0,16
D14,Other,2021,4,5,0,1
D14,Other,2021,5,6,0,1
D14,Other,2021,3,3,1,0
D14,Other,2021,29,32,0,3
D14,Other,2021,15,18,0,3
D14,Other,2021,12,12,1,0
D13,Sexual Violation,2021,1,2,0,1
D13,Sexual Violation,2021,1,4,0,3
D13,Sexual Violation,2021,1,2,0,1
D13,Sexual Violation,2021,1,1,1,0
D13,Sexual Violation,2021,0,2,0,2
D13,Sexual Violation,2021,5,16,0,11
D13,Sexual Violation,2021,4,11,0,7
D13,Sexual Violation,2021,4,8,0,4
D13,Other,2021,0,1,0,1
D13,Other,2021,11,12,0,1
D13,Other,2021,8,8,1,0
D13,Other,2021,1,1,1,0
D13,Other,2021,19,19,1,0
D13,Other,2021,1,1,1,0
D13,Other,2021,3,3,1,0
D13,Other,2021,1,1,1,0
D13,Other,2021,8,8,1,0
D14,Other,2021,13,73,0,60
D14,Other,2021,1,5,0,4
D14,Other,2021,12,70,0,58
D14,Other,2021,45,171,0,126
D14,Other,2021,25,96,0,71
D14,Other,2021,13,59,0,46
D13,Other,2021,8,9,0,1
D14,Other,2021,20,103,0,83
D22,Auto Theft,2021,4,31,0,27
D22,Auto Theft,2021,2,26,0,24
D22,Auto Theft,2021,5,67,0,62
D22,Auto Theft,2021,9,118,0,109
D22,Auto Theft,2021,3,17,0,14
D22,Auto Theft,2021,4,27,0,23
D22,Auto Theft,2021,1,61,0,60
D22,Auto Theft,2021,0,36,0,36
D22,Auto Theft,2021,2,41,0,39
D22,Auto Theft,2021,0,22,0,22
D22,Auto Theft,2021,1,34,0,33
D22,Auto Theft,2021,0,2,0,2
D22,Auto Theft,2021,1,16,0,15
D22,Auto Theft,2021,0,23,0,23
D22,Auto Theft,2021,2,71,0,69
D14,Other,2021,47,130,0,83
D22,Break & Enter-Apartment,2021,1,3,0,2
D14,Theft Over $5000,2021,1,4,0,3
D22,Break & Enter-Apartment,2021,0,3,0,3
D14,Theft Over $5000,2021,0,2,0,2
D22,Break & Enter-Apartment,2021,3,12,0,9
D14,Theft Over $5000,2021,0,1,0,1
D22,Break & Enter-Apartment,2021,2,7,0,5
D14,Theft Over $5000,2021,2,18,0,16
D14,Theft Over $5000,2021,0,6,0,6
D13,Other,2021,30,31,0,1
D22,Break & Enter-Apartment,2021,6,22,0,16
D14,Theft Over $5000,2021,2,8,0,6
D13,Other,2021,4,6,0,2
D22,Break & Enter-Apartment,2021,0,8,0,8
D14,Theft Over $5000,2021,1,5,0,4
D13,Other,2021,3,4,0,1
D22,Break & Enter-Apartment,2021,1,7,0,6
D14,Theft Over $5000,2021,0,6,0,6
D13,Other,2021,35,46,0,11
D22,Break & Enter-Apartment,2021,1,2,0,1
D14,Theft Over $5000,2021,1,8,0,7
D13,Other,2021,7,8,0,1
D22,Break & Enter-Apartment,2021,3,7,0,4
D14,Theft Over $5000,2021,1,4,0,3
D13,Other,2021,20,24,0,4
D22,Break & Enter-Apartment,2021,3,8,0,5
D14,Theft Over $5000,2021,2,10,0,8
D13,Other,2021,24,30,0,6
D22,Break & Enter-Apartment,2021,3,6,0,3
D14,Theft Over $5000,2021,1,6,0,5
D13,Other,2021,6,8,0,2
D22,Break & Enter-Commercial,2021,2,8,0,6
D14,Theft Under $5000,2021,53,300,0,247
D13,Other,2021,5,6,0,1
D22,Break & Enter-Commercial,2021,1,5,0,4
D14,Theft Under $5000,2021,5,135,0,130
D13,Other,2021,7,8,0,1
D22,Break & Enter-Commercial,2021,1,5,0,4
D14,Theft Under $5000,2021,4,42,0,38
D13,Other,2021,43,48,0,5
D22,Break & Enter-Commercial,2021,14,60,0,46
D14,Theft Under $5000,2021,31,240,0,209
D13,Other,2021,11,12,0,1
D22,Break & Enter-Commercial,2021,0,1,0,1
D14,Theft Under $5000,2021,61,470,0,409
D13,Other,2021,1,1,1,0
D22,Break & Enter-Commercial,2021,0,2,0,2
D14,Theft Under $5000,2021,22,201,0,179
D13,Other,2021,79,86,0,7
D22,Break & Enter-Commercial,2021,6,23,0,17
D14,Theft Under $5000,2021,22,126,0,104
D13,Other,2021,45,55,0,10
D22,Break & Enter-Commercial,2021,2,7,0,5
D14,Theft Under $5000,2021,1,12,0,11
D14,Theft Under $5000,2021,12,190,0,178
D14,Theft Under $5000,2021,124,619,0,495
D14,Theft Under $5000,2021,73,367,0,294
D14,Theft Under $5000,2021,8,149,0,141
D14,Theft Under $5000,2021,39,409,0,370
D14,Theft Under $5000,2021,25,238,0,213
D14,Assault,2021,57,109,0,52
D14,Assault,2021,47,96,0,49
D14,Assault,2021,16,36,0,20
D14,Assault,2021,84,142,0,58
D14,Assault,2021,92,140,0,48
D14,Assault,2021,109,192,0,83
D14,Assault,2021,44,71,0,27
D14,Assault,2021,1,2,0,1
D14,Assault,2021,43,72,0,29
D14,Assault,2021,138,235,0,97
D14,Assault,2021,55,116,0,61
D14,Assault,2021,28,51,0,23
D14,Assault,2021,61,161,0,100
D22,Break & Enter-Commercial,2021,0,4,0,4
D22,Break & Enter-Commercial,2021,0,6,0,6
D22,Break & Enter-Commercial,2021,1,12,0,11
D22,Break & Enter-Commercial,2021,1,6,0,5
D22,Break & Enter-Commercial,2021,1,4,0,3
D22,Break & Enter-Commercial,2021,3,15,0,12
D22,Break & Enter-House,2021,1,5,0,4
D22,Break & Enter-House,2021,0,8,0,8
D22,Break & Enter-House,2021,1,6,0,5
D22,Break & Enter-House,2021,1,2,0,1
D13,Other,2021,19,27,0,8
D13,Other Criminal Violations - Offensive Weapons,2021,3,3,1,0
D13,Other Criminal Violations - Offensive Weapons,2021,3,4,0,1
D13,Other Criminal Violations - Offensive Weapons,2021,1,2,0,1
D13,Other Criminal Violations - Offensive Weapons,2021,2,2,1,0
D13,Other Criminal Violations - Offensive Weapons,2021,0,1,0,1
D13,Other Criminal Violations - Offensive Weapons,2021,2,3,0,1
D13,Other Criminal Violations - Offensive Weapons,2021,2,3,0,1
D13,Other Criminal Violations - Offensive Weapons,2021,1,2,0,1
D13,Other Criminal Violations - Offensive Weapons,2021,1,1,1,0
D13,Other Criminal Violations - Offensive Weapons,2021,4,4,1,0
D23,Assault,2021,34,56,0,22
D23,Assault,2021,142,226,0,84
D23,Assault,2021,39,52,0,13
D23,Attempt Murder,2021,4,4,1,0
D23,Fraud,2021,0,5,0,5
D23,Attempt Murder,2021,0,1,0,1
D23,Attempt Murder,2021,1,1,1,0
D23,Fraud,2021,0,48,0,48
D22,Other,2021,14,15,0,1
D23,Attempt Murder,2021,1,1,1,0
D23,Other,2021,9,13,0,4
D23,Fraud,2021,1,25,0,24
D23,Attempt Murder,2021,1,1,1,0
D22,Other,2021,2,2,1,0
D22,Other,2021,13,29,0,16
D23,Other,2021,2,3,0,1
D23,Fraud,2021,3,52,0,49
D23,Other,2021,3,3,1,0
D23,Other,2021,4,7,0,3
D22,Other,2021,5,5,1,0
D22,Other,2021,4,6,0,2
D23,Other,2021,39,51,0,12
D23,Fraud,2021,4,107,0,103
D23,Other,2021,8,17,0,9
D23,Other,2021,11,12,0,1
D22,Other,2021,3,3,1,0
D22,Other,2021,4,8,0,4
D23,Other,2021,0,1,0,1
D23,Fraud,2021,1,24,0,23
D23,Other,2021,9,15,0,6
D23,Other,2021,1,1,1,0
D22,Other,2021,19,22,0,3
D22,Other,2021,6,10,0,4
D23,Other,2021,105,127,0,22
D23,Fraud,2021,0,1,0,1
D23,Other,2021,14,30,0,16
D23,Other,2021,1,1,1,0
D22,Other,2021,1,1,1,0
D22,Other,2021,2,7,0,5
D23,Other,2021,18,23,0,5
D23,Fraud,2021,2,34,0,32
D23,Other,2021,29,48,0,19
D23,Other,2021,2,2,1,0
D22,Other,2021,8,8,1,0
D22,Other,2021,4,9,0,5
D23,Other,2021,20,24,0,4
D23,Fraud,2021,20,188,0,168
D23,Other,2021,6,12,0,6
D23,Other,2021,22,24,0,2
D22,Other,2021,2,2,1,0
D22,Other,2021,23,24,0,1
D22,Other,2021,17,21,0,4
D22,Other,2021,12,12,1,0
D22,Other,2021,14,23,0,9
D22,Other,2021,50,67,0,17
D22,Other,2021,20,21,0,1
D22,Other,2021,37,47,0,10
D22,Other,2021,1,1,1,0
D22,Other,2021,36,41,0,5
D22,Other,2021,14,20,0,6
D22,Other,2021,36,43,0,7
D22,Other,2021,16,18,0,2
D22,Other,2021,79,108,0,29
D22,Other,2021,12,13,0,1
D22,Other,2021,48,59,0,11
D22,Other,2021,9,12,0,3
D22,Other,2021,45,56,0,11
D22,Other Criminal Violations - Offensive Weapons,2021,3,3,1,0
D22,Other Criminal Violations - Offensive Weapons,2021,1,2,0,1
D22,Other Criminal Violations - Offensive Weapons,2021,0,1,0,1
D22,Other Criminal Violations - Offensive Weapons,2021,6,12,0,6
D22,Other Criminal Violations - Offensive Weapons,2021,7,7,1,0
D22,Other Criminal Violations - Offensive Weapons,2021,5,6,0,1
D22,Other Criminal Violations - Offensive Weapons,2021,2,2,1,0
D22,Other Criminal Violations - Offensive Weapons,2021,1,2,0,1
D22,Other Criminal Violations - Offensive Weapons,2021,3,3,1,0
D22,Other Criminal Violations - Offensive Weapons,2021,24,28,0,4
D22,Other Criminal Violations - Offensive Weapons,2021,1,1,1,0
D22,Other Criminal Violations - Offensive Weapons,2021,4,6,0,2
D22,Other Criminal Violations - Offensive Weapons,2021,1,1,1,0
D22,Other Criminal Violations - Offensive Weapons,2021,6,6,1,0
D22,Other,2021,1,1,1,0
D22,Other,2021,0,3,0,3
D22,Other,2021,1,1,1,0
D22,Other,2021,1,2,0,1
D22,Other,2021,1,1,1,0
D22,Other,2021,1,1,1,0
D22,Other,2021,1,1,1,0
D22,Other,2021,0,2,0,2
D22,Other,2021,2,4,0,2
D23,Other,2021,1,1,1,0
D23,Other,2021,1,1,1,0
D23,Fraud,2021,4,47,0,43
D23,Other,2021,2,2,1,0
D23,Other,2021,8,9,0,1
D23,Other,2021,7,11,0,4
D23,Other,2021,0,4,0,4
D23,Other,2021,96,116,0,20
D23,Auto Theft,2021,0,5,0,5
D22,Other,2021,2,3,0,1
D23,Auto Theft,2021,1,51,0,50
D23,Other,2021,38,62,0,24
D22,Other,2021,13,25,0,12
D23,Other,2021,9,36,0,27
D23,Auto Theft,2021,0,20,0,20
D23,Other,2021,21,24,0,3
D23,Other,2021,6,12,0,6
D22,Other,2021,0,1,0,1
D23,Other,2021,4,25,0,21
D23,Auto Theft,2021,0,2,0,2
D23,Other Criminal Violations - Offensive Weapons,2021,3,3,1,0
D23,Robbery-Other,2021,3,6,0,3
D22,Other,2021,7,12,0,5
D23,Other,2021,0,1,0,1
D23,Auto Theft,2021,2,82,0,80
D23,Other Criminal Violations - Offensive Weapons,2021,4,4,1,0
D23,Robbery-Other,2021,0,1,0,1
D22,Other,2021,4,7,0,3
D23,Other,2021,15,60,0,45
D23,Auto Theft,2021,1,78,0,77
D23,Other Criminal Violations - Offensive Weapons,2021,5,8,0,3
D23,Robbery-Other,2021,6,8,0,2
D22,Other,2021,10,14,0,4
D23,Other,2021,19,84,0,65
D23,Auto Theft,2021,0,2,0,2
D23,Other Criminal Violations - Offensive Weapons,2021,9,10,0,1
D23,Robbery-Other,2021,10,40,0,30
D22,Robbery-Financial,2021,1,1,1,0
D23,Other,2021,0,2,0,2
D23,Auto Theft,2021,0,1,0,1
D23,Other Criminal Violations - Offensive Weapons,2021,1,1,1,0
D23,Robbery-Other,2021,1,1,1,0
D22,Robbery-Financial,2021,1,1,1,0
D23,Other,2021,7,28,0,21
D23,Auto Theft,2021,0,40,0,40
D23,Other Criminal Violations - Offensive Weapons,2021,12,16,0,4
D23,Robbery-Other,2021,2,9,0,7
D23,Robbery-Other,2021,1,6,0,5
D23,Robbery-Other,2021,21,40,0,19
D23,Robbery-Other,2021,2,4,0,2
D23,Sexual Violation,2021,1,1,1,0
D23,Sexual Violation,2021,5,7,0,2
D23,Sexual Violation,2021,2,4,0,2
D23,Sexual Violation,2021,16,18,0,2
D23,Sexual Violation,2021,7,19,0,12
D23,Sexual Violation,2021,8,16,0,8
D23,Sexual Violation,2021,3,6,0,3
D23,Sexual Violation,2021,27,38,0,11
D23,Sexual Violation,2021,11,17,0,6
D23,Other,2021,2,2,1,0
D23,Other,2021,8,10,0,2
D23,Other,2021,3,3,1,0
D23,Other,2021,3,3,1,0
D23,Other,2021,2,2,1,0
D23,Other,2021,8,9,0,1
D23,Other,2021,15,16,0,1
D23,Other,2021,1,1,1,0
D23,Other,2021,5,5,1,0
D23,Other,2021,2,2,1,0
D23,Other,2021,11,11,1,0
D23,Other,2021,38,42,0,4
D23,Other,2021,4,4,1,0
D23,Other,2021,1,1,1,0
D23,Other,2021,8,15,0,7
D31,Break & Enter-Commercial,2021,7,15,0,8
D23,Other Criminal Violations - Offensive Weapons,2021,2,2,1,0
D23,Other,2021,1,1,1,0
D23,Other,2021,1,2,0,1
D23,Other,2021,0,1,0,1
D23,Other,2021,2,3,0,1
D23,Other,2021,1,1,1,0
D31,Other,2021,1,3,0,2
D31,Other,2021,2,2,1,0
D31,Other,2021,6,8,0,2
D31,Other,2021,1,1,1,0
D31,Other,2021,5,5,1,0
D31,Other,2021,10,15,0,5
D31,Other,2021,0,1,0,1
D31,Other,2021,3,5,0,2
D31,Auto Theft,2021,2,66,0,64
D31,Auto Theft,2021,2,45,0,43
D31,Auto Theft,2021,2,106,0,104
D31,Auto Theft,2021,0,136,0,136
D31,Auto Theft,2021,2,62,0,60
D31,Auto Theft,2021,0,9,0,9
D31,Auto Theft,2021,11,116,0,105
D31,Auto Theft,2021,2,44,0,42
D31,Auto Theft,2021,3,128,0,125
D31,Break & Enter-Apartment,2021,3,13,0,10
D31,Break & Enter-Apartment,2021,1,4,0,3
D31,Break & Enter-Apartment,2021,3,14,0,11
D31,Break & Enter-Apartment,2021,1,1,1,0
D31,Break & Enter-Apartment,2021,0,4,0,4
D31,Break & Enter-Apartment,2021,0,2,0,2
D31,Break & Enter-Apartment,2021,2,10,0,8
D31,Break & Enter-Apartment,2021,0,3,0,3
D31,Break & Enter-Apartment,2021,8,21,0,13
D31,Break & Enter-Commercial,2021,1,3,0,2
D31,Break & Enter-Commercial,2021,0,4,0,4
D31,Break & Enter-Commercial,2021,4,32,0,28
D23,Auto Theft,2021,2,44,0,42
D22,Robbery-Financial,2021,1,2,0,1
D23,Other,2021,8,35,0,27
D23,Other,2021,50,247,0,197
D23,Other,2021,12,63,0,51
D23,Theft Over $5000,2021,1,3,0,2
D23,Theft Over $5000,2021,0,1,0,1
D23,Theft Over $5000,2021,0,5,0,5
D23,Theft Over $5000,2021,1,8,0,7
D23,Theft Over $5000,2021,0,3,0,3
D23,Theft Over $5000,2021,0,2,0,2
D23,Theft Over $5000,2021,0,2,0,2
D23,Theft Over $5000,2021,3,56,0,53
D23,Theft Over $5000,2021,1,3,0,2
D23,Theft Under $5000,2021,0,14,0,14
D23,Theft Under $5000,2021,5,83,0,78
D23,Theft Under $5000,2021,0,1,0,1
D23,Theft Under $5000,2021,1,47,0,46
D23,Theft Under $5000,2021,21,231,0,210
D23,Theft Under $5000,2021,18,243,0,225
D23,Theft Under $5000,2021,0,5,0,5
D23,Theft Under $5000,2021,0,1,0,1
D23,Theft Under $5000,2021,6,92,0,86
D23,Theft Under $5000,2021,1,67,0,66
D23,Theft Under $5000,2021,45,875,0,830
D23,Theft Under $5000,2021,4,165,0,161
D23,Assault,2021,3,5,0,2
D23,Assault,2021,40,58,0,18
D23,Assault,2021,14,24,0,10
D23,Assault,2021,51,87,0,36
D23,Assault,2021,126,192,0,66
D23,Assault,2021,1,1,1,0
D23,Assault,2021,0,1,0,1
D23,Assault,2021,29,44,0,15
D31,Break & Enter-Commercial,2021,1,21,0,20
D31,Break & Enter-Commercial,2021,0,2,0,2
D31,Break & Enter-Commercial,2021,11,29,0,18
D31,Break & Enter-Commercial,2021,8,33,0,25
D31,Break & Enter-House,2021,2,9,0,7
D23,Auto Theft,2021,5,497,0,492
D31,Break & Enter-House,2021,5,6,0,1
D31,Break & Enter-House,2021,5,10,0,5
D23,Auto Theft,2021,1,58,0,57
D31,Break & Enter-House,2021,2,7,0,5
D23,Break & Enter-Apartment,2021,0,6,0,6
D31,Break & Enter-House,2021,0,3,0,3
D23,Break & Enter-Apartment,2021,2,5,0,3
D31,Break & Enter-House,2021,5,15,0,10
D22,Robbery-Financial,2021,4,4,1,0
D23,Break & Enter-Apartment,2021,1,6,0,5
D22,Robbery-Other,2021,1,1,1,0
D31,Break & Enter-House,2021,0,2,0,2
D23,Break & Enter-Apartment,2021,0,5,0,5
D22,Robbery-Other,2021,1,4,0,3
D31,Break & Enter-House,2021,2,4,0,2
D23,Break & Enter-Apartment,2021,5,12,0,7
D22,Robbery-Other,2021,3,7,0,4
D31,Break & Enter-Other,2021,1,2,0,1
D23,Break & Enter-Apartment,2021,0,1,0,1
D22,Robbery-Other,2021,1,2,0,1
D31,Break & Enter-Other,2021,0,3,0,3
D23,Break & Enter-Apartment,2021,5,10,0,5
D22,Robbery-Other,2021,4,4,1,0
D31,Break & Enter-Other,2021,1,3,0,2
D23,Break & Enter-Apartment,2021,0,1,0,1
D22,Robbery-Other,2021,2,6,0,4
D31,Break & Enter-Other,2021,1,1,1,0
D23,Break & Enter-Commercial,2021,1,2,0,1
D22,Robbery-Other,2021,6,10,0,4
D23,Break & Enter-Commercial,2021,0,1,0,1
D22,Robbery-Other,2021,1,1,1,0
D31,Break & Enter-Other,2021,0,2,0,2
D23,Break & Enter-Commercial,2021,1,5,0,4
D22,Robbery-Other,2021,1,5,0,4
D31,Break & Enter-Other,2021,3,10,0,7
D23,Break & Enter-Commercial,2021,1,4,0,3
D22,Robbery-Other,2021,5,6,0,1
D31,Break & Enter-Other,2021,0,1,0,1
D23,Break & Enter-Commercial,2021,0,1,0,1
D22,Robbery-Other,2021,0,1,0,1
D31,Break & Enter-Other,2021,8,17,0,9
D23,Break & Enter-Commercial,2021,9,13,0,4
D22,Robbery-Other,2021,6,12,0,6
D31,Fraud,2021,3,77,0,74
D23,Break & Enter-Commercial,2021,2,3,0,1
D22,Robbery-Other,2021,0,1,0,1
D31,Fraud,2021,4,54,0,50
D23,Break & Enter-Commercial,2021,14,75,0,61
D22,Robbery-Other,2021,3,13,0,10
D31,Fraud,2021,3,90,0,87
D23,Break & Enter-Commercial,2021,6,9,0,3
D22,Sexual Violation,2021,4,9,0,5
D31,Fraud,2021,4,60,0,56
D23,Break & Enter-House,2021,1,2,0,1
D22,Sexual Violation,2021,3,5,0,2
D31,Fraud,2021,0,42,0,42
D23,Break & Enter-House,2021,3,7,0,4
D22,Sexual Violation,2021,5,7,0,2
D31,Fraud,2021,2,6,0,4
D23,Break & Enter-House,2021,0,5,0,5
D22,Sexual Violation,2021,11,21,0,10
D31,Fraud,2021,6,103,0,97
D23,Break & Enter-House,2021,0,5,0,5
D22,Sexual Violation,2021,3,3,1,0
D31,Fraud,2021,2,17,0,15
D23,Break & Enter-House,2021,1,3,0,2
D22,Sexual Violation,2021,3,13,0,10
D31,Fraud,2021,3,145,0,142
D23,Break & Enter-House,2021,0,4,0,4
D22,Sexual Violation,2021,4,9,0,5
D31,Other,2021,27,100,0,73
D23,Break & Enter-House,2021,4,12,0,8
D22,Sexual Violation,2021,0,1,0,1
D22,Sexual Violation,2021,1,4,0,3
D22,Sexual Violation,2021,3,6,0,3
D22,Sexual Violation,2021,7,13,0,6
D22,Sexual Violation,2021,5,11,0,6
D22,Sexual Violation,2021,1,4,0,3
D22,Sexual Violation,2021,3,7,0,4
D22,Other,2021,4,4,1,0
D22,Other,2021,7,8,0,1
D22,Other,2021,3,3,1,0
D22,Other,2021,24,25,0,1
D22,Other,2021,4,7,0,3
D22,Other,2021,13,14,0,1
D31,Other,2021,21,77,0,56
D23,Break & Enter-House,2021,0,8,0,8
D31,Other,2021,46,143,0,97
D23,Break & Enter-Other,2021,1,3,0,2
D23,Break & Enter-Other,2021,0,1,0,1
D31,Other,2021,24,82,0,58
D23,Break & Enter-Other,2021,2,3,0,1
D31,Other,2021,15,65,0,50
D23,Break & Enter-Other,2021,0,1,0,1
D31,Other,2021,2,13,0,11
D23,Break & Enter-Other,2021,0,2,0,2
D31,Other,2021,60,167,0,107
D23,Break & Enter-Other,2021,2,3,0,1
D31,Other,2021,4,22,0,18
D31,Other,2021,44,170,0,126
D31,Theft Over $5000,2021,0,9,0,9
D31,Theft Over $5000,2021,0,3,0,3
D31,Theft Over $5000,2021,0,7,0,7
D31,Theft Over $5000,2021,2,29,0,27
D31,Theft Over $5000,2021,1,14,0,13
D31,Theft Over $5000,2021,0,2,0,2
D31,Theft Over $5000,2021,1,19,0,18
D31,Theft Over $5000,2021,0,1,0,1
D31,Theft Over $5000,2021,1,21,0,20
D31,Theft Under $5000,2021,21,234,0,213
D22,Theft Over $5000,2021,0,4,0,4
D22,Theft Over $5000,2021,0,2,0,2
D22,Theft Over $5000,2021,0,1,0,1
D22,Theft Over $5000,2021,4,32,0,28
D22,Theft Over $5000,2021,1,3,0,2
D22,Theft Over $5000,2021,1,6,0,5
D22,Theft Over $5000,2021,2,6,0,4
D22,Theft Over $5000,2021,0,3,0,3
D22,Theft Over $5000,2021,1,3,0,2
D22,Theft Over $5000,2021,0,7,0,7
D22,Theft Over $5000,2021,0,5,0,5
D22,Theft Over $5000,2021,0,2,0,2
D22,Theft Over $5000,2021,0,7,0,7
D22,Theft Under $5000,2021,5,97,0,92
D22,Theft Under $5000,2021,2,70,0,68
D22,Theft Under $5000,2021,3,88,0,85
D22,Theft Under $5000,2021,118,660,0,542
D22,Theft Under $5000,2021,3,38,0,35
D22,Theft Under $5000,2021,19,167,0,148
D22,Theft Under $5000,2021,26,345,0,319
D22,Theft Under $5000,2021,17,135,0,118
D22,Theft Under $5000,2021,29,169,0,140
D22,Theft Under $5000,2021,7,109,0,102
D22,Theft Under $5000,2021,9,117,0,108
D22,Theft Under $5000,2021,0,12,0,12
D22,Theft Under $5000,2021,34,176,0,142
D22,Theft Under $5000,2021,7,100,0,93
D22,Theft Under $5000,2021,30,193,0,163
D22,Assault,2021,17,26,0,9
D22,Assault,2021,16,25,0,9
D22,Assault,2021,20,31,0,11
D22,Assault,2021,74,138,0,64
D22,Assault,2021,25,41,0,16
D22,Assault,2021,68,93,0,25
D22,Assault,2021,0,1,0,1
D22,Assault,2021,27,48,0,21
D22,Assault,2021,9,22,0,13
D22,Assault,2021,52,90,0,38
D22,Assault,2021,15,20,0,5
D22,Assault,2021,157,249,0,92
D22,Assault,2021,2,4,0,2
D22,Assault,2021,70,105,0,35
D22,Assault,2021,14,21,0,7
D22,Assault,2021,48,71,0,23
D22,Attempt Murder,2021,1,1,1,0
D22,Attempt Murder,2021,1,1,1,0
D22,Attempt Murder,2021,2,2,1,0
D22,Other,2021,2,4,0,2
D22,Other,2021,8,10,0,2
D22,Other,2021,6,11,0,5
D32,Break & Enter-House,2021,2,4,0,2
D32,Other,2021,3,23,0,20
D32,Break & Enter-House,2021,1,7,0,6
D32,Break & Enter-House,2021,0,5,0,5
D32,Break & Enter-House,2021,0,10,0,10
D32,Break & Enter-House,2021,0,3,0,3
D32,Break & Enter-House,2021,1,12,0,11
D32,Break & Enter-House,2021,1,3,0,2
D32,Break & Enter-House,2021,1,9,0,8
D32,Break & Enter-House,2021,2,6,0,4
D32,Break & Enter-House,2021,0,1,0,1
D32,Break & Enter-House,2021,2,14,0,12
D32,Break & Enter-House,2021,7,15,0,8
D32,Break & Enter-House,2021,0,15,0,15
D32,Break & Enter-House,2021,1,4,0,3
D32,Break & Enter-House,2021,2,9,0,7
D32,Break & Enter-House,2021,0,1,0,1
D32,Break & Enter-Other,2021,0,4,0,4
D32,Break & Enter-Other,2021,0,3,0,3
D32,Break & Enter-Other,2021,0,1,0,1
D32,Break & Enter-Other,2021,1,5,0,4
D32,Break & Enter-Other,2021,0,1,0,1
D32,Break & Enter-Other,2021,0,5,0,5
D32,Break & Enter-Other,2021,1,3,0,2
D32,Break & Enter-Other,2021,1,4,0,3
D32,Break & Enter-Other,2021,0,2,0,2
D32,Fraud,2021,1,50,0,49
D32,Fraud,2021,2,49,0,47
D32,Fraud,2021,0,32,0,32
D32,Fraud,2021,0,19,0,19
D32,Fraud,2021,3,67,0,64
D32,Fraud,2021,0,14,0,14
D32,Fraud,2021,0,44,0,44
D32,Fraud,2021,0,33,0,33
D32,Fraud,2021,1,73,0,72
D32,Fraud,2021,2,31,0,29
D32,Fraud,2021,1,1,1,0
D32,Fraud,2021,0,4,0,4
D32,Fraud,2021,0,51,0,51
D32,Other,2021,12,12,1,0
D32,Fraud,2021,4,62,0,58
D32,Fraud,2021,0,24,0,24
D32,Fraud,2021,0,59,0,59
D32,Fraud,2021,1,73,0,72
D32,Fraud,2021,2,114,0,112
D32,Fraud,2021,8,62,0,54
D32,Fraud,2021,9,95,0,86
D32,Other,2021,10,34,0,24
D32,Other,2021,3,44,0,41
D32,Auto Theft,2021,1,45,0,44
D32,Other,2021,4,50,0,46
D32,Other,2021,3,17,0,14
D32,Other,2021,16,97,0,81
D32,Theft Under $5000,2021,51,318,0,267
D32,Robbery-Other,2021,0,1,0,1
D32,Auto Theft,2021,1,15,0,14
D32,Robbery-Other,2021,2,9,0,7
D32,Other,2021,2,35,0,33
D32,Robbery-Other,2021,1,2,0,1
D32,Auto Theft,2021,0,62,0,62
D32,Theft Under $5000,2021,66,536,0,470
D32,Assault,2021,35,46,0,11
D32,Other,2021,11,50,0,39
D32,Other,2021,15,19,0,4
D32,Assault,2021,29,49,0,20
D32,Auto Theft,2021,3,47,0,44
D32,Robbery-Other,2021,11,11,1,0
D32,Other,2021,9,60,0,51
D32,Other,2021,7,9,0,2
D32,Assault,2021,18,37,0,19
D32,Auto Theft,2021,0,2,0,2
D32,Robbery-Other,2021,2,7,0,5
D32,Other,2021,4,49,0,45
D32,Other,2021,5,7,0,2
D32,Assault,2021,5,17,0,12
D32,Auto Theft,2021,1,44,0,43
D32,Robbery-Other,2021,4,8,0,4
D32,Other,2021,1,5,0,4
D32,Other,2021,26,38,0,12
D32,Assault,2021,46,88,0,42
D32,Auto Theft,2021,4,93,0,89
D32,Robbery-Other,2021,5,15,0,10
D32,Other,2021,19,53,0,34
D32,Other,2021,6,10,0,4
D32,Assault,2021,21,38,0,17
D32,Auto Theft,2021,0,30,0,30
D32,Robbery-Other,2021,1,6,0,5
D32,Other,2021,21,115,0,94
D32,Other,2021,12,21,0,9
D32,Assault,2021,33,48,0,15
D32,Auto Theft,2021,0,61,0,61
D32,Robbery-Other,2021,11,24,0,13
D32,Other,2021,0,1,0,1
D32,Other,2021,24,30,0,6
D32,Assault,2021,33,65,0,32
D32,Auto Theft,2021,4,37,0,33
D32,Robbery-Other,2021,14,24,0,10
D32,Other,2021,5,32,0,27
D32,Other,2021,22,25,0,3
D32,Assault,2021,48,80,0,32
D32,Auto Theft,2021,5,40,0,35
D32,Auto Theft,2021,12,48,0,36
D32,Auto Theft,2021,7,66,0,59
D32,Break & Enter-Apartment,2021,1,14,0,13
D32,Break & Enter-Apartment,2021,5,8,0,3
D32,Break & Enter-Apartment,2021,1,6,0,5
D32,Break & Enter-Apartment,2021,0,1,0,1
D32,Break & Enter-Apartment,2021,0,10,0,10
D32,Break & Enter-Apartment,2021,0,4,0,4
D32,Break & Enter-Apartment,2021,0,3,0,3
D32,Break & Enter-Apartment,2021,1,2,0,1
D32,Break & Enter-Apartment,2021,0,2,0,2
D32,Break & Enter-Apartment,2021,2,9,0,7
D32,Break & Enter-Apartment,2021,4,6,0,2
D32,Break & Enter-Apartment,2021,2,5,0,3
D32,Break & Enter-Apartment,2021,1,12,0,11
D32,Break & Enter-Apartment,2021,2,5,0,3
D32,Break & Enter-Apartment,2021,0,9,0,9
D32,Break & Enter-Apartment,2021,1,1,1,0
D32,Break & Enter-Apartment,2021,2,5,0,3
D32,Break & Enter-Commercial,2021,0,2,0,2
D32,Break & Enter-Commercial,2021,0,6,0,6
D32,Break & Enter-Commercial,2021,0,11,0,11
D32,Break & Enter-Commercial,2021,0,2,0,2
D32,Break & Enter-Commercial,2021,2,12,0,10
D32,Break & Enter-Commercial,2021,0,8,0,8
D32,Break & Enter-Commercial,2021,0,7,0,7
D32,Break & Enter-Commercial,2021,1,3,0,2
D32,Break & Enter-Commercial,2021,1,5,0,4
D32,Break & Enter-Commercial,2021,1,7,0,6
D32,Break & Enter-Commercial,2021,0,2,0,2
D32,Break & Enter-Commercial,2021,1,3,0,2
D32,Break & Enter-Commercial,2021,1,10,0,9
D32,Break & Enter-Commercial,2021,1,1,1,0
D32,Break & Enter-Commercial,2021,0,6,0,6
D32,Break & Enter-Commercial,2021,0,2,0,2
D32,Break & Enter-Commercial,2021,4,10,0,6
D32,Break & Enter-Commercial,2021,6,36,0,30
D32,Break & Enter-Commercial,2021,4,18,0,14
D32,Break & Enter-House,2021,1,1,1,0
D32,Other,2021,14,73,0,59
D32,Other,2021,12,14,0,2
D32,Other,2021,14,64,0,50
D32,Assault,2021,20,37,0,17
D32,Robbery-Other,2021,1,3,0,2
D32,Other,2021,12,59,0,47
D32,Other,2021,0,1,0,1
D32,Robbery-Other,2021,4,9,0,5
D32,Assault,2021,2,3,0,1
D32,Other,2021,5,57,0,52
D32,Assault,2021,4,9,0,5
D32,Sexual Violation,2021,3,5,0,2
D32,Other,2021,5,7,0,2
D32,Other,2021,37,86,0,49
D32,Assault,2021,40,79,0,39
D32,Sexual Violation,2021,1,5,0,4
D32,Other,2021,15,20,0,5
D32,Theft Over $5000,2021,1,5,0,4
D32,Assault,2021,115,183,0,68
D32,Sexual Violation,2021,5,6,0,1
D32,Other,2021,47,60,0,13
D32,Theft Over $5000,2021,0,1,0,1
D32,Assault,2021,10,16,0,6
D32,Sexual Violation,2021,3,8,0,5
D32,Other,2021,9,11,0,2
D32,Theft Over $5000,2021,0,4,0,4
D32,Assault,2021,53,77,0,24
D32,Sexual Violation,2021,3,5,0,2
D32,Other,2021,22,28,0,6
D32,Theft Over $5000,2021,1,7,0,6
D32,Assault,2021,56,76,0,20
D32,Sexual Violation,2021,3,12,0,9
D32,Other,2021,83,97,0,14
D32,Theft Over $5000,2021,0,2,0,2
D32,Assault,2021,42,66,0,24
D32,Sexual Violation,2021,3,10,0,7
D32,Other,2021,27,33,0,6
D32,Theft Over $5000,2021,0,5,0,5
D32,Assault,2021,19,46,0,27
D32,Sexual Violation,2021,1,3,0,2
D32,Other,2021,88,99,0,11
D32,Theft Over $5000,2021,0,6,0,6
D31,Other,2021,15,17,0,2
D32,Assault,2021,60,102,0,42
D32,Sexual Violation,2021,2,4,0,2
D32,Other,2021,30,36,0,6
D32,Theft Over $5000,2021,0,5,0,5
D31,Other,2021,10,11,0,1
D32,Attempt Murder,2021,1,1,1,0
D32,Sexual Violation,2021,1,2,0,1
D32,Other Criminal Violations - Offensive Weapons,2021,2,2,1,0
D31,Other,2021,13,14,0,1
D32,Theft Over $5000,2021,0,1,0,1
D31,Other,2021,3,3,1,0
D32,Other,2021,10,13,0,3
D32,Sexual Violation,2021,2,6,0,4
D32,Theft Over $5000,2021,0,2,0,2
D32,Other Criminal Violations - Offensive Weapons,2021,3,3,1,0
D32,Sexual Violation,2021,11,30,0,19
D32,Theft Over $5000,2021,0,8,0,8
D32,Other Criminal Violations - Offensive Weapons,2021,0,1,0,1
D32,Sexual Violation,2021,2,4,0,2
D32,Theft Over $5000,2021,2,9,0,7
D32,Other,2021,10,17,0,7
D32,Other Criminal Violations - Offensive Weapons,2021,11,13,0,2
D32,Sexual Violation,2021,3,9,0,6
D32,Theft Over $5000,2021,0,2,0,2
D32,Other,2021,3,6,0,3
D32,Other Criminal Violations - Offensive Weapons,2021,1,1,1,0
D32,Sexual Violation,2021,6,14,0,8
D32,Theft Over $5000,2021,2,7,0,5
D31,Other,2021,22,26,0,4
D32,Other,2021,2,4,0,2
D32,Other Criminal Violations - Offensive Weapons,2021,3,4,0,1
D32,Sexual Violation,2021,2,12,0,10
D32,Theft Over $5000,2021,0,9,0,9
D31,Other,2021,16,16,1,0
D32,Other,2021,20,26,0,6
D32,Other Criminal Violations - Offensive Weapons,2021,4,5,0,1
D32,Sexual Violation,2021,1,2,0,1
D32,Theft Over $5000,2021,0,9,0,9
D31,Other,2021,12,15,0,3
D32,Other,2021,1,4,0,3
D32,Other Criminal Violations - Offensive Weapons,2021,10,12,0,2
D32,Sexual Violation,2021,7,12,0,5
D32,Theft Over $5000,2021,1,12,0,11
D31,Other,2021,106,131,0,25
D32,Other,2021,11,21,0,10
D32,Other Criminal Violations - Offensive Weapons,2021,3,3,1,0
D32,Other,2021,9,9,1,0
D32,Theft Over $5000,2021,1,16,0,15
D31,Other,2021,15,22,0,7
D32,Other,2021,7,10,0,3
D32,Other,2021,6,6,1,0
D32,Theft Under $5000,2021,4,149,0,145
D31,Other,2021,94,109,0,15
D32,Other,2021,7,14,0,7
D31,Other,2021,25,27,0,2
D32,Other Criminal Violations - Offensive Weapons,2021,0,1,0,1
D32,Theft Under $5000,2021,4,77,0,73
D32,Other,2021,9,9,1,0
D32,Other,2021,1,1,1,0
D31,Other,2021,120,136,0,16
D32,Other Criminal Violations - Offensive Weapons,2021,4,6,0,2
D32,Theft Under $5000,2021,15,193,0,178
D32,Other,2021,4,12,0,8
D32,Other,2021,6,7,0,1
D31,Other,2021,1,1,1,0
D32,Other Criminal Violations - Offensive Weapons,2021,16,18,0,2
D32,Theft Under $5000,2021,1,47,0,46
D32,Other,2021,14,29,0,15
D32,Other,2021,1,2,0,1
D31,Other,2021,6,9,0,3
D32,Other Criminal Violations - Offensive Weapons,2021,2,2,1,0
D32,Theft Under $5000,2021,49,340,0,291
D32,Other,2021,3,4,0,1
D32,Other,2021,15,17,0,2
D31,Other,2021,124,151,0,27
D32,Other Criminal Violations - Offensive Weapons,2021,7,9,0,2
D32,Theft Under $5000,2021,2,39,0,37
D32,Other,2021,14,21,0,7
D32,Other,2021,1,2,0,1
D31,Other,2021,10,14,0,4
D32,Other Criminal Violations - Offensive Weapons,2021,7,7,1,0
D32,Theft Under $5000,2021,2,104,0,102
D32,Other,2021,5,15,0,10
D32,Other,2021,2,3,0,1
D31,Other,2021,50,76,0,26
D32,Other Criminal Violations - Offensive Weapons,2021,8,11,0,3
D32,Theft Under $5000,2021,5,131,0,126
D32,Other,2021,5,8,0,3
D32,Other,2021,1,2,0,1
D31,Other Criminal Violations - Offensive Weapons,2021,22,26,0,4
D32,Other Criminal Violations - Offensive Weapons,2021,4,4,1,0
D32,Theft Under $5000,2021,37,270,0,233
D32,Other,2021,7,10,0,3
D32,Other,2021,4,5,0,1
D31,Other Criminal Violations - Offensive Weapons,2021,11,16,0,5
D31,Other Criminal Violations - Offensive Weapons,2021,25,36,0,11
D31,Other Criminal Violations - Offensive Weapons,2021,6,7,0,1
D31,Other Criminal Violations - Offensive Weapons,2021,7,10,0,3
D31,Other Criminal Violations - Offensive Weapons,2021,1,1,1,0
D31,Other Criminal Violations - Offensive Weapons,2021,30,42,0,12
D31,Other Criminal Violations - Offensive Weapons,2021,1,3,0,2
D31,Other Criminal Violations - Offensive Weapons,2021,10,23,0,13
D31,Other,2021,4,6,0,2
D31,Other,2021,1,1,1,0
D31,Other,2021,3,4,0,1
D32,Other,2021,1,1,1,0
D32,Other,2021,1,1,1,0
D32,Other,2021,8,9,0,1
D32,Other,2021,4,4,1,0
D32,Other,2021,1,1,1,0
D32,Other,2021,4,4,1,0
D32,Other,2021,2,2,1,0
D32,Other,2021,1,1,1,0
D32,Other,2021,6,7,0,1
D32,Other,2021,3,3,1,0
D32,Other,2021,3,3,1,0
D32,Other,2021,2,2,1,0
D32,Other,2021,4,4,1,0
D32,Other,2021,2,2,1,0
D32,Other,2021,4,5,0,1
D32,Auto Theft,2021,5,34,0,29
D32,Auto Theft,2021,2,44,0,42
D32,Auto Theft,2021,2,83,0,81
D32,Auto Theft,2021,1,11,0,10
D32,Auto Theft,2021,1,89,0,88
D32,Auto Theft,2021,0,16,0,16
D32,Other Criminal Violations - Offensive Weapons,2021,9,12,0,3
D32,Other,2021,4,4,1,0
D32,Theft Under $5000,2021,10,136,0,126
D32,Other,2021,7,17,0,10
D32,Other,2021,1,1,1,0
D32,Other,2021,1,1,1,0
D32,Theft Under $5000,2021,2,12,0,10
D32,Robbery-Financial,2021,0,2,0,2
D32,Other,2021,9,10,0,1
D32,Theft Under $5000,2021,3,83,0,80
D32,Robbery-Financial,2021,2,2,1,0
D32,Theft Under $5000,2021,20,193,0,173
D32,Other,2021,0,1,0,1
D32,Robbery-Financial,2021,2,2,1,0
D32,Other,2021,4,5,0,1
D32,Theft Under $5000,2021,3,104,0,101
D32,Other,2021,1,1,1,0
D32,Robbery-Financial,2021,1,1,1,0
D32,Other,2021,5,5,1,0
D32,Theft Under $5000,2021,4,135,0,131
D32,Other,2021,1,1,1,0
D32,Robbery-Financial,2021,2,2,1,0
D32,Other,2021,4,5,0,1
D32,Theft Under $5000,2021,12,153,0,141
D32,Other,2021,1,1,1,0
D32,Robbery-Other,2021,0,3,0,3
D32,Other,2021,9,9,1,0
D32,Theft Under $5000,2021,43,416,0,373
D33,Other,2021,10,11,0,1
D32,Robbery-Other,2021,5,6,0,1
D32,Other,2021,2,3,0,1
D33,Other,2021,2,3,0,1
D32,Robbery-Other,2021,4,9,0,5
D32,Other,2021,7,8,0,1
D33,Other,2021,10,14,0,4
D32,Robbery-Other,2021,1,9,0,8
D32,Other,2021,9,10,0,1
D33,Other,2021,4,4,1,0
D33,Other,2021,4,4,1,0
D33,Other,2021,1,1,1,0
D33,Other,2021,2,2,1,0
D31,Theft Under $5000,2021,13,132,0,119
D31,Theft Under $5000,2021,49,233,0,184
D31,Theft Under $5000,2021,10,206,0,196
D31,Theft Under $5000,2021,20,90,0,70
D31,Theft Under $5000,2021,1,1,1,0
D31,Theft Under $5000,2021,1,13,0,12
D31,Theft Under $5000,2021,71,489,0,418
D31,Theft Under $5000,2021,1,40,0,39
D31,Theft Under $5000,2021,21,327,0,306
D31,Assault,2021,105,170,0,65
D31,Assault,2021,60,84,0,24
D31,Assault,2021,151,271,0,120
D31,Assault,2021,54,87,0,33
D31,Assault,2021,77,115,0,38
D31,Assault,2021,5,17,0,12
D31,Assault,2021,163,251,0,88
D31,Assault,2021,18,30,0,12
D31,Assault,2021,149,237,0,88
D31,Attempt Murder,2021,1,1,1,0
D31,Attempt Murder,2021,1,1,1,0
D31,Attempt Murder,2021,1,1,1,0
D31,Attempt Murder,2021,1,2,0,1
D31,Other,2021,26,38,0,12
D31,Other,2021,4,8,0,4
D31,Other,2021,33,52,0,19
D31,Other,2021,13,33,0,20
D31,Other,2021,8,17,0,9
D31,Other,2021,1,3,0,2
D31,Other,2021,20,32,0,12
D31,Other,2021,7,14,0,7
D31,Other,2021,28,54,0,26
D31,Robbery-Other,2021,7,9,0,2
D31,Robbery-Other,2021,3,7,0,4
D31,Robbery-Other,2021,19,23,0,4
D31,Robbery-Other,2021,3,10,0,7
D31,Robbery-Other,2021,11,16,0,5
D31,Robbery-Other,2021,1,4,0,3
D31,Robbery-Other,2021,13,25,0,12
D31,Robbery-Other,2021,6,23,0,17
D31,Sexual Violation,2021,20,36,0,16
D31,Sexual Violation,2021,2,6,0,4
D31,Sexual Violation,2021,21,43,0,22
D31,Sexual Violation,2021,7,18,0,11
D31,Sexual Violation,2021,7,21,0,14
D31,Sexual Violation,2021,2,5,0,3
D31,Sexual Violation,2021,11,20,0,9
D31,Sexual Violation,2021,2,3,0,1
D31,Sexual Violation,2021,12,28,0,16
D31,Other,2021,4,5,0,1
D31,Other,2021,6,10,0,4
D33,Other,2021,9,11,0,2
D33,Other,2021,5,7,0,2
D33,Other,2021,10,12,0,2
D33,Other,2021,1,1,1,0
D33,Other,2021,7,12,0,5
D33,Other,2021,1,1,1,0
D33,Other Criminal Violations - Offensive Weapons,2021,7,10,0,3
D41,Break & Enter-Apartment,2021,1,2,0,1
D33,Robbery-Other,2021,0,2,0,2
D33,Other,2021,1,1,1,0
D33,Other Criminal Violations - Offensive Weapons,2021,7,7,1,0
D33,Other Criminal Violations - Offensive Weapons,2021,1,1,1,0
D33,Other Criminal Violations - Offensive Weapons,2021,0,1,0,1
D33,Other Criminal Violations - Offensive Weapons,2021,7,8,0,1
D33,Other Criminal Violations - Offensive Weapons,2021,5,6,0,1
D33,Break & Enter-Other,2021,0,1,0,1
D33,Other Criminal Violations - Offensive Weapons,2021,8,8,1,0
D33,Other Criminal Violations - Offensive Weapons,2021,4,4,1,0
D33,Other Criminal Violations - Offensive Weapons,2021,1,1,1,0
D33,Other Criminal Violations - Offensive Weapons,2021,2,4,0,2
D33,Other Criminal Violations - Offensive Weapons,2021,3,3,1,0
D33,Other Criminal Violations - Offensive Weapons,2021,4,4,1,0
D33,Other Criminal Violations - Offensive Weapons,2021,4,6,0,2
D33,Other Criminal Violations - Offensive Weapons,2021,2,4,0,2
D33,Other,2021,2,2,1,0
D33,Other,2021,1,2,0,1
D33,Other,2021,1,1,1,0
D33,Other,2021,1,1,1,0
D41,Other,2021,1,1,1,0
D41,Other,2021,1,2,0,1
D41,Other,2021,8,10,0,2
D41,Other,2021,12,13,0,1
D41,Other,2021,2,3,0,1
D41,Other,2021,2,2,1,0
D41,Other,2021,5,5,1,0
D41,Other,2021,10,10,1,0
D41,Other,2021,3,3,1,0
D41,Other,2021,8,8,1,0
D41,Other,2021,14,15,0,1
D41,Auto Theft,2021,1,8,0,7
D41,Auto Theft,2021,1,17,0,16
D41,Auto Theft,2021,0,30,0,30
D41,Auto Theft,2021,6,50,0,44
D41,Auto Theft,2021,0,14,0,14
D41,Auto Theft,2021,6,49,0,43
D41,Auto Theft,2021,0,15,0,15
D41,Auto Theft,2021,3,11,0,8
D41,Auto Theft,2021,3,34,0,31
D41,Auto Theft,2021,0,3,0,3
D41,Auto Theft,2021,2,22,0,20
D41,Auto Theft,2021,6,93,0,87
D41,Break & Enter-Apartment,2021,1,2,0,1
D41,Break & Enter-Apartment,2021,5,16,0,11
D41,Break & Enter-Apartment,2021,8,11,0,3
D41,Other,2021,25,47,0,22
D41,Other,2021,5,13,0,8
D41,Other,2021,5,20,0,15
D41,Other,2021,8,12,0,4
D33,Other,2021,0,1,0,1
D41,Break & Enter-Apartment,2021,1,5,0,4
D41,Other,2021,28,96,0,68
D33,Robbery-Other,2021,0,2,0,2
D41,Other,2021,8,20,0,12
D33,Break & Enter-Other,2021,0,1,0,1
D41,Other,2021,53,152,0,99
D33,Other,2021,3,4,0,1
D41,Other,2021,2,5,0,3
D33,Break & Enter-Other,2021,0,1,0,1
D33,Robbery-Other,2021,6,12,0,6
D41,Other,2021,8,22,0,14
D41,Break & Enter-Apartment,2021,2,2,1,0
D33,Auto Theft,2021,1,36,0,35
D41,Other,2021,7,8,0,1
D33,Break & Enter-Other,2021,0,1,0,1
D33,Robbery-Other,2021,3,7,0,4
D41,Other,2021,32,112,0,80
D41,Break & Enter-Apartment,2021,1,7,0,6
D33,Auto Theft,2021,2,42,0,40
D41,Other,2021,14,32,0,18
D33,Break & Enter-Other,2021,0,1,0,1
D33,Robbery-Other,2021,2,7,0,5
D41,Other,2021,10,25,0,15
D41,Break & Enter-Apartment,2021,3,11,0,8
D33,Auto Theft,2021,0,27,0,27
D41,Other,2021,6,6,1,0
D33,Fraud,2021,11,114,0,103
D33,Robbery-Other,2021,4,6,0,2
D41,Other,2021,13,47,0,34
D41,Break & Enter-Apartment,2021,3,6,0,3
D33,Auto Theft,2021,0,1,0,1
D41,Other,2021,25,36,0,11
D33,Fraud,2021,6,100,0,94
D33,Robbery-Other,2021,1,1,1,0
D41,Other,2021,43,122,0,79
D41,Break & Enter-Apartment,2021,1,2,0,1
D33,Auto Theft,2021,0,35,0,35
D41,Other,2021,21,36,0,15
D33,Fraud,2021,2,32,0,30
D33,Robbery-Other,2021,2,10,0,8
D41,Other,2021,3,4,0,1
D41,Break & Enter-Commercial,2021,2,4,0,2
D33,Auto Theft,2021,1,34,0,33
D41,Robbery-Financial,2021,0,2,0,2
D33,Fraud,2021,1,5,0,4
D33,Fraud,2021,2,108,0,106
D33,Fraud,2021,1,46,0,45
D33,Fraud,2021,0,2,0,2
D33,Fraud,2021,3,74,0,71
D33,Fraud,2021,2,73,0,71
D33,Fraud,2021,0,5,0,5
D33,Fraud,2021,1,27,0,26
D33,Fraud,2021,1,53,0,52
D33,Fraud,2021,1,26,0,25
D33,Fraud,2021,0,1,0,1
D33,Fraud,2021,13,41,0,28
D33,Fraud,2021,0,1,0,1
D33,Other,2021,22,100,0,78
D33,Other,2021,13,57,0,44
D33,Other,2021,6,30,0,24
D33,Other,2021,2,10,0,8
D33,Other,2021,9,80,0,71
D33,Other,2021,11,62,0,51
D33,Other,2021,0,5,0,5
D33,Other,2021,17,92,0,75
D33,Other,2021,3,52,0,49
D33,Other,2021,0,1,0,1
D33,Other,2021,2,8,0,6
D33,Other,2021,6,43,0,37
D33,Other,2021,3,57,0,54
D33,Other,2021,3,28,0,25
D33,Other,2021,0,1,0,1
D33,Other,2021,3,47,0,44
D33,Other,2021,2,3,0,1
D33,Theft Over $5000,2021,0,8,0,8
D33,Theft Over $5000,2021,1,9,0,8
D33,Theft Over $5000,2021,0,2,0,2
D33,Theft Over $5000,2021,2,11,0,9
D33,Theft Over $5000,2021,1,4,0,3
D33,Theft Over $5000,2021,0,1,0,1
D33,Theft Over $5000,2021,0,6,0,6
D33,Theft Over $5000,2021,0,4,0,4
D33,Theft Over $5000,2021,0,1,0,1
D33,Theft Over $5000,2021,0,1,0,1
D33,Theft Over $5000,2021,0,6,0,6
D33,Theft Over $5000,2021,0,5,0,5
D41,Other,2021,27,101,0,74
D33,Auto Theft,2021,1,33,0,32
D41,Break & Enter-Commercial,2021,6,9,0,3
D41,Robbery-Financial,2021,1,1,1,0
D41,Other,2021,34,106,0,72
D33,Auto Theft,2021,5,41,0,36
D41,Break & Enter-Commercial,2021,9,26,0,17
D41,Break & Enter-Commercial,2021,1,1,1,0
D41,Break & Enter-Commercial,2021,11,29,0,18
D41,Break & Enter-Commercial,2021,2,4,0,2
D41,Break & Enter-Commercial,2021,0,3,0,3
D41,Break & Enter-Commercial,2021,3,12,0,9
D41,Break & Enter-Commercial,2021,7,16,0,9
D41,Break & Enter-Commercial,2021,7,47,0,40
D41,Break & Enter-House,2021,2,2,1,0
D41,Break & Enter-House,2021,1,2,0,1
D41,Break & Enter-House,2021,7,12,0,5
D41,Break & Enter-House,2021,9,15,0,6
D41,Break & Enter-House,2021,2,7,0,5
D41,Break & Enter-House,2021,1,3,0,2
D41,Break & Enter-House,2021,3,4,0,1
D41,Break & Enter-House,2021,4,6,0,2
D41,Break & Enter-House,2021,0,10,0,10
D41,Break & Enter-House,2021,0,1,0,1
D41,Break & Enter-House,2021,3,7,0,4
D41,Break & Enter-House,2021,5,11,0,6
D41,Break & Enter-Other,2021,1,1,1,0
D41,Break & Enter-Other,2021,0,3,0,3
D41,Break & Enter-Other,2021,2,5,0,3
D41,Break & Enter-Other,2021,2,5,0,3
D41,Break & Enter-Other,2021,1,1,1,0
D41,Break & Enter-Other,2021,0,1,0,1
D41,Break & Enter-Other,2021,1,2,0,1
D41,Break & Enter-Other,2021,1,2,0,1
D41,Break & Enter-Other,2021,4,10,0,6
D41,Fraud,2021,2,15,0,13
D41,Fraud,2021,2,17,0,15
D41,Fraud,2021,5,68,0,63
D41,Fraud,2021,8,88,0,80
D41,Fraud,2021,1,17,0,16
D41,Fraud,2021,7,95,0,88
D41,Fraud,2021,1,26,0,25
D41,Fraud,2021,8,41,0,33
D41,Fraud,2021,5,61,0,56
D41,Fraud,2021,0,9,0,9
D41,Fraud,2021,5,44,0,39
D41,Fraud,2021,11,140,0,129
D33,Robbery-Other,2021,2,6,0,4
D41,Robbery-Other,2021,0,1,0,1
D33,Auto Theft,2021,0,4,0,4
D33,Robbery-Other,2021,1,2,0,1
D41,Robbery-Other,2021,8,10,0,2
D33,Robbery-Other,2021,0,2,0,2
D41,Robbery-Other,2021,3,7,0,4
D33,Robbery-Other,2021,0,1,0,1
D33,Auto Theft,2021,0,20,0,20
D41,Robbery-Other,2021,7,8,0,1
D41,Theft Over $5000,2021,1,4,0,3
D33,Sexual Violation,2021,5,11,0,6
D33,Auto Theft,2021,0,14,0,14
D41,Robbery-Other,2021,2,5,0,3
D41,Theft Over $5000,2021,0,4,0,4
D33,Sexual Violation,2021,9,17,0,8
D33,Auto Theft,2021,1,34,0,33
D41,Robbery-Other,2021,9,14,0,5
D41,Theft Over $5000,2021,2,15,0,13
D33,Sexual Violation,2021,1,5,0,4
D33,Auto Theft,2021,0,29,0,29
D41,Robbery-Other,2021,3,7,0,4
D41,Theft Over $5000,2021,0,4,0,4
D33,Sexual Violation,2021,0,3,0,3
D33,Break & Enter-Apartment,2021,0,2,0,2
D41,Robbery-Other,2021,3,3,1,0
D41,Theft Over $5000,2021,1,3,0,2
D33,Sexual Violation,2021,11,24,0,13
D33,Break & Enter-Apartment,2021,2,7,0,5
D41,Robbery-Other,2021,10,24,0,14
D41,Theft Over $5000,2021,0,3,0,3
D33,Break & Enter-Apartment,2021,0,6,0,6
D41,Robbery-Other,2021,10,21,0,11
D41,Theft Over $5000,2021,1,5,0,4
D33,Break & Enter-Apartment,2021,0,13,0,13
D41,Robbery-Other,2021,16,24,0,8
D41,Theft Over $5000,2021,1,15,0,14
D33,Break & Enter-Apartment,2021,1,13,0,12
D41,Sexual Violation,2021,2,3,0,1
D41,Theft Under $5000,2021,2,23,0,21
D33,Break & Enter-Apartment,2021,3,18,0,15
D41,Sexual Violation,2021,3,6,0,3
D41,Theft Under $5000,2021,2,53,0,51
D33,Break & Enter-Apartment,2021,2,3,0,1
D41,Sexual Violation,2021,4,14,0,10
D41,Theft Under $5000,2021,94,319,0,225
D33,Break & Enter-Apartment,2021,0,3,0,3
D41,Sexual Violation,2021,10,24,0,14
D41,Theft Under $5000,2021,79,323,0,244
D33,Break & Enter-Apartment,2021,0,8,0,8
D41,Sexual Violation,2021,3,12,0,9
D41,Sexual Violation,2021,10,17,0,7
D41,Sexual Violation,2021,1,3,0,2
D41,Sexual Violation,2021,6,12,0,6
D41,Sexual Violation,2021,17,28,0,11
D41,Sexual Violation,2021,0,1,0,1
D41,Sexual Violation,2021,14,21,0,7
D41,Sexual Violation,2021,16,25,0,9
D41,Other,2021,5,6,0,1
D41,Other,2021,8,9,0,1
D41,Other,2021,10,11,0,1
D41,Other,2021,17,17,1,0
D41,Other,2021,4,4,1,0
D41,Other,2021,30,32,0,2
D41,Other,2021,0,1,0,1
D41,Other,2021,5,8,0,3
D41,Other,2021,3,3,1,0
D41,Other,2021,2,2,1,0
D41,Other,2021,7,7,1,0
D41,Other,2021,38,39,0,1
D41,Other,2021,10,10,1,0
D41,Other,2021,9,11,0,2
D41,Other,2021,52,70,0,18
D41,Other,2021,291,319,0,28
D33,Sexual Violation,2021,7,14,0,7
D41,Theft Under $5000,2021,5,37,0,32
D33,Break & Enter-Apartment,2021,0,1,0,1
D33,Sexual Violation,2021,9,16,0,7
D41,Theft Under $5000,2021,32,311,0,279
D33,Break & Enter-Apartment,2021,0,1,0,1
D33,Sexual Violation,2021,3,4,0,1
D41,Theft Under $5000,2021,6,42,0,36
D33,Break & Enter-Commercial,2021,3,6,0,3
D33,Sexual Violation,2021,3,6,0,3
D41,Theft Under $5000,2021,41,122,0,81
D33,Break & Enter-Commercial,2021,2,10,0,8
D33,Sexual Violation,2021,2,5,0,3
D41,Theft Under $5000,2021,64,312,0,248
D33,Break & Enter-Commercial,2021,0,5,0,5
D33,Sexual Violation,2021,4,7,0,3
D41,Theft Under $5000,2021,18,32,0,14
D33,Break & Enter-Commercial,2021,1,3,0,2
D33,Sexual Violation,2021,2,3,0,1
D41,Theft Under $5000,2021,48,375,0,327
D33,Break & Enter-Commercial,2021,2,9,0,7
D33,Other,2021,25,29,0,4
D41,Theft Under $5000,2021,96,570,0,474
D33,Other,2021,7,10,0,3
D41,Assault,2021,12,24,0,12
D33,Other,2021,2,2,1,0
D33,Break & Enter-Commercial,2021,0,2,0,2
D41,Assault,2021,22,36,0,14
D33,Other,2021,3,3,1,0
D33,Break & Enter-Commercial,2021,0,4,0,4
D41,Assault,2021,90,127,0,37
D33,Other,2021,5,5,1,0
D33,Break & Enter-Commercial,2021,0,6,0,6
D41,Assault,2021,136,208,0,72
D33,Other,2021,12,16,0,4
D33,Break & Enter-Commercial,2021,0,5,0,5
D41,Assault,2021,27,36,0,9
D33,Other,2021,8,10,0,2
D33,Break & Enter-House,2021,0,12,0,12
D41,Assault,2021,72,127,0,55
D33,Other,2021,10,10,1,0
D33,Break & Enter-House,2021,0,9,0,9
D41,Assault,2021,37,49,0,12
D33,Other,2021,8,10,0,2
D33,Break & Enter-House,2021,1,4,0,3
D41,Assault,2021,54,83,0,29
D33,Other,2021,0,1,0,1
D33,Break & Enter-House,2021,0,3,0,3
D41,Assault,2021,90,170,0,80
D33,Other,2021,8,8,1,0
D33,Break & Enter-House,2021,1,12,0,11
D41,Assault,2021,2,5,0,3
D33,Other,2021,3,4,0,1
D33,Break & Enter-House,2021,1,7,0,6
D41,Assault,2021,109,166,0,57
D33,Other,2021,3,4,0,1
D33,Break & Enter-House,2021,1,3,0,2
D41,Assault,2021,99,185,0,86
D33,Other,2021,1,2,0,1
D33,Break & Enter-House,2021,0,7,0,7
D41,Attempt Murder,2021,1,1,1,0
D33,Other,2021,8,8,1,0
D33,Break & Enter-House,2021,0,1,0,1
D41,Attempt Murder,2021,1,1,1,0
D33,Other,2021,4,4,1,0
D33,Break & Enter-House,2021,1,9,0,8
D41,Attempt Murder,2021,1,1,1,0
D33,Other,2021,43,58,0,15
D33,Break & Enter-House,2021,0,2,0,2
D41,Other,2021,1,3,0,2
D33,Break & Enter-House,2021,1,6,0,5
D41,Other,2021,4,10,0,6
D33,Break & Enter-Other,2021,1,3,0,2
D33,Other,2021,12,14,0,2
D41,Other,2021,27,41,0,14
D33,Break & Enter-Other,2021,1,3,0,2
D33,Other,2021,7,8,0,1
D33,Other,2021,0,1,0,1
D33,Other,2021,18,30,0,12
D33,Other,2021,30,36,0,6
D33,Other,2021,37,44,0,7
D33,Other,2021,14,20,0,6
D33,Other,2021,2,2,1,0
D33,Other,2021,0,1,0,1
D33,Theft Over $5000,2021,0,4,0,4
D33,Theft Under $5000,2021,45,293,0,248
D33,Theft Under $5000,2021,34,288,0,254
D33,Theft Under $5000,2021,6,106,0,100
D33,Theft Under $5000,2021,0,4,0,4
D33,Theft Under $5000,2021,0,1,0,1
D33,Theft Under $5000,2021,18,301,0,283
D33,Theft Under $5000,2021,4,124,0,120
D33,Theft Under $5000,2021,0,1,0,1
D33,Theft Under $5000,2021,7,188,0,181
D33,Theft Under $5000,2021,4,100,0,96
D33,Theft Under $5000,2021,0,14,0,14
D33,Theft Under $5000,2021,3,54,0,51
D33,Theft Under $5000,2021,5,134,0,129
D33,Theft Under $5000,2021,8,163,0,155
D33,Theft Under $5000,2021,2,72,0,70
D33,Theft Under $5000,2021,1,1,1,0
D33,Assault,2021,49,81,0,32
D33,Assault,2021,37,59,0,22
D33,Assault,2021,12,25,0,13
D33,Assault,2021,2,6,0,4
D33,Assault,2021,54,110,0,56
D33,Assault,2021,36,77,0,41
D33,Assault,2021,0,1,0,1
D33,Assault,2021,58,92,0,34
D33,Assault,2021,24,41,0,17
D33,Assault,2021,1,3,0,2
D33,Assault,2021,28,44,0,16
D33,Assault,2021,13,22,0,9
D33,Assault,2021,16,27,0,11
D33,Assault,2021,0,1,0,1
D33,Assault,2021,21,40,0,19
D33,Assault,2021,4,6,0,2
D33,Attempt Murder,2021,1,3,0,2
D33,Attempt Murder,2021,1,1,1,0
D33,Other,2021,8,12,0,4
D33,Other,2021,5,14,0,9
D33,Other,2021,3,4,0,1
D33,Other,2021,11,18,0,7
D33,Other,2021,11,19,0,8
D33,Other,2021,6,14,0,8
D33,Other,2021,4,13,0,9
D33,Other,2021,1,1,1,0
D33,Other,2021,5,10,0,5
D33,Other,2021,3,7,0,4
D33,Other,2021,4,5,0,1
D33,Other,2021,8,10,0,2
D33,Robbery-Financial,2021,1,1,1,0
D33,Robbery-Other,2021,1,2,0,1
D33,Robbery-Other,2021,2,3,0,1
D42,Other,2021,27,38,0,11
D42,Other,2021,25,33,0,8
D42,Other,2021,62,72,0,10
D42,Other,2021,22,28,0,6
D42,Other,2021,16,32,0,16
D42,Other,2021,25,35,0,10
D42,Other,2021,1,1,1,0
D42,Other,2021,18,24,0,6
D42,Other,2021,26,35,0,9
D42,Other,2021,14,15,0,1
D42,Other Criminal Violations - Offensive Weapons,2021,2,2,1,0
D42,Other Criminal Violations - Offensive Weapons,2021,5,7,0,2
D42,Other Criminal Violations - Offensive Weapons,2021,3,3,1,0
D42,Other Criminal Violations - Offensive Weapons,2021,1,2,0,1
D42,Other Criminal Violations - Offensive Weapons,2021,11,14,0,3
D42,Other Criminal Violations - Offensive Weapons,2021,6,7,0,1
D42,Other Criminal Violations - Offensive Weapons,2021,4,4,1,0
D42,Other Criminal Violations - Offensive Weapons,2021,8,8,1,0
D42,Other Criminal Violations - Offensive Weapons,2021,1,1,1,0
D42,Other Criminal Violations - Offensive Weapons,2021,2,4,0,2
D42,Other Criminal Violations - Offensive Weapons,2021,4,6,0,2
D42,Other Criminal Violations - Offensive Weapons,2021,2,2,1,0
D42,Other,2021,1,1,1,0
D42,Other,2021,1,1,1,0
D42,Other,2021,0,1,0,1
D42,Other,2021,1,1,1,0
D43,Other,2021,2,2,1,0
D43,Other,2021,5,6,0,1
D43,Other,2021,3,3,1,0
D43,Other,2021,5,5,1,0
D43,Other,2021,10,13,0,3
D43,Other,2021,1,1,1,0
D43,Other,2021,2,2,1,0
D43,Other,2021,6,7,0,1
D43,Other,2021,17,19,0,2
D43,Other,2021,9,9,1,0
D43,Auto Theft,2021,1,7,0,6
D43,Auto Theft,2021,0,59,0,59
D43,Fraud,2021,14,112,0,98
D43,Auto Theft,2021,2,22,0,20
D43,Auto Theft,2021,2,17,0,15
D43,Auto Theft,2021,8,28,0,20
D43,Auto Theft,2021,8,50,0,42
D43,Auto Theft,2021,3,13,0,10
D43,Auto Theft,2021,3,30,0,27
D43,Auto Theft,2021,2,32,0,30
D43,Auto Theft,2021,3,26,0,23
D43,Auto Theft,2021,14,75,0,61
D43,Auto Theft,2021,0,9,0,9
D43,Auto Theft,2021,3,57,0,54
D43,Break & Enter-Apartment,2021,0,5,0,5
D42,Other,2021,25,37,0,12
D43,Break & Enter-Apartment,2021,0,1,0,1
D43,Assault,2021,54,77,0,23
D42,Break & Enter-Commercial,2021,0,2,0,2
D43,Fraud,2021,1,18,0,17
D42,Other,2021,11,15,0,4
D43,Break & Enter-Apartment,2021,1,4,0,3
D42,Break & Enter-Commercial,2021,0,18,0,18
D43,Assault,2021,1,2,0,1
D43,Fraud,2021,9,96,0,87
D42,Other,2021,8,16,0,8
D43,Break & Enter-Apartment,2021,3,7,0,4
D42,Break & Enter-Commercial,2021,0,3,0,3
D43,Assault,2021,67,111,0,44
D43,Other,2021,3,13,0,10
D41,Other,2021,20,23,0,3
D42,Other,2021,22,30,0,8
D43,Break & Enter-Apartment,2021,1,2,0,1
D42,Break & Enter-Commercial,2021,1,3,0,2
D43,Assault,2021,213,301,0,88
D42,Other,2021,9,84,0,75
D43,Other,2021,12,52,0,40
D43,Other,2021,2,21,0,19
D43,Other,2021,13,53,0,40
D43,Other,2021,16,67,0,51
D43,Other,2021,25,85,0,60
D43,Other,2021,6,33,0,27
D43,Other,2021,2,20,0,18
D43,Other,2021,9,51,0,42
D43,Other,2021,2,3,0,1
D43,Other,2021,22,87,0,65
D43,Other,2021,62,177,0,115
D43,Other,2021,3,16,0,13
D43,Other,2021,31,112,0,81
D43,Theft Over $5000,2021,1,3,0,2
D43,Theft Over $5000,2021,0,2,0,2
D43,Theft Over $5000,2021,1,3,0,2
D43,Theft Over $5000,2021,1,1,1,0
D43,Theft Over $5000,2021,2,5,0,3
D43,Theft Over $5000,2021,0,1,0,1
D43,Theft Over $5000,2021,0,1,0,1
D43,Theft Over $5000,2021,2,6,0,4
D43,Theft Over $5000,2021,2,4,0,2
D43,Theft Over $5000,2021,0,2,0,2
D43,Theft Over $5000,2021,2,8,0,6
D43,Theft Under $5000,2021,2,25,0,23
D43,Theft Under $5000,2021,73,397,0,324
D43,Theft Under $5000,2021,4,53,0,49
D43,Theft Under $5000,2021,16,175,0,159
D43,Theft Under $5000,2021,21,132,0,111
D43,Theft Under $5000,2021,53,295,0,242
D43,Theft Under $5000,2021,1,47,0,46
D43,Theft Under $5000,2021,0,48,0,48
D43,Theft Under $5000,2021,3,80,0,77
D43,Theft Under $5000,2021,0,4,0,4
D43,Theft Under $5000,2021,33,161,0,128
D43,Theft Under $5000,2021,46,377,0,331
D43,Theft Under $5000,2021,0,37,0,37
D43,Theft Under $5000,2021,32,213,0,181
D43,Assault,2021,24,32,0,8
D43,Assault,2021,39,79,0,40
D43,Assault,2021,21,35,0,14
D43,Assault,2021,29,49,0,20
D43,Assault,2021,53,91,0,38
D43,Assault,2021,96,157,0,61
D43,Assault,2021,19,33,0,14
D43,Assault,2021,17,32,0,15
D41,Other,2021,241,332,0,91
D42,Other,2021,9,25,0,16
D43,Break & Enter-Apartment,2021,2,9,0,7
D42,Break & Enter-Commercial,2021,2,3,0,1
D43,Assault,2021,10,16,0,6
D42,Other,2021,17,76,0,59
D41,Other,2021,10,11,0,1
D42,Other,2021,10,16,0,6
D43,Break & Enter-Apartment,2021,0,1,0,1
D43,Assault,2021,108,164,0,56
D42,Break & Enter-Commercial,2021,1,5,0,4
D42,Other,2021,2,2,1,0
D41,Other,2021,48,54,0,6
D42,Other,2021,15,27,0,12
D43,Break & Enter-Apartment,2021,6,14,0,8
D43,Attempt Murder,2021,0,2,0,2
D42,Break & Enter-Commercial,2021,13,72,0,59
D42,Other,2021,9,35,0,26
D41,Other,2021,93,107,0,14
D42,Other,2021,0,1,0,1
D43,Break & Enter-Apartment,2021,4,8,0,4
D43,Attempt Murder,2021,0,1,0,1
D42,Break & Enter-Commercial,2021,4,13,0,9
D42,Other,2021,9,76,0,67
D41,Other,2021,11,15,0,4
D42,Other,2021,6,8,0,2
D43,Break & Enter-Apartment,2021,5,7,0,2
D43,Other,2021,2,3,0,1
D42,Break & Enter-Commercial,2021,0,1,0,1
D42,Other,2021,7,30,0,23
D42,Other,2021,0,1,0,1
D42,Theft Over $5000,2021,0,2,0,2
D42,Theft Over $5000,2021,0,6,0,6
D42,Theft Over $5000,2021,0,4,0,4
D42,Theft Over $5000,2021,0,3,0,3
D42,Theft Over $5000,2021,0,2,0,2
D42,Theft Over $5000,2021,0,2,0,2
D42,Theft Over $5000,2021,2,8,0,6
D42,Theft Over $5000,2021,1,7,0,6
D42,Theft Over $5000,2021,0,1,0,1
D42,Theft Over $5000,2021,0,2,0,2
D42,Theft Over $5000,2021,0,5,0,5
D42,Theft Over $5000,2021,1,2,0,1
D42,Theft Under $5000,2021,11,170,0,159
D42,Theft Under $5000,2021,15,202,0,187
D42,Theft Under $5000,2021,2,33,0,31
D42,Theft Under $5000,2021,0,50,0,50
D42,Theft Under $5000,2021,15,160,0,145
D42,Theft Under $5000,2021,13,169,0,156
D42,Theft Under $5000,2021,15,111,0,96
D42,Theft Under $5000,2021,26,224,0,198
D42,Theft Under $5000,2021,20,203,0,183
D42,Theft Under $5000,2021,2,4,0,2
D42,Theft Under $5000,2021,5,61,0,56
D42,Theft Under $5000,2021,31,347,0,316
D42,Theft Under $5000,2021,4,59,0,55
D42,Assault,2021,38,58,0,20
D42,Assault,2021,85,129,0,44
D42,Assault,2021,48,72,0,24
D42,Assault,2021,0,4,0,4
D42,Assault,2021,56,91,0,35
D42,Assault,2021,70,127,0,57
D42,Assault,2021,54,77,0,23
D42,Assault,2021,31,53,0,22
D42,Assault,2021,52,79,0,27
D42,Assault,2021,4,8,0,4
D42,Assault,2021,32,50,0,18
D42,Assault,2021,72,104,0,32
D42,Assault,2021,28,42,0,14
D42,Attempt Murder,2021,3,3,1,0
D42,Attempt Murder,2021,0,1,0,1
D42,Attempt Murder,2021,0,1,0,1
D42,Attempt Murder,2021,0,1,0,1
D42,Other,2021,8,15,0,7
D41,Other,2021,83,98,0,15
D43,Break & Enter-Commercial,2021,0,4,0,4
D43,Break & Enter-Commercial,2021,0,3,0,3
D42,Break & Enter-Commercial,2021,4,5,0,1
D43,Other,2021,2,5,0,3
D42,Other,2021,10,19,0,9
D41,Other,2021,74,84,0,10
D42,Other,2021,3,6,0,3
D43,Other,2021,8,9,0,1
D43,Break & Enter-Commercial,2021,4,12,0,8
D42,Break & Enter-Commercial,2021,0,5,0,5
D41,Other Criminal Violations - Offensive Weapons,2021,1,2,0,1
D42,Robbery-Financial,2021,1,1,1,0
D43,Break & Enter-Commercial,2021,5,8,0,3
D42,Break & Enter-House,2021,2,10,0,8
D43,Other,2021,6,16,0,10
D41,Other Criminal Violations - Offensive Weapons,2021,4,4,1,0
D42,Robbery-Other,2021,3,7,0,4
D43,Break & Enter-Commercial,2021,1,7,0,6
D42,Break & Enter-House,2021,2,12,0,10
D43,Other,2021,9,16,0,7
D41,Other Criminal Violations - Offensive Weapons,2021,9,11,0,2
D42,Robbery-Other,2021,2,17,0,15
D43,Break & Enter-Commercial,2021,1,1,1,0
D42,Break & Enter-House,2021,2,5,0,3
D43,Other,2021,15,28,0,13
D41,Other Criminal Violations - Offensive Weapons,2021,24,26,0,2
D42,Robbery-Other,2021,0,6,0,6
D43,Break & Enter-Commercial,2021,0,3,0,3
D42,Break & Enter-House,2021,4,6,0,2
D43,Other,2021,5,11,0,6
D41,Other Criminal Violations - Offensive Weapons,2021,8,9,0,1
D42,Robbery-Other,2021,3,7,0,4
D43,Break & Enter-Commercial,2021,0,7,0,7
D42,Break & Enter-House,2021,7,11,0,4
D43,Other,2021,5,10,0,5
D41,Other Criminal Violations - Offensive Weapons,2021,2,3,0,1
D42,Robbery-Other,2021,15,20,0,5
D43,Break & Enter-Commercial,2021,17,44,0,27
D42,Break & Enter-House,2021,3,6,0,3
D43,Other,2021,9,15,0,6
D41,Other Criminal Violations - Offensive Weapons,2021,1,1,1,0
D42,Robbery-Other,2021,11,19,0,8
D43,Break & Enter-Commercial,2021,1,2,0,1
D42,Break & Enter-House,2021,0,10,0,10
D43,Other,2021,1,1,1,0
D42,Robbery-Other,2021,6,10,0,4
D43,Break & Enter-Commercial,2021,6,13,0,7
D42,Break & Enter-House,2021,1,9,0,8
D43,Other,2021,17,26,0,9
D42,Robbery-Other,2021,7,8,0,1
D43,Break & Enter-House,2021,1,1,1,0
D43,Other,2021,30,64,0,34
D42,Break & Enter-House,2021,0,1,0,1
D42,Robbery-Other,2021,1,5,0,4
D43,Break & Enter-House,2021,0,2,0,2
D43,Other,2021,0,2,0,2
D42,Break & Enter-House,2021,1,11,0,10
D41,Other Criminal Violations - Offensive Weapons,2021,10,13,0,3
D42,Robbery-Other,2021,6,10,0,4
D43,Break & Enter-House,2021,1,2,0,1
D43,Other,2021,14,29,0,15
D42,Break & Enter-House,2021,1,4,0,3
D41,Other Criminal Violations - Offensive Weapons,2021,8,10,0,2
D42,Robbery-Other,2021,0,4,0,4
D43,Break & Enter-House,2021,0,5,0,5
D43,Robbery-Other,2021,3,7,0,4
D42,Break & Enter-House,2021,0,10,0,10
D41,Other Criminal Violations - Offensive Weapons,2021,16,17,0,1
D42,Sexual Violation,2021,7,21,0,14
D43,Break & Enter-House,2021,1,5,0,4
D43,Robbery-Other,2021,15,32,0,17
D42,Break & Enter-Other,2021,0,1,0,1
D41,Other,2021,1,1,1,0
D42,Sexual Violation,2021,15,23,0,8
D43,Break & Enter-House,2021,4,12,0,8
D43,Robbery-Other,2021,3,4,0,1
D42,Break & Enter-Other,2021,0,2,0,2
D41,Other,2021,0,1,0,1
D42,Sexual Violation,2021,6,11,0,5
D43,Break & Enter-House,2021,1,3,0,2
D43,Robbery-Other,2021,2,5,0,3
D42,Break & Enter-Other,2021,0,2,0,2
D42,Other,2021,1,2,0,1
D42,Sexual Violation,2021,6,11,0,5
D43,Break & Enter-House,2021,2,5,0,3
D43,Robbery-Other,2021,7,7,1,0
D42,Break & Enter-Other,2021,0,4,0,4
D42,Other,2021,3,3,1,0
D42,Sexual Violation,2021,10,23,0,13
D42,Sexual Violation,2021,8,12,0,4
D42,Sexual Violation,2021,1,3,0,2
D42,Sexual Violation,2021,4,16,0,12
D42,Sexual Violation,2021,0,1,0,1
D42,Sexual Violation,2021,1,7,0,6
D42,Sexual Violation,2021,9,14,0,5
D42,Sexual Violation,2021,1,1,1,0
D42,Sexual Violation,2021,0,3,0,3
D42,Other,2021,7,7,1,0
D42,Other,2021,19,19,1,0
D42,Other,2021,6,7,0,1
D42,Other,2021,5,5,1,0
D42,Other,2021,14,16,0,2
D42,Other,2021,19,20,0,1
D42,Other,2021,10,10,1,0
D42,Other,2021,24,26,0,2
D42,Other,2021,5,5,1,0
D42,Other,2021,11,13,0,2
D42,Other,2021,8,10,0,2
D42,Other,2021,12,18,0,6
D42,Other,2021,71,87,0,16
D42,Other,2021,1,1,1,0
D43,Break & Enter-House,2021,3,5,0,2
D43,Break & Enter-House,2021,0,1,0,1
D42,Break & Enter-Other,2021,0,2,0,2
D43,Break & Enter-House,2021,5,11,0,6
D43,Break & Enter-House,2021,2,5,0,3
D42,Break & Enter-Other,2021,0,2,0,2
D43,Break & Enter-House,2021,0,5,0,5
D43,Robbery-Other,2021,17,21,0,4
D42,Break & Enter-Other,2021,2,3,0,1
D43,Break & Enter-Other,2021,0,4,0,4
D43,Robbery-Other,2021,2,4,0,2
D42,Break & Enter-Other,2021,1,1,1,0
D43,Break & Enter-Other,2021,1,2,0,1
D43,Robbery-Other,2021,1,3,0,2
D42,Fraud,2021,3,75,0,72
D43,Break & Enter-Other,2021,1,1,1,0
D43,Robbery-Other,2021,1,5,0,4
D42,Fraud,2021,8,104,0,96
D43,Break & Enter-Other,2021,0,1,0,1
D43,Robbery-Other,2021,0,1,0,1
D42,Fraud,2021,0,1,0,1
D43,Break & Enter-Other,2021,2,10,0,8
D43,Robbery-Other,2021,6,12,0,6
D43,Robbery-Other,2021,16,35,0,19
D43,Robbery-Other,2021,2,2,1,0
D43,Robbery-Other,2021,6,9,0,3
D43,Sexual Violation,2021,3,5,0,2
D43,Sexual Violation,2021,1,3,0,2
D43,Sexual Violation,2021,4,6,0,2
D43,Sexual Violation,2021,5,19,0,14
D43,Sexual Violation,2021,6,11,0,5
D43,Sexual Violation,2021,14,22,0,8
D43,Sexual Violation,2021,2,5,0,3
D43,Sexual Violation,2021,3,4,0,1
D43,Sexual Violation,2021,6,14,0,8
D43,Sexual Violation,2021,1,1,1,0
D43,Sexual Violation,2021,8,16,0,8
D43,Sexual Violation,2021,27,45,0,18
D43,Sexual Violation,2021,2,10,0,8
D43,Sexual Violation,2021,5,12,0,7
D43,Break & Enter-Other,2021,3,3,1,0
D43,Fraud,2021,5,23,0,18
D43,Fraud,2021,4,62,0,58
D43,Fraud,2021,0,28,0,28
D43,Fraud,2021,4,31,0,27
D43,Fraud,2021,7,50,0,43
D43,Fraud,2021,9,90,0,81
D43,Fraud,2021,0,19,0,19
D43,Fraud,2021,2,39,0,37
D43,Fraud,2021,7,39,0,32
D43,Fraud,2021,0,5,0,5
D43,Fraud,2021,1,46,0,45
D42,Fraud,2021,1,57,0,56
D42,Fraud,2021,6,51,0,45
D42,Fraud,2021,2,63,0,61
D42,Fraud,2021,3,59,0,56
D42,Fraud,2021,4,96,0,92
D42,Fraud,2021,7,69,0,62
D42,Fraud,2021,0,6,0,6
D42,Fraud,2021,3,51,0,48
D42,Fraud,2021,3,82,0,79
D42,Fraud,2021,3,18,0,15
D42,Other,2021,7,43,0,36
D42,Other,2021,15,97,0,82
D42,Other,2021,12,36,0,24
D42,Other,2021,16,72,0,56
D42,Other,2021,26,104,0,78
D42,Other,2021,11,42,0,31
D42,Other,2021,2,2,1,0
D42,Other,2021,1,2,0,1
D42,Other,2021,1,1,1,0
D42,Other,2021,4,4,1,0
D42,Other,2021,1,1,1,0
D42,Other,2021,1,1,1,0
D42,Other,2021,3,4,0,1
D42,Other,2021,3,3,1,0
D42,Auto Theft,2021,2,52,0,50
D42,Auto Theft,2021,9,39,0,30
D42,Auto Theft,2021,0,19,0,19
D42,Auto Theft,2021,2,18,0,16
D42,Auto Theft,2021,1,43,0,42
D42,Auto Theft,2021,0,22,0,22
D42,Auto Theft,2021,1,81,0,80
D42,Auto Theft,2021,5,76,0,71
D42,Auto Theft,2021,2,45,0,43
D42,Auto Theft,2021,2,59,0,57
D42,Auto Theft,2021,4,29,0,25
D42,Break & Enter-Apartment,2021,2,5,0,3
D42,Break & Enter-Apartment,2021,2,12,0,10
D42,Break & Enter-Apartment,2021,1,4,0,3
D42,Break & Enter-Apartment,2021,1,8,0,7
D42,Break & Enter-Apartment,2021,0,2,0,2
D42,Break & Enter-Apartment,2021,0,2,0,2
D42,Break & Enter-Apartment,2021,1,5,0,4
D42,Break & Enter-Apartment,2021,1,5,0,4
D42,Break & Enter-Apartment,2021,0,5,0,5
D51,Robbery-Financial,2021,2,2,1,0
D51,Robbery-Other,2021,5,11,0,6
D51,Robbery-Other,2021,14,30,0,16
D51,Robbery-Other,2021,40,63,0,23
D51,Robbery-Other,2021,44,76,0,32
D51,Robbery-Other,2021,1,1,1,0
D51,Robbery-Other,2021,10,14,0,4
D51,Robbery-Other,2021,10,14,0,4
D51,Robbery-Other,2021,4,4,1,0
D51,Robbery-Other,2021,17,25,0,8
D51,Sexual Violation,2021,2,10,0,8
D51,Sexual Violation,2021,17,40,0,23
D51,Sexual Violation,2021,11,36,0,25
D51,Sexual Violation,2021,24,60,0,36
D51,Sexual Violation,2021,1,4,0,3
D51,Sexual Violation,2021,6,20,0,14
D51,Sexual Violation,2021,4,15,0,11
D51,Fraud,2021,5,92,0,87
D51,Sexual Violation,2021,7,18,0,11
D51,Other,2021,1,1,1,0
D52,Fraud,2021,9,62,0,53
D52,Other,2021,5,10,0,5
D51,Other,2021,12,14,0,2
D51,Other,2021,6,7,0,1
D51,Other,2021,15,17,0,2
D51,Other,2021,34,37,0,3
D51,Other,2021,1,1,1,0
D51,Other,2021,11,11,1,0
D51,Other,2021,11,13,0,2
D51,Other,2021,9,9,1,0
D51,Other,2021,26,30,0,4
D51,Other,2021,0,1,0,1
D51,Other,2021,49,55,0,6
D51,Other,2021,148,171,0,23
D51,Other,2021,234,259,0,25
D51,Other,2021,1,1,1,0
D51,Other,2021,571,606,0,35
D51,Other,2021,4,4,1,0
D51,Other,2021,121,145,0,24
D51,Other,2021,134,157,0,23
D51,Other,2021,3,3,1,0
D51,Other,2021,110,128,0,18
D51,Other,2021,1,1,1,0
D51,Other Criminal Violations - Offensive Weapons,2021,10,14,0,4
D51,Other Criminal Violations - Offensive Weapons,2021,26,34,0,8
D51,Other Criminal Violations - Offensive Weapons,2021,43,53,0,10
D51,Other Criminal Violations - Offensive Weapons,2021,70,80,0,10
D51,Other Criminal Violations - Offensive Weapons,2021,15,20,0,5
D51,Other Criminal Violations - Offensive Weapons,2021,14,15,0,1
D51,Other Criminal Violations - Offensive Weapons,2021,1,1,1,0
D51,Other Criminal Violations - Offensive Weapons,2021,25,32,0,7
D51,Other,2021,1,1,1,0
D51,Other,2021,1,2,0,1
D51,Other,2021,2,3,0,1
D51,Other,2021,18,23,0,5
D52,Other,2021,17,23,0,6
D51,Other,2021,24,98,0,74
D51,Other,2021,0,1,0,1
D52,Other,2021,1,1,1,0
D52,Fraud,2021,0,1,0,1
D51,Other,2021,12,14,0,2
D52,Other,2021,5,18,0,13
D51,Other,2021,86,250,0,164
D51,Other,2021,0,1,0,1
D52,Other,2021,0,2,0,2
D52,Fraud,2021,1,26,0,25
D51,Other,2021,3,3,1,0
D51,Other,2021,9,11,0,2
D51,Auto Theft,2021,2,5,0,3
D51,Auto Theft,2021,7,31,0,24
D51,Auto Theft,2021,10,44,0,34
D51,Auto Theft,2021,11,50,0,39
D51,Auto Theft,2021,0,1,0,1
D51,Auto Theft,2021,4,20,0,16
D51,Auto Theft,2021,3,9,0,6
D51,Auto Theft,2021,2,27,0,25
D51,Break & Enter-Apartment,2021,7,29,0,22
D51,Break & Enter-Apartment,2021,25,50,0,25
D51,Break & Enter-Apartment,2021,17,48,0,31
D51,Break & Enter-Apartment,2021,33,73,0,40
D51,Break & Enter-Apartment,2021,13,34,0,21
D51,Break & Enter-Apartment,2021,10,18,0,8
D51,Break & Enter-Apartment,2021,13,52,0,39
D51,Break & Enter-Commercial,2021,2,16,0,14
D51,Break & Enter-Commercial,2021,10,30,0,20
D51,Break & Enter-Commercial,2021,25,100,0,75
D51,Break & Enter-Commercial,2021,11,54,0,43
D51,Break & Enter-Commercial,2021,2,7,0,5
D51,Break & Enter-Commercial,2021,2,8,0,6
D51,Break & Enter-Commercial,2021,2,9,0,7
D51,Break & Enter-Commercial,2021,14,55,0,41
D51,Break & Enter-House,2021,5,15,0,10
D51,Break & Enter-House,2021,2,4,0,2
D51,Break & Enter-House,2021,0,2,0,2
D51,Break & Enter-House,2021,3,14,0,11
D51,Break & Enter-House,2021,1,1,1,0
D51,Break & Enter-House,2021,2,4,0,2
D51,Break & Enter-House,2021,1,2,0,1
D51,Break & Enter-Other,2021,3,10,0,7
D51,Break & Enter-Other,2021,3,5,0,2
D51,Break & Enter-Other,2021,6,14,0,8
D51,Break & Enter-Other,2021,1,15,0,14
D51,Break & Enter-Other,2021,2,3,0,1
D51,Break & Enter-Other,2021,1,3,0,2
D51,Break & Enter-Other,2021,0,1,0,1
D51,Break & Enter-Other,2021,1,7,0,6
D51,Fraud,2021,3,56,0,53
D51,Fraud,2021,10,134,0,124
D51,Fraud,2021,12,136,0,124
D51,Fraud,2021,9,106,0,97
D51,Fraud,2021,0,3,0,3
D51,Fraud,2021,4,53,0,49
D51,Fraud,2021,1,49,0,48
D51,Fraud,2021,0,5,0,5
D51,Other,2021,107,350,0,243
D52,Other,2021,7,9,0,2
D52,Other,2021,3,3,1,0
D52,Other,2021,8,9,0,1
D52,Other,2021,1,1,1,0
D52,Other,2021,7,7,1,0
D52,Other,2021,3,4,0,1
D52,Fraud,2021,11,118,0,107
D51,Other,2021,166,426,0,260
D52,Other,2021,0,1,0,1
D52,Other,2021,18,40,0,22
D52,Other,2021,7,7,1,0
D52,Fraud,2021,27,219,0,192
D51,Other,2021,1,8,0,7
D52,Other,2021,1,1,1,0
D52,Other,2021,37,58,0,21
D52,Other,2021,2,2,1,0
D52,Other,2021,30,107,0,77
D51,Other,2021,49,159,0,110
D53,Other,2021,9,9,1,0
D52,Robbery-Financial,2021,1,1,1,0
D52,Other,2021,12,13,0,1
D52,Other,2021,1,6,0,5
D51,Other,2021,45,117,0,72
D53,Other,2021,1,1,1,0
D52,Robbery-Other,2021,9,14,0,5
D52,Other,2021,11,12,0,1
D52,Other,2021,14,39,0,25
D51,Other,2021,1,4,0,3
D53,Other,2021,1,1,1,0
D52,Robbery-Other,2021,9,17,0,8
D52,Auto Theft,2021,1,23,0,22
D52,Other,2021,20,79,0,59
D51,Other,2021,56,169,0,113
D53,Other,2021,1,1,1,0
D52,Robbery-Other,2021,5,15,0,10
D52,Auto Theft,2021,0,3,0,3
D52,Other,2021,43,149,0,106
D51,Theft Over $5000,2021,1,7,0,6
D53,Other,2021,1,1,1,0
D52,Robbery-Other,2021,6,9,0,3
D52,Auto Theft,2021,1,1,1,0
D52,Other,2021,0,8,0,8
D51,Theft Over $5000,2021,2,21,0,19
D53,Other,2021,1,1,1,0
D53,Other,2021,12,12,1,0
D53,Other,2021,9,9,1,0
D53,Other,2021,5,5,1,0
D53,Other,2021,4,5,0,1
D53,Other,2021,1,1,1,0
D53,Auto Theft,2021,0,22,0,22
D53,Auto Theft,2021,0,23,0,23
D53,Auto Theft,2021,0,27,0,27
D53,Auto Theft,2021,0,19,0,19
D53,Auto Theft,2021,0,16,0,16
D53,Auto Theft,2021,0,35,0,35
D53,Auto Theft,2021,0,62,0,62
D53,Auto Theft,2021,2,87,0,85
D53,Auto Theft,2021,1,38,0,37
D53,Auto Theft,2021,0,1,0,1
D53,Auto Theft,2021,0,15,0,15
D53,Auto Theft,2021,4,73,0,69
D53,Auto Theft,2021,0,16,0,16
D53,Auto Theft,2021,1,17,0,16
D53,Auto Theft,2021,2,29,0,27
D53,Auto Theft,2021,2,13,0,11
D53,Break & Enter-Apartment,2021,9,34,0,25
D53,Break & Enter-Apartment,2021,0,2,0,2
D53,Break & Enter-Apartment,2021,2,10,0,8
D53,Break & Enter-Apartment,2021,1,3,0,2
D53,Break & Enter-Apartment,2021,2,3,0,1
D53,Break & Enter-Apartment,2021,2,5,0,3
D53,Break & Enter-Apartment,2021,2,7,0,5
D53,Break & Enter-Apartment,2021,1,4,0,3
D53,Break & Enter-Apartment,2021,6,29,0,23
D53,Break & Enter-Apartment,2021,2,19,0,17
D53,Break & Enter-Apartment,2021,3,21,0,18
D53,Break & Enter-Apartment,2021,4,16,0,12
D53,Break & Enter-Apartment,2021,2,8,0,6
D53,Break & Enter-Apartment,2021,2,12,0,10
D53,Break & Enter-Commercial,2021,12,59,0,47
D53,Break & Enter-Commercial,2021,0,4,0,4
D53,Break & Enter-Commercial,2021,0,1,0,1
D52,Robbery-Other,2021,1,6,0,5
D52,Auto Theft,2021,0,9,0,9
D52,Other,2021,16,256,0,240
D52,Robbery-Other,2021,0,3,0,3
D51,Theft Over $5000,2021,7,25,0,18
D52,Auto Theft,2021,0,10,0,10
D52,Other,2021,6,70,0,64
D52,Robbery-Other,2021,4,8,0,4
D52,Other,2021,33,125,0,92
D52,Auto Theft,2021,2,4,0,2
D52,Robbery-Other,2021,15,38,0,23
D51,Theft Over $5000,2021,3,16,0,13
D52,Other,2021,67,393,0,326
D52,Auto Theft,2021,1,2,0,1
D52,Sexual Violation,2021,9,26,0,17
D51,Theft Over $5000,2021,2,3,0,1
D52,Theft Over $5000,2021,2,11,0,9
D52,Auto Theft,2021,1,32,0,31
D52,Sexual Violation,2021,0,6,0,6
D51,Theft Over $5000,2021,1,6,0,5
D52,Theft Over $5000,2021,0,1,0,1
D52,Auto Theft,2021,3,18,0,15
D52,Sexual Violation,2021,3,13,0,10
D51,Theft Over $5000,2021,0,2,0,2
D52,Theft Over $5000,2021,1,3,0,2
D52,Break & Enter-Apartment,2021,4,15,0,11
D52,Sexual Violation,2021,8,23,0,15
D52,Sexual Violation,2021,2,3,0,1
D52,Sexual Violation,2021,7,12,0,5
D52,Sexual Violation,2021,3,5,0,2
D52,Sexual Violation,2021,10,19,0,9
D52,Sexual Violation,2021,17,51,0,34
D52,Other,2021,5,5,1,0
D52,Other,2021,1,1,1,0
D52,Other,2021,3,3,1,0
D52,Other,2021,18,19,0,1
D52,Other,2021,8,9,0,1
D52,Other,2021,2,2,1,0
D52,Other,2021,12,14,0,2
D52,Other,2021,3,3,1,0
D52,Other,2021,15,15,1,0
D52,Other,2021,20,22,0,2
D52,Other,2021,87,1267,0,1180
D52,Other,2021,5,5,1,0
D52,Other,2021,42,47,0,5
D52,Other,2021,21,28,0,7
D52,Other,2021,112,130,0,18
D52,Other,2021,5,6,0,1
D52,Other,2021,51,59,0,8
D52,Other,2021,10,13,0,3
D52,Other,2021,40,53,0,13
D52,Other,2021,387,415,0,28
D52,Other Criminal Violations - Offensive Weapons,2021,7,10,0,3
D52,Other Criminal Violations - Offensive Weapons,2021,7,7,1,0
D52,Other Criminal Violations - Offensive Weapons,2021,16,20,0,4
D52,Other Criminal Violations - Offensive Weapons,2021,13,14,0,1
D52,Other Criminal Violations - Offensive Weapons,2021,12,12,1,0
D52,Other Criminal Violations - Offensive Weapons,2021,5,5,1,0
D52,Other Criminal Violations - Offensive Weapons,2021,13,15,0,2
D52,Other Criminal Violations - Offensive Weapons,2021,31,36,0,5
D52,Theft Over $5000,2021,1,13,0,12
D52,Break & Enter-Apartment,2021,3,10,0,7
D52,Theft Over $5000,2021,1,9,0,8
D52,Break & Enter-Apartment,2021,5,28,0,23
D52,Break & Enter-Apartment,2021,2,13,0,11
D52,Theft Over $5000,2021,0,1,0,1
D52,Break & Enter-Apartment,2021,1,2,0,1
D52,Theft Over $5000,2021,1,11,0,10
D52,Break & Enter-Apartment,2021,3,19,0,16
D52,Theft Over $5000,2021,8,26,0,18
D52,Break & Enter-Apartment,2021,2,12,0,10
D52,Theft Under $5000,2021,24,247,0,223
D52,Break & Enter-Commercial,2021,11,19,0,8
D52,Theft Under $5000,2021,2,2,1,0
D52,Theft Under $5000,2021,5,34,0,29
D52,Break & Enter-Commercial,2021,4,14,0,10
D52,Theft Under $5000,2021,8,146,0,138
D52,Break & Enter-Commercial,2021,5,15,0,10
D52,Theft Under $5000,2021,23,415,0,392
D52,Break & Enter-Commercial,2021,0,1,0,1
D52,Theft Under $5000,2021,1,9,0,8
D52,Break & Enter-Commercial,2021,8,15,0,7
D52,Theft Under $5000,2021,11,139,0,128
D52,Break & Enter-Commercial,2021,15,60,0,45
D52,Theft Under $5000,2021,2,93,0,91
D52,Break & Enter-Commercial,2021,32,90,0,58
D52,Theft Under $5000,2021,21,312,0,291
D52,Theft Under $5000,2021,210,1104,0,894
D52,Break & Enter-House,2021,2,6,0,4
D52,Assault,2021,98,131,0,33
D52,Break & Enter-House,2021,0,1,0,1
D52,Assault,2021,3,7,0,4
D52,Break & Enter-Other,2021,0,4,0,4
D52,Assault,2021,43,77,0,34
D52,Break & Enter-Other,2021,1,2,0,1
D52,Assault,2021,73,117,0,44
D52,Break & Enter-Other,2021,0,1,0,1
D52,Assault,2021,88,152,0,64
D52,Break & Enter-Other,2021,7,11,0,4
D52,Assault,2021,3,3,1,0
D52,Break & Enter-Other,2021,2,8,0,6
D52,Assault,2021,67,109,0,42
D52,Break & Enter-Other,2021,3,7,0,4
D52,Assault,2021,7,31,0,24
D52,Break & Enter-Other,2021,0,2,0,2
D52,Assault,2021,122,182,0,60
D52,Break & Enter-Other,2021,2,10,0,8
D52,Assault,2021,182,289,0,107
D52,Fraud,2021,26,148,0,122
D52,Attempt Murder,2021,1,1,1,0
D52,Fraud,2021,0,4,0,4
D52,Attempt Murder,2021,2,2,1,0
D52,Fraud,2021,0,8,0,8
D52,Other,2021,16,24,0,8
D52,Fraud,2021,8,85,0,77
D52,Other,2021,3,3,1,0
D52,Fraud,2021,8,96,0,88
D52,Other,2021,3,14,0,11
D52,Other,2021,21,31,0,10
D52,Other,2021,10,27,0,17
D51,Theft Over $5000,2021,1,14,0,13
D51,Theft Under $5000,2021,0,1,0,1
D51,Theft Under $5000,2021,42,437,0,395
D51,Theft Under $5000,2021,111,999,0,888
D51,Theft Under $5000,2021,0,1,0,1
D51,Theft Under $5000,2021,0,1,0,1
D51,Theft Under $5000,2021,140,1074,0,934
D51,Theft Under $5000,2021,76,619,0,543
D51,Theft Under $5000,2021,0,14,0,14
D51,Theft Under $5000,2021,57,306,0,249
D51,Theft Under $5000,2021,43,150,0,107
D51,Theft Under $5000,2021,0,85,0,85
D51,Theft Under $5000,2021,82,486,0,404
D51,Assault,2021,64,121,0,57
D51,Assault,2021,196,350,0,154
D51,Assault,2021,267,457,0,190
D51,Assault,2021,345,553,0,208
D51,Assault,2021,2,2,1,0
D51,Assault,2021,133,233,0,100
D51,Assault,2021,100,159,0,59
D51,Assault,2021,9,21,0,12
D51,Assault,2021,142,214,0,72
D51,Attempt Murder,2021,1,1,1,0
D51,Attempt Murder,2021,1,1,1,0
D51,Attempt Murder,2021,1,1,1,0
D51,Other,2021,10,18,0,8
D51,Other,2021,33,60,0,27
D51,Other,2021,25,54,0,29
D51,Other,2021,56,94,0,38
D51,Other,2021,16,28,0,12
D51,Other,2021,16,29,0,13
D51,Other,2021,0,1,0,1
D51,Other,2021,15,33,0,18
D43,Other,2021,2,4,0,2
D43,Other,2021,5,5,1,0
D43,Other,2021,3,3,1,0
D43,Other,2021,5,5,1,0
D43,Other,2021,6,7,0,1
D43,Other,2021,13,15,0,2
D43,Other,2021,5,6,0,1
D43,Other,2021,8,8,1,0
D43,Other,2021,10,12,0,2
D43,Other,2021,4,4,1,0
D43,Other,2021,9,9,1,0
D43,Other,2021,26,32,0,6
D43,Other,2021,3,3,1,0
D43,Other,2021,18,21,0,3
D43,Other,2021,14,18,0,4
D43,Other,2021,17,26,0,9
D43,Other,2021,16,19,0,3
D43,Other,2021,2,2,1,0
D43,Other,2021,20,28,0,8
D43,Other,2021,44,52,0,8
D43,Other,2021,52,68,0,16
D43,Other,2021,10,14,0,4
D43,Other,2021,12,18,0,6
D43,Other,2021,35,45,0,10
D43,Other,2021,6,8,0,2
D43,Other,2021,58,75,0,17
D43,Other,2021,306,357,0,51
D43,Other,2021,13,17,0,4
D43,Other,2021,69,83,0,14
D43,Other Criminal Violations - Offensive Weapons,2021,1,1,1,0
D43,Other Criminal Violations - Offensive Weapons,2021,7,8,0,1
D43,Other Criminal Violations - Offensive Weapons,2021,3,3,1,0
D43,Other Criminal Violations - Offensive Weapons,2021,1,2,0,1
D43,Other Criminal Violations - Offensive Weapons,2021,2,2,1,0
D43,Other Criminal Violations - Offensive Weapons,2021,9,10,0,1
D43,Other Criminal Violations - Offensive Weapons,2021,0,1,0,1
D43,Other Criminal Violations - Offensive Weapons,2021,6,6,1,0
D43,Other Criminal Violations - Offensive Weapons,2021,3,5,0,2
D43,Other Criminal Violations - Offensive Weapons,2021,8,10,0,2
D43,Other Criminal Violations - Offensive Weapons,2021,26,29,0,3
D43,Other Criminal Violations - Offensive Weapons,2021,0,1,0,1
D43,Other Criminal Violations - Offensive Weapons,2021,12,12,1,0
D43,Other,2021,0,1,0,1
D43,Other,2021,1,1,1,0
D43,Other,2021,0,1,0,1
D43,Other,2021,1,1,1,0
D51,Other,2021,8,8,1,0
D51,Other,2021,18,19,0,1
D51,Other,2021,34,34,1,0
D51,Other,2021,85,97,0,12
D55,Other,2021,7,68,0,61
D53,Fraud,2021,6,51,0,45
D55,Other,2021,15,73,0,58
D53,Fraud,2021,3,56,0,53
D55,Auto Theft,2021,1,15,0,14
D55,Other,2021,0,1,0,1
D53,Fraud,2021,8,77,0,69
D55,Auto Theft,2021,2,44,0,42
D55,Other,2021,8,22,0,14
D53,Fraud,2021,1,71,0,70
D53,Other,2021,9,12,0,3
D55,Auto Theft,2021,0,19,0,19
D55,Other,2021,13,54,0,41
D53,Fraud,2021,9,70,0,61
D55,Break & Enter-House,2021,4,13,0,9
D55,Auto Theft,2021,1,6,0,5
D55,Other,2021,51,210,0,159
D53,Other,2021,12,17,0,5
D53,Fraud,2021,0,1,0,1
D55,Auto Theft,2021,7,48,0,41
D55,Break & Enter-House,2021,2,11,0,9
D55,Other,2021,26,108,0,82
D53,Other,2021,12,14,0,2
D55,Auto Theft,2021,2,20,0,18
D53,Fraud,2021,3,32,0,29
D53,Theft Under $5000,2021,5,170,0,165
D55,Break & Enter-House,2021,1,3,0,2
D53,Robbery-Other,2021,4,8,0,4
D55,Other,2021,17,98,0,81
D53,Theft Under $5000,2021,0,5,0,5
D53,Other,2021,45,52,0,7
D55,Auto Theft,2021,0,32,0,32
D53,Fraud,2021,6,39,0,33
D55,Break & Enter-House,2021,3,11,0,8
D53,Robbery-Other,2021,7,21,0,14
D55,Other,2021,7,34,0,27
D53,Theft Under $5000,2021,3,110,0,107
D53,Other,2021,55,68,0,13
D55,Auto Theft,2021,0,10,0,10
D53,Other,2021,38,176,0,138
D55,Break & Enter-House,2021,8,26,0,18
D53,Robbery-Other,2021,3,5,0,2
D55,Other,2021,16,64,0,48
D53,Theft Under $5000,2021,51,360,0,309
D53,Other,2021,36,48,0,12
D55,Auto Theft,2021,0,13,0,13
D53,Other,2021,2,2,1,0
D55,Break & Enter-House,2021,2,4,0,2
D55,Break & Enter-House,2021,5,15,0,10
D55,Break & Enter-House,2021,1,1,1,0
D55,Break & Enter-House,2021,4,12,0,8
D55,Break & Enter-House,2021,0,10,0,10
D55,Break & Enter-Other,2021,0,2,0,2
D55,Break & Enter-Other,2021,1,1,1,0
D55,Break & Enter-Other,2021,2,8,0,6
D55,Break & Enter-Other,2021,0,2,0,2
D55,Break & Enter-Other,2021,2,5,0,3
D55,Break & Enter-Other,2021,0,3,0,3
D55,Break & Enter-Other,2021,0,1,0,1
D55,Break & Enter-Other,2021,0,2,0,2
D55,Break & Enter-Other,2021,0,5,0,5
D55,Break & Enter-Other,2021,4,17,0,13
D55,Break & Enter-Other,2021,1,1,1,0
D55,Break & Enter-Other,2021,0,2,0,2
D55,Break & Enter-Other,2021,3,5,0,2
D55,Fraud,2021,3,27,0,24
D55,Fraud,2021,6,33,0,27
D55,Fraud,2021,2,36,0,34
D55,Fraud,2021,5,36,0,31
D55,Fraud,2021,5,74,0,69
D55,Fraud,2021,3,70,0,67
D55,Fraud,2021,4,30,0,26
D55,Fraud,2021,1,6,0,5
D55,Fraud,2021,5,41,0,36
D55,Fraud,2021,5,70,0,65
D55,Fraud,2021,4,30,0,26
D55,Fraud,2021,1,29,0,28
D55,Fraud,2021,5,119,0,114
D55,Fraud,2021,3,48,0,45
D55,Fraud,2021,7,58,0,51
D55,Fraud,2021,3,21,0,18
D55,Fraud,2021,3,42,0,39
D55,Fraud,2021,2,16,0,14
D55,Other,2021,15,64,0,49
D55,Other,2021,7,36,0,29
D55,Other,2021,1,2,0,1
D55,Other,2021,24,99,0,75
D55,Other,2021,11,45,0,34
D55,Other,2021,41,149,0,108
D55,Other,2021,14,57,0,43
D55,Other,2021,32,106,0,74
D55,Other,2021,0,9,0,9
D53,Theft Under $5000,2021,26,447,0,421
D55,Other,2021,6,23,0,17
D53,Other,2021,43,47,0,4
D55,Auto Theft,2021,0,9,0,9
D53,Other,2021,0,10,0,10
D53,Theft Under $5000,2021,43,281,0,238
D53,Robbery-Other,2021,5,11,0,6
D55,Theft Over $5000,2021,1,2,0,1
D53,Other,2021,2,2,1,0
D55,Break & Enter-Apartment,2021,1,3,0,2
D53,Other,2021,0,4,0,4
D53,Robbery-Other,2021,1,2,0,1
D55,Theft Over $5000,2021,0,1,0,1
D53,Theft Under $5000,2021,0,3,0,3
D53,Other,2021,39,45,0,6
D55,Break & Enter-Apartment,2021,2,8,0,6
D53,Other,2021,4,18,0,14
D53,Robbery-Other,2021,2,3,0,1
D55,Theft Over $5000,2021,0,5,0,5
D53,Theft Under $5000,2021,12,338,0,326
D53,Other,2021,12,13,0,1
D55,Break & Enter-Apartment,2021,2,3,0,1
D53,Other,2021,1,4,0,3
D53,Sexual Violation,2021,12,27,0,15
D55,Theft Over $5000,2021,0,4,0,4
D53,Theft Under $5000,2021,9,195,0,186
D53,Other Criminal Violations - Offensive Weapons,2021,12,13,0,1
D55,Break & Enter-Apartment,2021,2,4,0,2
D53,Other,2021,1,13,0,12
D53,Other,2021,3,8,0,5
D53,Other,2021,5,36,0,31
D53,Other,2021,4,41,0,37
D53,Other,2021,8,57,0,49
D53,Other,2021,1,6,0,5
D53,Other,2021,10,37,0,27
D53,Other,2021,27,133,0,106
D53,Other,2021,22,70,0,48
D53,Other,2021,14,61,0,47
D53,Other,2021,2,3,0,1
D53,Other,2021,17,79,0,62
D53,Other,2021,6,43,0,37
D53,Theft Over $5000,2021,3,30,0,27
D53,Theft Over $5000,2021,0,1,0,1
D53,Theft Over $5000,2021,0,2,0,2
D53,Theft Over $5000,2021,0,1,0,1
D53,Theft Over $5000,2021,0,1,0,1
D53,Theft Over $5000,2021,0,3,0,3
D53,Theft Over $5000,2021,0,3,0,3
D53,Theft Over $5000,2021,0,3,0,3
D53,Theft Over $5000,2021,0,2,0,2
D53,Theft Over $5000,2021,2,8,0,6
D53,Theft Over $5000,2021,0,6,0,6
D53,Theft Over $5000,2021,0,2,0,2
D53,Theft Over $5000,2021,1,3,0,2
D53,Theft Under $5000,2021,44,771,0,727
D53,Theft Under $5000,2021,1,2,0,1
D53,Theft Under $5000,2021,0,21,0,21
D53,Theft Under $5000,2021,1,16,0,15
D53,Theft Under $5000,2021,1,31,0,30
D53,Theft Under $5000,2021,1,3,0,2
D53,Theft Under $5000,2021,0,27,0,27
D53,Theft Under $5000,2021,0,10,0,10
D53,Theft Under $5000,2021,4,69,0,65
D53,Theft Under $5000,2021,1,83,0,82
D53,Assault,2021,83,166,0,83
D55,Theft Over $5000,2021,1,8,0,7
D53,Other Criminal Violations - Offensive Weapons,2021,2,2,1,0
D55,Break & Enter-Apartment,2021,4,20,0,16
D53,Assault,2021,0,3,0,3
D53,Sexual Violation,2021,0,1,0,1
D55,Theft Over $5000,2021,0,1,0,1
D53,Other Criminal Violations - Offensive Weapons,2021,2,2,1,0
D55,Break & Enter-Apartment,2021,0,8,0,8
D55,Break & Enter-Apartment,2021,0,7,0,7
D55,Break & Enter-Apartment,2021,0,1,0,1
D55,Break & Enter-Apartment,2021,0,1,0,1
D55,Break & Enter-Apartment,2021,6,14,0,8
D55,Break & Enter-Apartment,2021,1,3,0,2
D55,Break & Enter-Apartment,2021,2,7,0,5
D55,Break & Enter-Apartment,2021,8,30,0,22
D55,Break & Enter-Apartment,2021,2,6,0,4
D55,Break & Enter-Apartment,2021,1,6,0,5
D55,Break & Enter-Apartment,2021,4,12,0,8
D55,Break & Enter-Apartment,2021,2,6,0,4
D55,Break & Enter-Apartment,2021,0,1,0,1
D55,Break & Enter-Commercial,2021,9,17,0,8
D55,Break & Enter-Commercial,2021,3,7,0,4
D55,Break & Enter-Commercial,2021,6,18,0,12
D55,Break & Enter-Commercial,2021,2,5,0,3
D55,Break & Enter-Commercial,2021,5,22,0,17
D55,Break & Enter-Commercial,2021,0,2,0,2
D55,Break & Enter-Commercial,2021,4,17,0,13
D55,Break & Enter-Commercial,2021,4,16,0,12
D55,Break & Enter-Commercial,2021,5,15,0,10
D55,Break & Enter-Commercial,2021,5,18,0,13
D55,Break & Enter-Commercial,2021,19,57,0,38
D55,Break & Enter-Commercial,2021,2,6,0,4
D55,Break & Enter-Commercial,2021,0,17,0,17
D55,Break & Enter-Commercial,2021,1,9,0,8
D55,Break & Enter-Commercial,2021,4,9,0,5
D55,Break & Enter-House,2021,1,1,1,0
D55,Break & Enter-House,2021,1,6,0,5
D55,Break & Enter-House,2021,1,2,0,1
D55,Break & Enter-House,2021,8,22,0,14
D55,Break & Enter-House,2021,3,12,0,9
D55,Break & Enter-House,2021,7,21,0,14
D55,Break & Enter-House,2021,3,12,0,9
D53,Sexual Violation,2021,0,2,0,2
D53,Other Criminal Violations - Offensive Weapons,2021,1,2,0,1
D55,Theft Over $5000,2021,2,6,0,4
D53,Sexual Violation,2021,1,3,0,2
D53,Assault,2021,3,3,1,0
D55,Theft Over $5000,2021,0,2,0,2
D53,Other Criminal Violations - Offensive Weapons,2021,3,4,0,1
D55,Theft Over $5000,2021,0,1,0,1
D53,Sexual Violation,2021,3,4,0,1
D53,Assault,2021,6,16,0,10
D53,Other Criminal Violations - Offensive Weapons,2021,2,2,1,0
D53,Assault,2021,11,13,0,2
D55,Theft Over $5000,2021,0,3,0,3
D53,Sexual Violation,2021,0,1,0,1
D53,Other Criminal Violations - Offensive Weapons,2021,0,1,0,1
D53,Assault,2021,3,7,0,4
D55,Theft Over $5000,2021,2,5,0,3
D53,Sexual Violation,2021,7,14,0,7
D53,Other Criminal Violations - Offensive Weapons,2021,1,1,1,0
D53,Assault,2021,19,24,0,5
D55,Theft Over $5000,2021,0,1,0,1
D53,Sexual Violation,2021,2,4,0,2
D53,Other Criminal Violations - Offensive Weapons,2021,5,5,1,0
D53,Assault,2021,2,3,0,1
D55,Theft Over $5000,2021,1,19,0,18
D53,Sexual Violation,2021,4,14,0,10
D53,Other Criminal Violations - Offensive Weapons,2021,16,17,0,1
D53,Assault,2021,15,27,0,12
D55,Theft Over $5000,2021,2,10,0,8
D53,Sexual Violation,2021,0,4,0,4
D53,Other Criminal Violations - Offensive Weapons,2021,3,3,1,0
D53,Assault,2021,28,40,0,12
D55,Theft Over $5000,2021,1,9,0,8
D53,Sexual Violation,2021,7,14,0,7
D53,Other Criminal Violations - Offensive Weapons,2021,9,11,0,2
D53,Assault,2021,21,41,0,20
D55,Theft Over $5000,2021,0,2,0,2
D53,Sexual Violation,2021,5,14,0,9
D53,Other Criminal Violations - Offensive Weapons,2021,5,5,1,0
D53,Assault,2021,0,2,0,2
D55,Theft Over $5000,2021,1,2,0,1
D53,Sexual Violation,2021,4,13,0,9
D53,Other Criminal Violations - Offensive Weapons,2021,2,2,1,0
D53,Assault,2021,56,86,0,30
D55,Theft Under $5000,2021,57,320,0,263
D53,Sexual Violation,2021,6,9,0,3
D53,Sexual Violation,2021,4,10,0,6
D53,Sexual Violation,2021,6,11,0,5
D53,Other,2021,8,11,0,3
D53,Other,2021,2,2,1,0
D53,Other,2021,3,3,1,0
D53,Other,2021,1,1,1,0
D53,Other,2021,1,1,1,0
D53,Other,2021,6,6,1,0
D53,Other,2021,2,3,0,1
D53,Other,2021,3,3,1,0
D53,Other,2021,3,3,1,0
D53,Other,2021,5,5,1,0
D53,Other,2021,3,4,0,1
D53,Other,2021,8,8,1,0
D53,Other,2021,1,1,1,0
D53,Other,2021,2,2,1,0
D53,Other,2021,14,15,0,1
D53,Other,2021,2,2,1,0
D53,Other,2021,2,7,0,5
D53,Other,2021,2,2,1,0
D53,Other,2021,3,3,1,0
D53,Other,2021,7,7,1,0
D53,Other,2021,96,110,0,14
D53,Other,2021,1,1,1,0
D53,Other,2021,1,4,0,3
D53,Other,2021,2,3,0,1
D53,Other,2021,11,14,0,3
D53,Other,2021,2,2,1,0
D53,Other,2021,6,6,1,0
D53,Other,2021,3,4,0,1
D53,Other,2021,1,1,1,0
D53,Other,2021,1,1,1,0
D55,Theft Under $5000,2021,17,80,0,63
D55,Other,2021,1,1,1,0
D55,Other,2021,1,1,1,0
D55,Theft Under $5000,2021,0,1,0,1
D55,Other,2021,3,3,1,0
D55,Theft Under $5000,2021,42,219,0,177
D55,Other,2021,1,1,1,0
D55,Theft Under $5000,2021,6,116,0,110
D55,Other,2021,3,3,1,0
D55,Theft Under $5000,2021,69,362,0,293
D55,Other,2021,9,10,0,1
D55,Theft Under $5000,2021,8,111,0,103
D55,Other,2021,5,5,1,0
D53,Assault,2021,75,138,0,63
D55,Theft Under $5000,2021,10,194,0,184
D55,Theft Under $5000,2021,1,10,0,9
D55,Other,2021,2,3,0,1
D55,Theft Under $5000,2021,28,141,0,113
D55,Other,2021,3,3,1,0
D55,Theft Under $5000,2021,13,162,0,149
D55,Other,2021,2,2,1,0
D55,Theft Under $5000,2021,19,145,0,126
D55,Other,2021,3,3,1,0
D55,Theft Under $5000,2021,50,290,0,240
D55,Other,2021,1,1,1,0
D55,Theft Under $5000,2021,142,711,0,569
D55,Other,2021,11,14,0,3
D55,Theft Under $5000,2021,37,174,0,137
D55,Other,2021,7,7,1,0
D55,Theft Under $5000,2021,43,318,0,275
D55,Other,2021,5,5,1,0
D55,Theft Under $5000,2021,3,48,0,45
D55,Other,2021,7,7,1,0
D55,Theft Under $5000,2021,29,230,0,201
D55,Other,2021,2,3,0,1
D55,Theft Under $5000,2021,3,60,0,57
D55,Assault,2021,28,50,0,22
D53,Assault,2021,61,103,0,42
D55,Auto Theft,2021,0,5,0,5
D55,Assault,2021,33,50,0,17
D53,Assault,2021,57,102,0,45
D55,Auto Theft,2021,0,11,0,11
D55,Assault,2021,5,7,0,2
D53,Assault,2021,2,3,0,1
D55,Auto Theft,2021,3,22,0,19
D53,Assault,2021,25,57,0,32
D55,Auto Theft,2021,1,16,0,15
D53,Assault,2021,23,41,0,18
D55,Auto Theft,2021,7,39,0,32
D53,Other,2021,10,22,0,12
D55,Auto Theft,2021,2,17,0,15
D53,Break & Enter-Commercial,2021,1,6,0,5
D53,Other,2021,1,2,0,1
D55,Auto Theft,2021,3,19,0,16
D53,Break & Enter-Commercial,2021,1,2,0,1
D53,Other,2021,3,3,1,0
D53,Break & Enter-Commercial,2021,0,3,0,3
D53,Other,2021,2,3,0,1
D53,Break & Enter-Commercial,2021,0,7,0,7
D53,Other,2021,2,4,0,2
D53,Break & Enter-Commercial,2021,1,20,0,19
D53,Other,2021,5,8,0,3
D53,Break & Enter-Commercial,2021,1,13,0,12
D53,Other,2021,3,5,0,2
D53,Break & Enter-Commercial,2021,0,1,0,1
D53,Other,2021,5,15,0,10
D53,Break & Enter-Commercial,2021,8,18,0,10
D53,Other,2021,0,2,0,2
D53,Break & Enter-Commercial,2021,7,31,0,24
D53,Other,2021,14,21,0,7
D53,Break & Enter-Commercial,2021,1,15,0,14
D53,Break & Enter-Commercial,2021,3,14,0,11
D53,Other,2021,2,10,0,8
D53,Break & Enter-Commercial,2021,1,12,0,11
D53,Other,2021,6,14,0,8
D53,Break & Enter-Commercial,2021,2,15,0,13
D53,Other,2021,7,13,0,6
D53,Break & Enter-House,2021,2,16,0,14
D53,Other,2021,5,11,0,6
D53,Break & Enter-House,2021,0,2,0,2
D53,Other,2021,5,9,0,4
D53,Break & Enter-House,2021,0,4,0,4
D53,Break & Enter-House,2021,3,11,0,8
D53,Robbery-Financial,2021,1,1,1,0
D53,Break & Enter-House,2021,0,1,0,1
D53,Robbery-Other,2021,14,26,0,12
D53,Break & Enter-House,2021,1,7,0,6
D53,Robbery-Other,2021,3,3,1,0
D53,Break & Enter-House,2021,3,12,0,9
D53,Robbery-Other,2021,0,1,0,1
D53,Break & Enter-House,2021,4,11,0,7
D53,Robbery-Other,2021,3,5,0,2
D53,Break & Enter-House,2021,1,13,0,12
D53,Robbery-Other,2021,1,2,0,1
D53,Break & Enter-House,2021,1,10,0,9
D53,Robbery-Other,2021,5,7,0,2
D53,Break & Enter-House,2021,2,6,0,4
D53,Break & Enter-House,2021,1,6,0,5
D53,Break & Enter-House,2021,0,3,0,3
D53,Break & Enter-Other,2021,1,10,0,9
D53,Break & Enter-Other,2021,1,1,1,0
D53,Break & Enter-Other,2021,0,1,0,1
D53,Break & Enter-Other,2021,0,2,0,2
D53,Break & Enter-Other,2021,0,1,0,1
D53,Break & Enter-Other,2021,0,2,0,2
D53,Break & Enter-Other,2021,0,3,0,3
D53,Break & Enter-Other,2021,0,3,0,3
D53,Break & Enter-Other,2021,0,1,0,1
D53,Break & Enter-Other,2021,1,3,0,2
D53,Break & Enter-Other,2021,0,4,0,4
D53,Break & Enter-Other,2021,1,2,0,1
D53,Break & Enter-Other,2021,1,6,0,5
D53,Break & Enter-Other,2021,0,5,0,5
D53,Fraud,2021,9,91,0,82
D53,Fraud,2021,0,2,0,2
D53,Fraud,2021,0,12,0,12
D53,Fraud,2021,1,17,0,16
D53,Fraud,2021,0,23,0,23
D53,Fraud,2021,0,2,0,2
D53,Fraud,2021,1,12,0,11
D53,Fraud,2021,0,14,0,14
D53,Fraud,2021,1,30,0,29
D53,Fraud,2021,4,35,0,31
D55,Other,2021,27,31,0,4
D55,Other,2021,53,58,0,5
D55,Other,2021,19,25,0,6
D55,Other,2021,68,85,0,17
D55,Other,2021,32,33,0,1
D55,Other,2021,43,49,0,6
D55,Other,2021,5,7,0,2
D55,Other,2021,23,29,0,6
D55,Other,2021,66,75,0,9
D55,Other,2021,1,1,1,0
D55,Other,2021,14,20,0,6
D55,Other,2021,23,26,0,3
D55,Other,2021,87,110,0,23
D55,Other,2021,67,81,0,14
D55,Other,2021,47,52,0,5
D55,Other,2021,31,39,0,8
D55,Other,2021,140,159,0,19
D55,Other,2021,19,26,0,7
D55,Other Criminal Violations - Offensive Weapons,2021,4,4,1,0
D55,Other Criminal Violations - Offensive Weapons,2021,2,2,1,0
D55,Other Criminal Violations - Offensive Weapons,2021,1,1,1,0
D55,Other Criminal Violations - Offensive Weapons,2021,3,5,0,2
D55,Other Criminal Violations - Offensive Weapons,2021,1,2,0,1
D55,Other Criminal Violations - Offensive Weapons,2021,13,16,0,3
D55,Other Criminal Violations - Offensive Weapons,2021,8,8,1,0
D55,Other Criminal Violations - Offensive Weapons,2021,11,13,0,2
D55,Other Criminal Violations - Offensive Weapons,2021,2,2,1,0
D55,Other Criminal Violations - Offensive Weapons,2021,4,4,1,0
D55,Other Criminal Violations - Offensive Weapons,2021,1,2,0,1
D55,Other Criminal Violations - Offensive Weapons,2021,19,21,0,2
D55,Other Criminal Violations - Offensive Weapons,2021,12,12,1,0
D55,Other Criminal Violations - Offensive Weapons,2021,6,6,1,0
D55,Other Criminal Violations - Offensive Weapons,2021,3,5,0,2
D55,Other Criminal Violations - Offensive Weapons,2021,1,2,0,1
D55,Other,2021,0,1,0,1
D55,Other,2021,1,1,1,0
D55,Other,2021,0,1,0,1
D55,Other,2021,1,1,1,0
NSA,Other,2021,59,72,0,13
NSA,Auto Theft,2021,0,1,0,1
NSA,Auto Theft,2021,1,39,0,38
NSA,Break & Enter-Apartment,2021,4,12,0,8
NSA,Break & Enter-Commercial,2021,13,33,0,20
NSA,Break & Enter-House,2021,5,8,0,3
NSA,Break & Enter-Other,2021,0,1,0,1
NSA,Fraud,2021,0,1,0,1
NSA,Fraud,2021,20,154,0,134
NSA,Fraud,2021,0,2,0,2
NSA,Other,2021,36,99,0,63
NSA,Other,2021,1,1,1,0
D11,Other,2022,11,17,0,6
D11,Other,2022,8,15,0,7
D11,Other,2022,17,24,0,7
D11,Other,2022,8,10,0,2
D11,Other,2022,4,5,0,1
D11,Other,2022,10,15,0,5
D11,Other,2022,6,8,0,2
D11,Other,2022,10,15,0,5
D11,Robbery-Financial,2022,0,1,0,1
D11,Robbery-Financial,2022,1,1,1,0
D11,Robbery-Financial,2022,3,3,1,0
D11,Robbery-Other,2022,5,9,0,4
D11,Robbery-Other,2022,6,11,0,5
D11,Robbery-Other,2022,1,11,0,10
D11,Robbery-Other,2022,3,6,0,3
D11,Robbery-Other,2022,8,13,0,5
D11,Robbery-Other,2022,1,2,0,1
D11,Robbery-Other,2022,1,1,1,0
D11,Robbery-Other,2022,7,10,0,3
D11,Robbery-Other,2022,5,10,0,5
D11,Robbery-Other,2022,1,2,0,1
D11,Robbery-Other,2022,4,5,0,1
D11,Sexual Violation,2022,0,1,0,1
D11,Sexual Violation,2022,5,9,0,4
D11,Sexual Violation,2022,15,34,0,19
D11,Sexual Violation,2022,5,16,0,11
D11,Sexual Violation,2022,5,7,0,2
D11,Sexual Violation,2022,11,16,0,5
D11,Sexual Violation,2022,3,7,0,4
D11,Sexual Violation,2022,0,3,0,3
D11,Sexual Violation,2022,0,1,0,1
D11,Sexual Violation,2022,0,1,0,1
D11,Sexual Violation,2022,1,2,0,1
D11,Sexual Violation,2022,8,22,0,14
D11,Sexual Violation,2022,2,2,1,0
D11,Sexual Violation,2022,6,10,0,4
D11,Other,2022,4,4,1,0
D11,Other,2022,5,6,0,1
D11,Other,2022,25,28,0,3
D11,Other,2022,15,17,0,2
D11,Break & Enter-Apartment,2022,4,7,0,3
D11,Other,2022,8,8,1,0
D11,Other,2022,6,6,1,0
D11,Other,2022,1,2,0,1
D11,Other,2022,1,1,1,0
D11,Other,2022,11,14,0,3
D11,Other,2022,4,4,1,0
D11,Other,2022,15,18,0,3
D11,Other,2022,2,3,0,1
D11,Other,2022,34,40,0,6
D11,Other,2022,95,102,0,7
D55,Assault,2021,43,78,0,35
NSA,Other,2021,0,1,0,1
D11,Break & Enter-Apartment,2022,0,2,0,2
D11,Break & Enter-Apartment,2022,0,2,0,2
D11,Break & Enter-Apartment,2022,5,18,0,13
D11,Break & Enter-Apartment,2022,2,2,1,0
D11,Break & Enter-Apartment,2022,0,3,0,3
D11,Break & Enter-Commercial,2022,1,7,0,6
D11,Break & Enter-Commercial,2022,2,3,0,1
D11,Break & Enter-Commercial,2022,3,12,0,9
D11,Break & Enter-Commercial,2022,5,27,0,22
D11,Break & Enter-Commercial,2022,4,18,0,14
D11,Break & Enter-Commercial,2022,0,1,0,1
D11,Break & Enter-Commercial,2022,0,6,0,6
NSA,Theft Over $5000,2021,1,18,0,17
D11,Break & Enter-Commercial,2022,7,18,0,11
NSA,Theft Under $5000,2021,0,1,0,1
D11,Break & Enter-Commercial,2022,5,14,0,9
NSA,Theft Under $5000,2021,20,113,0,93
D11,Break & Enter-Commercial,2022,0,2,0,2
NSA,Theft Under $5000,2021,0,1,0,1
D11,Break & Enter-House,2022,2,4,0,2
NSA,Assault,2021,0,1,0,1
D11,Break & Enter-House,2022,2,7,0,5
D11,Other,2022,46,53,0,7
D55,Robbery-Other,2021,0,3,0,3
D55,Assault,2021,38,55,0,17
NSA,Assault,2021,116,255,0,139
D11,Break & Enter-House,2022,8,17,0,9
D11,Other,2022,8,8,1,0
D55,Robbery-Other,2021,5,11,0,6
D55,Assault,2021,98,169,0,71
NSA,Other,2021,0,1,0,1
D11,Break & Enter-House,2022,0,2,0,2
D11,Other,2022,60,69,0,9
D11,Other,2022,25,93,0,68
D55,Robbery-Other,2021,1,5,0,4
D55,Assault,2021,70,127,0,57
NSA,Other,2021,0,1,0,1
D11,Other,2022,50,58,0,8
D11,Break & Enter-House,2022,2,11,0,9
D11,Other,2022,13,14,0,1
D11,Other,2022,6,28,0,22
D55,Robbery-Other,2021,7,8,0,1
D55,Assault,2021,54,97,0,43
NSA,Other,2021,25,47,0,22
D11,Break & Enter-House,2022,2,3,0,1
D11,Other,2022,18,20,0,2
D55,Assault,2021,6,9,0,3
D55,Robbery-Other,2021,9,21,0,12
D11,Other,2022,5,26,0,21
NSA,Robbery-Financial,2021,4,4,1,0
D11,Break & Enter-House,2022,2,14,0,12
D11,Other,2022,3,3,1,0
D55,Assault,2021,25,50,0,25
D55,Robbery-Other,2021,6,9,0,3
D11,Other,2022,0,2,0,2
NSA,Robbery-Other,2021,18,33,0,15
D11,Break & Enter-House,2022,1,5,0,4
D11,Other,2022,2,2,1,0
D55,Assault,2021,72,110,0,38
D55,Robbery-Other,2021,6,11,0,5
D11,Other,2022,2,3,0,1
NSA,Sexual Violation,2021,0,1,0,1
D11,Break & Enter-House,2022,1,2,0,1
D11,Other,2022,67,78,0,11
D55,Assault,2021,0,2,0,2
D55,Robbery-Other,2021,1,5,0,4
D11,Other,2022,38,111,0,73
NSA,Sexual Violation,2021,0,1,0,1
D11,Break & Enter-Other,2022,1,3,0,2
D11,Other,2022,18,23,0,5
D55,Assault,2021,20,33,0,13
D55,Robbery-Other,2021,3,5,0,2
D11,Other,2022,10,35,0,25
NSA,Sexual Violation,2021,0,2,0,2
D11,Break & Enter-Other,2022,1,4,0,3
D11,Other,2022,7,8,0,1
D55,Assault,2021,22,49,0,27
D55,Robbery-Other,2021,2,2,1,0
D11,Other,2022,4,11,0,7
NSA,Sexual Violation,2021,41,156,0,115
D11,Break & Enter-Other,2022,2,9,0,7
D11,Other,2022,84,89,0,5
D55,Assault,2021,103,187,0,84
D55,Sexual Violation,2021,1,1,1,0
D55,Sexual Violation,2021,2,6,0,4
D55,Sexual Violation,2021,1,6,0,5
D55,Sexual Violation,2021,6,12,0,6
D55,Sexual Violation,2021,4,9,0,5
D55,Sexual Violation,2021,6,19,0,13
D55,Sexual Violation,2021,12,17,0,5
D55,Sexual Violation,2021,7,12,0,5
D55,Sexual Violation,2021,1,1,1,0
D55,Sexual Violation,2021,0,2,0,2
D55,Sexual Violation,2021,3,10,0,7
D55,Sexual Violation,2021,9,20,0,11
D55,Sexual Violation,2021,2,4,0,2
D55,Sexual Violation,2021,2,5,0,3
D55,Sexual Violation,2021,18,31,0,13
D55,Sexual Violation,2021,5,13,0,8
D55,Sexual Violation,2021,7,16,0,9
D55,Sexual Violation,2021,2,3,0,1
D55,Sexual Violation,2021,2,5,0,3
D55,Sexual Violation,2021,3,5,0,2
D55,Other,2021,5,8,0,3
D55,Other,2021,5,5,1,0
D55,Other,2021,2,2,1,0
D55,Other,2021,3,3,1,0
D55,Other,2021,6,6,1,0
D55,Other,2021,10,13,0,3
D55,Other,2021,7,7,1,0
D55,Other,2021,9,11,0,2
D55,Other,2021,2,2,1,0
D55,Other,2021,6,6,1,0
D55,Other,2021,5,6,0,1
D55,Other,2021,24,24,1,0
D55,Other,2021,2,2,1,0
D55,Other,2021,33,36,0,3
D55,Other,2021,3,3,1,0
D55,Other,2021,8,10,0,2
D55,Other,2021,1,2,0,1
D55,Other,2021,3,3,1,0
D55,Other,2021,1,3,0,2
D55,Other,2021,31,36,0,5
D11,Other,2022,11,35,0,24
NSA,Other,2021,1,1,1,0
D11,Break & Enter-Other,2022,1,3,0,2
D11,Other Criminal Violations - Offensive Weapons,2022,0,1,0,1
D11,Theft Over $5000,2022,0,5,0,5
NSA,Other,2021,106,126,0,20
D11,Break & Enter-Other,2022,0,1,0,1
D11,Other Criminal Violations - Offensive Weapons,2022,5,5,1,0
D11,Other Criminal Violations - Offensive Weapons,2022,4,5,0,1
D11,Other Criminal Violations - Offensive Weapons,2022,6,6,1,0
D11,Other Criminal Violations - Offensive Weapons,2022,6,7,0,1
D11,Other Criminal Violations - Offensive Weapons,2022,7,9,0,2
D11,Other Criminal Violations - Offensive Weapons,2022,1,1,1,0
D11,Other Criminal Violations - Offensive Weapons,2022,0,1,0,1
D11,Other Criminal Violations - Offensive Weapons,2022,0,1,0,1
D11,Other Criminal Violations - Offensive Weapons,2022,5,7,0,2
D11,Other Criminal Violations - Offensive Weapons,2022,3,3,1,0
D11,Other Criminal Violations - Offensive Weapons,2022,3,5,0,2
D11,Other Criminal Violations - Offensive Weapons,2022,2,2,1,0
D11,Other,2022,2,2,1,0
D11,Other,2022,1,1,1,0
D12,Other,2022,2,2,1,0
D12,Other,2022,5,5,1,0
D12,Other,2022,2,2,1,0
D12,Other,2022,5,7,0,2
D12,Other,2022,4,5,0,1
D12,Other,2022,6,6,1,0
D12,Other,2022,5,5,1,0
D12,Other,2022,1,1,1,0
D12,Other,2022,4,4,1,0
D12,Other,2022,2,2,1,0
D12,Auto Theft,2022,1,21,0,20
D12,Auto Theft,2022,10,67,0,57
D12,Auto Theft,2022,0,13,0,13
D12,Auto Theft,2022,9,30,0,21
D12,Auto Theft,2022,3,46,0,43
D12,Auto Theft,2022,2,40,0,38
D12,Auto Theft,2022,0,3,0,3
D12,Auto Theft,2022,5,44,0,39
D12,Auto Theft,2022,6,63,0,57
D12,Auto Theft,2022,0,36,0,36
D12,Auto Theft,2022,13,94,0,81
D12,Auto Theft,2022,1,16,0,15
D12,Break & Enter-Apartment,2022,2,3,0,1
D55,Assault,2021,64,106,0,42
D11,Theft Over $5000,2022,0,6,0,6
D55,Assault,2021,46,86,0,40
NSA,Other,2021,0,1,0,1
D11,Break & Enter-Other,2022,1,3,0,2
D11,Theft Over $5000,2022,0,5,0,5
D55,Assault,2021,30,44,0,14
D11,Theft Over $5000,2022,3,12,0,9
NSA,Other,2021,1,1,1,0
D11,Break & Enter-Other,2022,0,1,0,1
D55,Assault,2021,47,74,0,27
D11,Theft Over $5000,2022,1,5,0,4
NSA,Other,2021,150,185,0,35
D11,Fraud,2022,9,46,0,37
D55,Assault,2021,17,29,0,12
D11,Theft Over $5000,2022,0,1,0,1
NSA,Other,2021,1,1,1,0
D11,Fraud,2022,7,66,0,59
D55,Attempt Murder,2021,9,12,0,3
D11,Theft Over $5000,2022,0,1,0,1
NSA,Other Criminal Violations - Offensive Weapons,2021,39,40,0,1
D11,Fraud,2022,7,75,0,68
D55,Attempt Murder,2021,2,2,1,0
D11,Theft Over $5000,2022,0,1,0,1
NSA,Other,2021,1,1,1,0
D11,Fraud,2022,10,70,0,60
D55,Attempt Murder,2021,1,1,1,0
D11,Theft Over $5000,2022,1,1,1,0
D11,Theft Over $5000,2022,1,8,0,7
D11,Theft Over $5000,2022,0,1,0,1
D11,Theft Over $5000,2022,0,3,0,3
D11,Theft Under $5000,2022,81,443,0,362
D11,Theft Under $5000,2022,98,552,0,454
D11,Theft Under $5000,2022,34,152,0,118
D11,Theft Under $5000,2022,123,624,0,501
D11,Theft Under $5000,2022,66,330,0,264
D11,Theft Under $5000,2022,2,42,0,40
D11,Theft Under $5000,2022,3,31,0,28
D11,Theft Under $5000,2022,1,3,0,2
D11,Theft Under $5000,2022,16,44,0,28
D11,Theft Under $5000,2022,72,476,0,404
D11,Theft Under $5000,2022,57,295,0,238
D11,Theft Under $5000,2022,1,23,0,22
D11,Theft Under $5000,2022,5,34,0,29
D11,Assault,2022,31,52,0,21
D11,Assault,2022,77,121,0,44
D11,Assault,2022,53,88,0,35
D11,Assault,2022,54,77,0,23
D11,Assault,2022,63,103,0,40
D11,Assault,2022,35,44,0,9
D11,Assault,2022,23,30,0,7
D11,Assault,2022,3,4,0,1
D11,Assault,2022,1,3,0,2
D11,Assault,2022,69,91,0,22
D11,Assault,2022,23,37,0,14
D11,Assault,2022,10,21,0,11
D11,Assault,2022,47,73,0,26
D11,Attempt Murder,2022,0,1,0,1
D11,Other,2022,15,19,0,4
D11,Other,2022,13,22,0,9
NSA,Other,2021,1,8,0,7
D11,Fraud,2022,5,57,0,52
D55,Other,2021,4,11,0,7
D11,Other,2022,3,3,1,0
D11,Fraud,2022,3,21,0,18
D55,Other,2021,13,17,0,4
D11,Other,2022,2,2,1,0
D11,Fraud,2022,1,11,0,10
D55,Other,2021,6,16,0,10
D11,Other,2022,2,3,0,1
D11,Fraud,2022,0,1,0,1
D55,Other,2021,4,11,0,7
D11,Other,2022,2,3,0,1
D55,Other,2021,21,41,0,20
D11,Other,2022,1,1,1,0
D55,Other,2021,12,20,0,8
D11,Fraud,2022,0,9,0,9
D11,Other,2022,2,2,1,0
D55,Other,2021,11,18,0,7
D11,Fraud,2022,7,67,0,60
D11,Other,2022,7,7,1,0
D55,Other,2021,0,1,0,1
D11,Fraud,2022,3,27,0,24
D11,Other,2022,1,1,1,0
D55,Other,2021,2,5,0,3
D11,Fraud,2022,0,4,0,4
D11,Other,2022,1,1,1,0
D55,Other,2021,19,28,0,9
D11,Fraud,2022,3,18,0,15
D11,Auto Theft,2022,2,5,0,3
D55,Other,2021,10,18,0,8
D11,Other,2022,1,2,0,1
D11,Auto Theft,2022,4,38,0,34
D55,Other,2021,4,6,0,2
D11,Other,2022,17,58,0,41
D11,Auto Theft,2022,6,77,0,71
D55,Other,2021,11,31,0,20
D11,Other,2022,40,121,0,81
D11,Auto Theft,2022,6,31,0,25
D55,Other,2021,15,28,0,13
D11,Other,2022,30,105,0,75
D11,Auto Theft,2022,7,38,0,31
D55,Other,2021,5,18,0,13
D11,Other,2022,23,81,0,58
D11,Auto Theft,2022,6,26,0,20
D55,Other,2021,6,15,0,9
D11,Auto Theft,2022,1,11,0,10
D55,Other,2021,3,10,0,7
D55,Other,2021,3,6,0,3
D11,Auto Theft,2022,4,22,0,18
D55,Robbery-Financial,2021,1,1,1,0
D11,Auto Theft,2022,4,29,0,25
D55,Robbery-Financial,2021,1,1,1,0
D11,Auto Theft,2022,0,5,0,5
D55,Robbery-Financial,2021,0,1,0,1
D11,Auto Theft,2022,3,13,0,10
D55,Robbery-Other,2021,2,2,1,0
D11,Break & Enter-Apartment,2022,3,4,0,1
D55,Robbery-Other,2021,10,11,0,1
D11,Break & Enter-Apartment,2022,8,20,0,12
D11,Break & Enter-Apartment,2022,5,12,0,7
D55,Robbery-Other,2021,5,8,0,3
D11,Break & Enter-Apartment,2022,5,11,0,6
D55,Robbery-Other,2021,4,10,0,6
D11,Break & Enter-Apartment,2022,7,12,0,5
D55,Robbery-Other,2021,4,4,1,0
D55,Robbery-Other,2021,13,23,0,10
D55,Robbery-Other,2021,1,3,0,2
D55,Robbery-Other,2021,5,11,0,6
D55,Robbery-Other,2021,1,1,1,0
D12,Other,2022,62,68,0,6
D13,Break & Enter-Apartment,2022,1,5,0,4
D12,Other,2022,16,22,0,6
D13,Break & Enter-Apartment,2022,1,2,0,1
D12,Other,2022,8,12,0,4
D12,Other,2022,10,10,1,0
D13,Break & Enter-Apartment,2022,1,4,0,3
D12,Other,2022,16,18,0,2
D12,Other,2022,14,22,0,8
D13,Break & Enter-Apartment,2022,3,11,0,8
D12,Break & Enter-Apartment,2022,0,7,0,7
D12,Other,2022,33,38,0,5
D12,Other,2022,3,7,0,4
D13,Break & Enter-Apartment,2022,1,2,0,1
D13,Assault,2022,12,20,0,8
D12,Break & Enter-Apartment,2022,2,3,0,1
D12,Other,2022,24,31,0,7
D12,Fraud,2022,0,12,0,12
D12,Other,2022,7,12,0,5
D13,Break & Enter-Apartment,2022,5,13,0,8
D13,Other,2022,3,3,1,0
D13,Assault,2022,17,23,0,6
D12,Break & Enter-Apartment,2022,4,9,0,5
D12,Other,2022,0,2,0,2
D12,Other,2022,8,8,1,0
D12,Other,2022,12,42,0,30
D13,Break & Enter-Apartment,2022,1,6,0,5
D13,Other,2022,3,3,1,0
D13,Assault,2022,26,38,0,12
D12,Break & Enter-Apartment,2022,5,18,0,13
D12,Other,2022,19,19,1,0
D12,Other,2022,15,18,0,3
D12,Other,2022,21,83,0,62
D13,Break & Enter-Apartment,2022,0,1,0,1
D13,Other,2022,4,4,1,0
D13,Assault,2022,16,18,0,2
D12,Break & Enter-Apartment,2022,1,1,1,0
D12,Other,2022,51,62,0,11
D12,Other,2022,8,11,0,3
D12,Other,2022,2,19,0,17
D13,Break & Enter-Commercial,2022,2,10,0,8
D13,Break & Enter-Commercial,2022,0,1,0,1
D13,Break & Enter-Commercial,2022,0,2,0,2
D13,Break & Enter-Commercial,2022,3,12,0,9
D13,Break & Enter-Commercial,2022,0,2,0,2
D13,Break & Enter-Commercial,2022,0,4,0,4
D13,Break & Enter-Commercial,2022,1,3,0,2
D13,Break & Enter-Commercial,2022,6,6,1,0
D13,Break & Enter-Commercial,2022,0,1,0,1
D13,Break & Enter-Commercial,2022,2,9,0,7
D13,Break & Enter-Commercial,2022,2,17,0,15
D13,Break & Enter-Commercial,2022,5,13,0,8
D13,Break & Enter-House,2022,1,5,0,4
D13,Break & Enter-House,2022,0,2,0,2
D13,Break & Enter-House,2022,0,1,0,1
D13,Break & Enter-House,2022,1,3,0,2
D13,Break & Enter-House,2022,0,3,0,3
D13,Break & Enter-House,2022,0,4,0,4
D13,Break & Enter-House,2022,2,6,0,4
D13,Break & Enter-House,2022,0,14,0,14
D13,Break & Enter-House,2022,2,2,1,0
D13,Break & Enter-House,2022,1,1,1,0
D13,Break & Enter-House,2022,1,8,0,7
D13,Break & Enter-House,2022,1,3,0,2
D13,Break & Enter-House,2022,0,7,0,7
D13,Break & Enter-Other,2022,0,5,0,5
D13,Break & Enter-Other,2022,0,1,0,1
D13,Break & Enter-Other,2022,0,4,0,4
D13,Break & Enter-Other,2022,0,1,0,1
D13,Break & Enter-Other,2022,0,2,0,2
D13,Break & Enter-Other,2022,1,4,0,3
D13,Break & Enter-Other,2022,1,3,0,2
D13,Break & Enter-Other,2022,2,10,0,8
D13,Break & Enter-Other,2022,0,2,0,2
D13,Break & Enter-Other,2022,1,5,0,4
D13,Fraud,2022,3,49,0,46
D13,Fraud,2022,2,22,0,20
D13,Fraud,2022,2,13,0,11
D13,Fraud,2022,3,41,0,38
D13,Fraud,2022,2,15,0,13
D13,Fraud,2022,2,13,0,11
D13,Fraud,2022,2,33,0,31
D12,Other,2022,18,54,0,36
D13,Other,2022,2,2,1,0
D13,Assault,2022,1,3,0,2
D12,Other,2022,24,31,0,7
D12,Other,2022,17,25,0,8
D12,Break & Enter-Apartment,2022,5,12,0,7
D13,Assault,2022,95,145,0,50
D12,Other,2022,4,8,0,4
D13,Assault,2022,42,73,0,31
D13,Fraud,2022,5,45,0,40
D12,Break & Enter-Apartment,2022,3,5,0,2
D12,Other,2022,60,74,0,14
D13,Other,2022,1,1,1,0
D12,Other,2022,5,23,0,18
D12,Other,2022,30,46,0,16
D13,Assault,2022,36,64,0,28
D13,Fraud,2022,1,18,0,17
D12,Break & Enter-Apartment,2022,3,13,0,10
D12,Other,2022,11,15,0,4
D13,Other,2022,10,13,0,3
D12,Other,2022,26,72,0,46
D12,Other,2022,4,6,0,2
D13,Attempt Murder,2022,1,1,1,0
D13,Fraud,2022,0,4,0,4
D12,Break & Enter-Commercial,2022,0,6,0,6
D12,Other Criminal Violations - Offensive Weapons,2022,4,9,0,5
D13,Other,2022,1,2,0,1
D12,Other,2022,2,6,0,4
D12,Robbery-Financial,2022,1,1,1,0
D13,Attempt Murder,2022,1,4,0,3
D13,Fraud,2022,2,59,0,57
D13,Other,2022,3,3,1,0
D12,Break & Enter-Commercial,2022,2,11,0,9
D12,Other Criminal Violations - Offensive Weapons,2022,3,5,0,2
D13,Other,2022,1,1,1,0
D12,Break & Enter-Commercial,2022,7,12,0,5
D12,Other,2022,11,23,0,12
D12,Robbery-Financial,2022,1,1,1,0
D13,Attempt Murder,2022,1,1,1,0
D13,Fraud,2022,6,42,0,36
D12,Other Criminal Violations - Offensive Weapons,2022,6,8,0,2
D13,Other,2022,26,32,0,6
D12,Other,2022,20,88,0,68
D13,Attempt Murder,2022,1,1,1,0
D12,Break & Enter-Commercial,2022,4,10,0,6
D12,Robbery-Other,2022,0,1,0,1
D13,Fraud,2022,3,41,0,38
D12,Other Criminal Violations - Offensive Weapons,2022,4,6,0,2
D13,Other,2022,17,19,0,2
D12,Other,2022,23,60,0,37
D13,Other,2022,8,14,0,6
D12,Break & Enter-Commercial,2022,0,3,0,3
D12,Robbery-Other,2022,3,10,0,7
D13,Other,2022,0,1,0,1
D12,Other Criminal Violations - Offensive Weapons,2022,3,4,0,1
D13,Other,2022,16,16,1,0
D12,Other,2022,46,125,0,79
D13,Other,2022,6,10,0,4
D12,Robbery-Other,2022,1,12,0,11
D13,Other,2022,14,72,0,58
D12,Other Criminal Violations - Offensive Weapons,2022,8,13,0,5
D12,Break & Enter-Commercial,2022,0,4,0,4
D13,Other,2022,36,40,0,4
D12,Other,2022,8,16,0,8
D13,Other,2022,4,6,0,2
D12,Robbery-Other,2022,5,8,0,3
D13,Other,2022,7,35,0,28
D12,Other Criminal Violations - Offensive Weapons,2022,2,8,0,6
D13,Other,2022,5,6,0,1
D12,Break & Enter-Commercial,2022,1,3,0,2
D12,Theft Over $5000,2022,0,2,0,2
D13,Other,2022,7,13,0,6
D12,Robbery-Other,2022,1,4,0,3
D13,Other,2022,3,30,0,27
D12,Other Criminal Violations - Offensive Weapons,2022,16,17,0,1
D12,Other Criminal Violations - Offensive Weapons,2022,1,1,1,0
D12,Other,2022,1,2,0,1
D12,Other,2022,2,4,0,2
D12,Other,2022,1,1,1,0
D12,Other,2022,1,1,1,0
D12,Other,2022,2,2,1,0
D12,Other,2022,1,1,1,0
D13,Other,2022,1,2,0,1
D13,Other,2022,0,1,0,1
D13,Other,2022,1,1,1,0
D13,Other,2022,1,1,1,0
D13,Other,2022,1,2,0,1
D13,Other,2022,1,1,1,0
D13,Other,2022,3,4,0,1
D13,Other,2022,2,4,0,2
D13,Auto Theft,2022,4,54,0,50
D13,Auto Theft,2022,0,25,0,25
D13,Auto Theft,2022,2,9,0,7
D13,Auto Theft,2022,1,40,0,39
D13,Auto Theft,2022,2,31,0,29
D13,Auto Theft,2022,2,22,0,20
D13,Auto Theft,2022,3,41,0,38
D13,Auto Theft,2022,3,55,0,52
D13,Auto Theft,2022,1,8,0,7
D13,Auto Theft,2022,5,63,0,58
D13,Auto Theft,2022,3,34,0,31
D13,Auto Theft,2022,2,52,0,50
D13,Break & Enter-Apartment,2022,2,6,0,4
D13,Break & Enter-Apartment,2022,0,3,0,3
D13,Break & Enter-Apartment,2022,0,3,0,3
D13,Other,2022,4,5,0,1
D12,Theft Over $5000,2022,0,8,0,8
D13,Other,2022,3,7,0,4
D12,Robbery-Other,2022,5,5,1,0
D12,Break & Enter-Commercial,2022,10,15,0,5
D13,Other,2022,1,1,1,0
D12,Theft Over $5000,2022,0,1,0,1
D13,Other,2022,0,3,0,3
D12,Robbery-Other,2022,0,1,0,1
D12,Break & Enter-Commercial,2022,4,11,0,7
D13,Other,2022,58,67,0,9
D12,Theft Over $5000,2022,0,3,0,3
D13,Other,2022,2,4,0,2
D13,Other,2022,8,9,0,1
D13,Other,2022,5,6,0,1
D13,Other,2022,7,13,0,6
D13,Other,2022,14,18,0,4
D13,Other,2022,14,16,0,2
D13,Robbery-Other,2022,5,12,0,7
D13,Robbery-Other,2022,0,3,0,3
D13,Robbery-Other,2022,2,8,0,6
D13,Robbery-Other,2022,2,10,0,8
D13,Robbery-Other,2022,3,3,1,0
D13,Robbery-Other,2022,3,4,0,1
D13,Robbery-Other,2022,0,3,0,3
D13,Robbery-Other,2022,7,24,0,17
D13,Robbery-Other,2022,1,4,0,3
D13,Robbery-Other,2022,1,3,0,2
D13,Sexual Violation,2022,1,3,0,2
D13,Sexual Violation,2022,6,9,0,3
D13,Sexual Violation,2022,6,10,0,4
D13,Sexual Violation,2022,7,15,0,8
D13,Sexual Violation,2022,4,6,0,2
D13,Sexual Violation,2022,0,1,0,1
D13,Sexual Violation,2022,0,3,0,3
D13,Sexual Violation,2022,4,8,0,4
D13,Sexual Violation,2022,1,2,0,1
D13,Sexual Violation,2022,6,15,0,9
D13,Sexual Violation,2022,6,11,0,5
D13,Sexual Violation,2022,3,6,0,3
D13,Other,2022,7,9,0,2
D13,Other,2022,10,12,0,2
D13,Other,2022,4,5,0,1
D13,Other,2022,14,16,0,2
D12,Robbery-Other,2022,1,2,0,1
D12,Theft Over $5000,2022,3,5,0,2
D13,Other,2022,7,9,0,2
D12,Break & Enter-Commercial,2022,0,1,0,1
D12,Robbery-Other,2022,2,13,0,11
D12,Theft Over $5000,2022,2,3,0,1
D13,Other,2022,5,5,1,0
D12,Break & Enter-Commercial,2022,8,22,0,14
D12,Robbery-Other,2022,1,2,0,1
D12,Theft Over $5000,2022,1,11,0,10
D13,Other,2022,49,56,0,7
D12,Break & Enter-Commercial,2022,1,1,1,0
D12,Robbery-Other,2022,12,22,0,10
D12,Robbery-Other,2022,5,5,1,0
D12,Sexual Violation,2022,6,15,0,9
D12,Sexual Violation,2022,12,21,0,9
D12,Sexual Violation,2022,2,4,0,2
D12,Sexual Violation,2022,7,13,0,6
D12,Sexual Violation,2022,6,8,0,2
D12,Sexual Violation,2022,9,13,0,4
D12,Sexual Violation,2022,0,1,0,1
D12,Sexual Violation,2022,2,3,0,1
D12,Sexual Violation,2022,8,16,0,8
D12,Sexual Violation,2022,8,13,0,5
D12,Sexual Violation,2022,22,35,0,13
D12,Sexual Violation,2022,2,2,1,0
D12,Other,2022,10,12,0,2
D12,Other,2022,17,20,0,3
D12,Other,2022,1,1,1,0
D12,Other,2022,8,8,1,0
D12,Other,2022,12,12,1,0
D12,Other,2022,5,5,1,0
D12,Other,2022,9,9,1,0
D12,Other,2022,2,3,0,1
D12,Other,2022,18,19,0,1
D12,Other,2022,1,1,1,0
D12,Other,2022,10,12,0,2
D12,Other,2022,3,4,0,1
D12,Other,2022,30,36,0,6
D12,Break & Enter-House,2022,0,1,0,1
D13,Other,2022,33,44,0,11
D12,Break & Enter-House,2022,1,3,0,2
D12,Theft Over $5000,2022,1,5,0,4
D13,Other,2022,13,17,0,4
D12,Break & Enter-House,2022,1,4,0,3
D12,Theft Over $5000,2022,1,9,0,8
D13,Other Criminal Violations - Offensive Weapons,2022,3,3,1,0
D12,Break & Enter-House,2022,1,7,0,6
D12,Theft Under $5000,2022,12,90,0,78
D13,Other Criminal Violations - Offensive Weapons,2022,1,4,0,3
D12,Break & Enter-House,2022,1,2,0,1
D12,Theft Under $5000,2022,77,385,0,308
D13,Other Criminal Violations - Offensive Weapons,2022,2,2,1,0
D12,Break & Enter-House,2022,3,9,0,6
D12,Theft Under $5000,2022,36,136,0,100
D13,Other Criminal Violations - Offensive Weapons,2022,2,2,1,0
D12,Theft Under $5000,2022,13,114,0,101
D13,Other Criminal Violations - Offensive Weapons,2022,2,2,1,0
D12,Theft Under $5000,2022,1,32,0,31
D12,Break & Enter-House,2022,0,2,0,2
D13,Other Criminal Violations - Offensive Weapons,2022,1,3,0,2
D12,Theft Under $5000,2022,8,77,0,69
D12,Break & Enter-House,2022,2,4,0,2
D13,Other Criminal Violations - Offensive Weapons,2022,1,1,1,0
D12,Theft Under $5000,2022,1,6,0,5
D12,Break & Enter-House,2022,1,4,0,3
D13,Other Criminal Violations - Offensive Weapons,2022,1,1,1,0
D12,Theft Under $5000,2022,101,371,0,270
D12,Break & Enter-Other,2022,0,2,0,2
D13,Other Criminal Violations - Offensive Weapons,2022,7,11,0,4
D12,Theft Under $5000,2022,20,160,0,140
D12,Break & Enter-Other,2022,0,2,0,2
D13,Other Criminal Violations - Offensive Weapons,2022,8,11,0,3
D12,Theft Under $5000,2022,3,42,0,39
D12,Break & Enter-Other,2022,0,1,0,1
D13,Other Criminal Violations - Offensive Weapons,2022,7,8,0,1
D12,Theft Under $5000,2022,23,176,0,153
D12,Break & Enter-Other,2022,1,2,0,1
D13,Other,2022,1,1,1,0
D12,Theft Under $5000,2022,2,19,0,17
D12,Break & Enter-Other,2022,1,2,0,1
D13,Other,2022,0,1,0,1
D12,Assault,2022,40,61,0,21
D12,Break & Enter-Other,2022,1,1,1,0
D13,Other,2022,1,1,1,0
D12,Assault,2022,95,141,0,46
D12,Break & Enter-Other,2022,1,1,1,0
D14,Other,2022,6,6,1,0
D12,Assault,2022,15,16,0,1
D12,Break & Enter-Other,2022,0,2,0,2
D14,Other,2022,2,2,1,0
D12,Assault,2022,57,91,0,34
D12,Break & Enter-Other,2022,3,7,0,4
D14,Other,2022,2,2,1,0
D12,Assault,2022,29,42,0,13
D12,Break & Enter-Other,2022,0,2,0,2
D14,Other,2022,6,14,0,8
D12,Assault,2022,59,105,0,46
D14,Other,2022,5,5,1,0
D12,Assault,2022,0,2,0,2
D14,Other,2022,18,18,1,0
D12,Assault,2022,25,34,0,9
D12,Fraud,2022,1,29,0,28
D14,Other,2022,1,1,1,0
D12,Assault,2022,105,145,0,40
D12,Fraud,2022,8,60,0,52
D14,Other,2022,1,1,1,0
D12,Assault,2022,46,65,0,19
D12,Fraud,2022,2,16,0,14
D14,Other,2022,1,2,0,1
D12,Assault,2022,158,217,0,59
D12,Fraud,2022,1,18,0,17
D14,Other,2022,17,19,0,2
D12,Assault,2022,12,16,0,4
D12,Fraud,2022,0,24,0,24
D14,Other,2022,3,4,0,1
D12,Attempt Murder,2022,1,1,1,0
D12,Fraud,2022,4,39,0,35
D14,Other,2022,4,4,1,0
D12,Attempt Murder,2022,1,1,1,0
D12,Fraud,2022,0,1,0,1
D14,Other,2022,10,11,0,1
D12,Attempt Murder,2022,1,1,1,0
D14,Other,2022,1,2,0,1
D12,Fraud,2022,1,26,0,25
D12,Attempt Murder,2022,1,1,1,0
D12,Fraud,2022,3,54,0,51
D12,Fraud,2022,0,17,0,17
D12,Fraud,2022,2,65,0,63
D13,Other,2022,22,78,0,56
D13,Other,2022,3,15,0,12
D13,Other,2022,4,21,0,17
D13,Other,2022,2,15,0,13
D13,Other,2022,17,59,0,42
D13,Other,2022,3,14,0,11
D13,Other,2022,1,4,0,3
D13,Other,2022,38,106,0,68
D13,Other,2022,10,73,0,63
D13,Other,2022,6,47,0,41
D13,Theft Over $5000,2022,0,1,0,1
D13,Theft Over $5000,2022,0,7,0,7
D13,Theft Over $5000,2022,1,2,0,1
D13,Theft Over $5000,2022,0,1,0,1
D13,Theft Over $5000,2022,0,3,0,3
D13,Theft Over $5000,2022,0,2,0,2
D13,Theft Over $5000,2022,0,7,0,7
D13,Theft Over $5000,2022,0,3,0,3
D13,Theft Over $5000,2022,0,4,0,4
D13,Theft Over $5000,2022,2,5,0,3
D13,Theft Over $5000,2022,0,9,0,9
D13,Theft Over $5000,2022,1,4,0,3
D13,Theft Under $5000,2022,7,95,0,88
D13,Theft Under $5000,2022,3,51,0,48
D13,Theft Under $5000,2022,74,524,0,450
D13,Theft Under $5000,2022,8,68,0,60
D13,Theft Under $5000,2022,3,29,0,26
D13,Theft Under $5000,2022,1,13,0,12
D13,Theft Under $5000,2022,12,146,0,134
D13,Theft Under $5000,2022,14,109,0,95
D13,Theft Under $5000,2022,1,30,0,29
D13,Theft Under $5000,2022,0,4,0,4
D13,Theft Under $5000,2022,11,122,0,111
D13,Theft Under $5000,2022,22,262,0,240
D13,Theft Under $5000,2022,28,145,0,117
D13,Assault,2022,49,75,0,26
D13,Assault,2022,34,53,0,19
D13,Assault,2022,19,39,0,20
D13,Assault,2022,50,85,0,35
D13,Assault,2022,9,12,0,3
D22,Theft Over $5000,2022,0,8,0,8
D22,Theft Over $5000,2022,1,7,0,6
D22,Theft Over $5000,2022,0,3,0,3
D22,Theft Over $5000,2022,12,45,0,33
D22,Theft Over $5000,2022,0,5,0,5
D22,Theft Over $5000,2022,3,12,0,9
D22,Theft Over $5000,2022,0,8,0,8
D22,Theft Over $5000,2022,0,4,0,4
D22,Theft Over $5000,2022,1,6,0,5
D22,Theft Over $5000,2022,0,3,0,3
D22,Theft Over $5000,2022,2,11,0,9
D22,Theft Over $5000,2022,0,4,0,4
D22,Theft Over $5000,2022,1,7,0,6
D22,Theft Over $5000,2022,0,2,0,2
D22,Theft Over $5000,2022,2,9,0,7
D22,Theft Under $5000,2022,8,142,0,134
D22,Theft Under $5000,2022,28,174,0,146
D22,Theft Under $5000,2022,5,79,0,74
D22,Theft Under $5000,2022,241,1330,0,1089
D22,Other,2022,4,5,0,1
D22,Theft Under $5000,2022,4,70,0,66
D22,Theft Under $5000,2022,43,226,0,183
D22,Theft Under $5000,2022,62,485,0,423
D22,Theft Under $5000,2022,33,173,0,140
D22,Theft Under $5000,2022,58,265,0,207
D22,Theft Under $5000,2022,33,202,0,169
D22,Theft Under $5000,2022,6,171,0,165
D22,Theft Under $5000,2022,1,21,0,20
D22,Theft Under $5000,2022,82,346,0,264
D22,Theft Under $5000,2022,6,85,0,79
D22,Theft Under $5000,2022,49,396,0,347
D22,Assault,2022,21,37,0,16
D22,Assault,2022,21,27,0,6
D22,Assault,2022,25,50,0,25
D22,Assault,2022,117,183,0,66
D22,Assault,2022,30,48,0,18
D22,Assault,2022,79,112,0,33
D22,Assault,2022,1,5,0,4
D22,Assault,2022,42,82,0,40
D22,Assault,2022,1,1,1,0
D22,Assault,2022,5,17,0,12
D22,Assault,2022,65,81,0,16
D22,Assault,2022,20,33,0,13
D22,Assault,2022,205,310,0,105
D22,Assault,2022,7,13,0,6
D22,Assault,2022,82,148,0,66
D22,Assault,2022,11,18,0,7
D22,Assault,2022,51,98,0,47
D22,Attempt Murder,2022,1,1,1,0
D22,Attempt Murder,2022,1,1,1,0
D22,Other,2022,5,9,0,4
D14,Auto Theft,2022,2,25,0,23
D14,Other,2022,1,1,1,0
D22,Break & Enter-House,2022,0,4,0,4
D14,Break & Enter-House,2022,5,18,0,13
D22,Other,2022,5,5,1,0
D22,Auto Theft,2022,3,68,0,65
D22,Auto Theft,2022,7,58,0,51
D22,Auto Theft,2022,6,91,0,85
D22,Auto Theft,2022,13,195,0,182
D22,Auto Theft,2022,1,32,0,31
D22,Auto Theft,2022,5,52,0,47
D22,Auto Theft,2022,13,94,0,81
D22,Auto Theft,2022,4,65,0,61
D22,Auto Theft,2022,2,32,0,30
D22,Auto Theft,2022,2,31,0,29
D22,Auto Theft,2022,7,62,0,55
D22,Auto Theft,2022,0,6,0,6
D22,Auto Theft,2022,1,42,0,41
D22,Auto Theft,2022,5,61,0,56
D22,Auto Theft,2022,9,138,0,129
D22,Break & Enter-Apartment,2022,1,2,0,1
D22,Break & Enter-Apartment,2022,0,3,0,3
D22,Break & Enter-Apartment,2022,0,4,0,4
D22,Break & Enter-Apartment,2022,3,18,0,15
D22,Break & Enter-Apartment,2022,4,17,0,13
D22,Break & Enter-Apartment,2022,2,19,0,17
D22,Break & Enter-Apartment,2022,1,19,0,18
D22,Break & Enter-Apartment,2022,0,1,0,1
D22,Break & Enter-Apartment,2022,3,13,0,10
D22,Break & Enter-Apartment,2022,0,2,0,2
D22,Break & Enter-Apartment,2022,6,13,0,7
D22,Break & Enter-Apartment,2022,0,1,0,1
D22,Break & Enter-Apartment,2022,2,11,0,9
D22,Break & Enter-Apartment,2022,2,8,0,6
D22,Break & Enter-Commercial,2022,1,24,0,23
D22,Break & Enter-Commercial,2022,1,7,0,6
D22,Break & Enter-Commercial,2022,1,3,0,2
D22,Break & Enter-Commercial,2022,9,59,0,50
D22,Break & Enter-Commercial,2022,2,4,0,2
D22,Break & Enter-Commercial,2022,4,13,0,9
D22,Break & Enter-Commercial,2022,0,6,0,6
D22,Break & Enter-Commercial,2022,1,13,0,12
D22,Break & Enter-Commercial,2022,0,2,0,2
D22,Break & Enter-Commercial,2022,6,21,0,15
D22,Break & Enter-Commercial,2022,0,2,0,2
D22,Break & Enter-Commercial,2022,4,6,0,2
D22,Break & Enter-Commercial,2022,0,2,0,2
D22,Break & Enter-Commercial,2022,1,20,0,19
D22,Break & Enter-House,2022,3,10,0,7
D22,Break & Enter-House,2022,1,16,0,15
D22,Break & Enter-House,2022,2,10,0,8
D22,Break & Enter-House,2022,0,1,0,1
D22,Break & Enter-House,2022,4,20,0,16
D22,Break & Enter-House,2022,0,2,0,2
D14,Break & Enter-House,2022,2,5,0,3
D14,Auto Theft,2022,0,25,0,25
D14,Other,2022,36,39,0,3
D14,Break & Enter-House,2022,1,1,1,0
D14,Auto Theft,2022,0,5,0,5
D22,Break & Enter-House,2022,1,8,0,7
D14,Break & Enter-House,2022,3,4,0,1
D14,Other,2022,10,11,0,1
D14,Auto Theft,2022,4,16,0,12
D22,Break & Enter-House,2022,6,11,0,5
D14,Other,2022,7,7,1,0
D14,Break & Enter-Other,2022,1,1,1,0
D14,Other,2022,40,44,0,4
D14,Auto Theft,2022,2,13,0,11
D22,Break & Enter-House,2022,0,1,0,1
D22,Break & Enter-House,2022,1,5,0,4
D22,Break & Enter-House,2022,2,11,0,9
D22,Break & Enter-House,2022,2,9,0,7
D22,Break & Enter-Other,2022,1,6,0,5
D22,Break & Enter-Other,2022,0,1,0,1
D14,Break & Enter-Other,2022,0,3,0,3
D22,Break & Enter-Other,2022,0,1,0,1
D14,Auto Theft,2022,2,19,0,17
D14,Other,2022,21,24,0,3
D14,Break & Enter-Other,2022,2,4,0,2
D22,Break & Enter-Other,2022,0,8,0,8
D14,Auto Theft,2022,2,16,0,14
D14,Other,2022,56,64,0,8
D14,Break & Enter-Other,2022,2,6,0,4
D22,Break & Enter-Other,2022,0,4,0,4
D14,Auto Theft,2022,0,1,0,1
D14,Other,2022,25,35,0,10
D14,Break & Enter-Other,2022,1,3,0,2
D22,Break & Enter-Other,2022,2,4,0,2
D14,Auto Theft,2022,2,25,0,23
D14,Other,2022,12,14,0,2
D14,Break & Enter-Other,2022,1,2,0,1
D22,Break & Enter-Other,2022,1,1,1,0
D14,Auto Theft,2022,6,28,0,22
D14,Other,2022,55,66,0,11
D14,Break & Enter-Other,2022,1,4,0,3
D22,Break & Enter-Other,2022,0,2,0,2
D14,Auto Theft,2022,1,33,0,32
D14,Other,2022,67,82,0,15
D14,Break & Enter-Other,2022,2,5,0,3
D22,Break & Enter-Other,2022,0,5,0,5
D14,Auto Theft,2022,0,12,0,12
D14,Other,2022,0,1,0,1
D14,Break & Enter-Other,2022,1,8,0,7
D22,Break & Enter-Other,2022,0,2,0,2
D14,Auto Theft,2022,1,35,0,34
D14,Other,2022,86,95,0,9
D14,Break & Enter-Other,2022,1,2,0,1
D22,Break & Enter-Other,2022,2,2,1,0
D14,Auto Theft,2022,3,23,0,20
D14,Break & Enter-Apartment,2022,6,19,0,13
D14,Break & Enter-Apartment,2022,0,7,0,7
D14,Break & Enter-Apartment,2022,0,1,0,1
D14,Break & Enter-Apartment,2022,4,11,0,7
D14,Break & Enter-Apartment,2022,2,9,0,7
D14,Break & Enter-Apartment,2022,5,17,0,12
D14,Break & Enter-Apartment,2022,4,6,0,2
D14,Break & Enter-Apartment,2022,1,1,1,0
D14,Break & Enter-Apartment,2022,1,6,0,5
D14,Break & Enter-Apartment,2022,11,28,0,17
D14,Break & Enter-Apartment,2022,5,15,0,10
D14,Break & Enter-Apartment,2022,1,7,0,6
D14,Break & Enter-Apartment,2022,0,13,0,13
D14,Break & Enter-Apartment,2022,3,15,0,12
D14,Break & Enter-Commercial,2022,2,10,0,8
D14,Break & Enter-Commercial,2022,3,12,0,9
D14,Break & Enter-Commercial,2022,1,2,0,1
D14,Break & Enter-Commercial,2022,5,11,0,6
D14,Break & Enter-Commercial,2022,2,8,0,6
D14,Break & Enter-Commercial,2022,1,16,0,15
D14,Break & Enter-Commercial,2022,3,10,0,7
D14,Break & Enter-Commercial,2022,3,15,0,12
D14,Break & Enter-Commercial,2022,12,21,0,9
D14,Break & Enter-Commercial,2022,7,28,0,21
D14,Break & Enter-Commercial,2022,3,11,0,8
D14,Break & Enter-Commercial,2022,9,30,0,21
D14,Break & Enter-Commercial,2022,3,12,0,9
D14,Break & Enter-House,2022,4,9,0,5
D14,Break & Enter-House,2022,3,11,0,8
D14,Break & Enter-House,2022,3,6,0,3
D14,Break & Enter-House,2022,1,2,0,1
D14,Break & Enter-House,2022,2,2,1,0
D14,Break & Enter-House,2022,7,8,0,1
D14,Break & Enter-House,2022,3,5,0,2
D14,Break & Enter-House,2022,4,12,0,8
D14,Break & Enter-House,2022,2,8,0,6
D14,Other,2022,105,119,0,14
D14,Break & Enter-Other,2022,0,2,0,2
D14,Other,2022,0,1,0,1
D14,Break & Enter-Other,2022,2,5,0,3
D14,Other,2022,20,26,0,6
D14,Other,2022,153,172,0,19
D14,Other,2022,56,60,0,4
D14,Other,2022,24,27,0,3
D14,Other,2022,64,72,0,8
D14,Other,2022,54,63,0,9
D14,Other Criminal Violations - Offensive Weapons,2022,9,10,0,1
D14,Other Criminal Violations - Offensive Weapons,2022,2,2,1,0
D14,Other Criminal Violations - Offensive Weapons,2022,12,14,0,2
D14,Other Criminal Violations - Offensive Weapons,2022,6,8,0,2
D14,Other Criminal Violations - Offensive Weapons,2022,17,19,0,2
D14,Other Criminal Violations - Offensive Weapons,2022,3,6,0,3
D14,Other Criminal Violations - Offensive Weapons,2022,1,1,1,0
D14,Other Criminal Violations - Offensive Weapons,2022,4,4,1,0
D14,Other Criminal Violations - Offensive Weapons,2022,19,20,0,1
D14,Other Criminal Violations - Offensive Weapons,2022,7,9,0,2
D14,Other Criminal Violations - Offensive Weapons,2022,4,5,0,1
D14,Other Criminal Violations - Offensive Weapons,2022,26,31,0,5
D14,Other Criminal Violations - Offensive Weapons,2022,3,4,0,1
D14,Other,2022,1,2,0,1
D14,Other,2022,1,1,1,0
D14,Other,2022,1,1,1,0
D14,Other,2022,1,1,1,0
D14,Other,2022,1,1,1,0
D14,Other,2022,1,1,1,0
D14,Other,2022,1,1,1,0
D22,Other,2022,3,3,1,0
D22,Other,2022,1,1,1,0
D22,Other,2022,14,14,1,0
D22,Other,2022,1,1,1,0
D22,Other,2022,1,2,0,1
D22,Other,2022,2,2,1,0
D22,Other,2022,2,2,1,0
D22,Other,2022,14,18,0,4
D22,Other,2022,1,1,1,0
D14,Fraud,2022,6,60,0,54
D14,Fraud,2022,4,44,0,40
D14,Fraud,2022,0,15,0,15
D14,Fraud,2022,17,98,0,81
D22,Break & Enter-Other,2022,4,7,0,3
D22,Fraud,2022,7,36,0,29
D22,Fraud,2022,7,36,0,29
D22,Fraud,2022,6,54,0,48
D22,Fraud,2022,33,217,0,184
D22,Fraud,2022,5,24,0,19
D22,Fraud,2022,18,68,0,50
D22,Fraud,2022,14,82,0,68
D22,Fraud,2022,3,35,0,32
D22,Fraud,2022,6,42,0,36
D22,Fraud,2022,9,39,0,30
D22,Fraud,2022,12,76,0,64
D22,Fraud,2022,2,14,0,12
D22,Fraud,2022,4,52,0,48
D22,Fraud,2022,5,29,0,24
D22,Fraud,2022,14,74,0,60
D22,Other,2022,12,49,0,37
D22,Other,2022,8,32,0,24
D22,Other,2022,8,51,0,43
D22,Other,2022,51,178,0,127
D22,Other,2022,11,34,0,23
D22,Other,2022,14,60,0,46
D22,Other,2022,30,104,0,74
D22,Other,2022,4,33,0,29
D22,Other,2022,22,70,0,48
D22,Other,2022,13,43,0,30
D22,Other,2022,110,187,0,77
D22,Other,2022,0,7,0,7
D22,Other,2022,20,68,0,48
D22,Other,2022,5,28,0,23
D22,Other,2022,19,113,0,94
D14,Fraud,2022,6,62,0,56
D14,Fraud,2022,7,76,0,69
D14,Fraud,2022,6,41,0,35
D14,Fraud,2022,0,6,0,6
D14,Fraud,2022,4,73,0,69
D14,Fraud,2022,0,1,0,1
D14,Fraud,2022,0,1,0,1
D14,Fraud,2022,7,88,0,81
D14,Fraud,2022,9,114,0,105
D14,Fraud,2022,6,43,0,37
D14,Fraud,2022,11,161,0,150
D14,Fraud,2022,8,94,0,86
D14,Other,2022,24,96,0,72
D14,Other,2022,21,78,0,57
D14,Other,2022,7,23,0,16
D14,Other,2022,0,1,0,1
D14,Other,2022,39,113,0,74
D14,Other,2022,25,60,0,35
D14,Other,2022,39,117,0,78
D14,Other,2022,21,67,0,46
D14,Other,2022,3,11,0,8
D14,Other,2022,7,65,0,58
D14,Other,2022,49,150,0,101
D14,Other,2022,45,127,0,82
D14,Other,2022,14,56,0,42
D14,Other,2022,27,103,0,76
D14,Other,2022,27,99,0,72
D14,Theft Over $5000,2022,1,9,0,8
D14,Theft Over $5000,2022,0,4,0,4
D14,Theft Over $5000,2022,0,1,0,1
D14,Theft Over $5000,2022,3,15,0,12
D14,Theft Over $5000,2022,0,7,0,7
D14,Theft Over $5000,2022,2,9,0,7
D14,Theft Over $5000,2022,0,3,0,3
D14,Theft Over $5000,2022,2,7,0,5
D14,Theft Over $5000,2022,3,9,0,6
D14,Theft Over $5000,2022,2,10,0,8
D14,Theft Over $5000,2022,1,5,0,4
D14,Theft Over $5000,2022,0,11,0,11
D14,Theft Over $5000,2022,2,6,0,4
D14,Theft Under $5000,2022,64,482,0,418
D14,Theft Under $5000,2022,9,249,0,240
D14,Theft Under $5000,2022,1,45,0,44
D14,Theft Under $5000,2022,20,291,0,271
D14,Theft Under $5000,2022,46,399,0,353
D14,Theft Under $5000,2022,31,250,0,219
D14,Theft Under $5000,2022,9,121,0,112
D14,Theft Under $5000,2022,2,10,0,8
D14,Theft Under $5000,2022,24,312,0,288
D14,Theft Under $5000,2022,0,1,0,1
D14,Theft Under $5000,2022,132,784,0,652
D14,Theft Under $5000,2022,63,457,0,394
D14,Theft Under $5000,2022,9,223,0,214
D14,Theft Under $5000,2022,41,755,0,714
D14,Theft Under $5000,2022,16,209,0,193
D14,Assault,2022,55,100,0,45
D14,Assault,2022,46,77,0,31
D14,Assault,2022,18,27,0,9
D14,Assault,2022,92,138,0,46
D14,Assault,2022,73,103,0,30
D14,Assault,2022,0,1,0,1
D14,Assault,2022,1,1,1,0
D14,Assault,2022,133,205,0,72
D14,Assault,2022,47,76,0,29
D14,Assault,2022,7,10,0,3
D14,Assault,2022,33,71,0,38
D14,Assault,2022,155,216,0,61
D14,Assault,2022,73,126,0,53
D14,Assault,2022,34,65,0,31
D14,Assault,2022,100,203,0,103
D14,Assault,2022,61,106,0,45
D14,Attempt Murder,2022,2,2,1,0
D14,Attempt Murder,2022,1,1,1,0
D14,Attempt Murder,2022,1,1,1,0
D14,Attempt Murder,2022,1,1,1,0
D14,Attempt Murder,2022,1,1,1,0
D14,Other,2022,7,13,0,6
D14,Other,2022,6,11,0,5
D14,Other,2022,3,4,0,1
D14,Other,2022,12,22,0,10
D14,Other,2022,8,10,0,2
D14,Other,2022,9,13,0,4
D14,Other,2022,5,5,1,0
D14,Other,2022,0,1,0,1
D14,Other,2022,11,16,0,5
D14,Other,2022,23,32,0,9
D14,Other,2022,8,15,0,7
D14,Other,2022,11,15,0,4
D14,Other,2022,15,21,0,6
D14,Other,2022,3,7,0,4
D14,Robbery-Financial,2022,1,2,0,1
D14,Robbery-Financial,2022,2,2,1,0
D14,Robbery-Financial,2022,1,1,1,0
D14,Robbery-Other,2022,9,15,0,6
D14,Robbery-Other,2022,3,8,0,5
D14,Robbery-Other,2022,1,4,0,3
D14,Robbery-Other,2022,8,11,0,3
D14,Robbery-Other,2022,4,9,0,5
D14,Robbery-Other,2022,5,11,0,6
D14,Robbery-Other,2022,7,8,0,1
D14,Robbery-Other,2022,0,1,0,1
D14,Robbery-Other,2022,4,11,0,7
D14,Robbery-Other,2022,5,6,0,1
D14,Robbery-Other,2022,22,25,0,3
D14,Robbery-Other,2022,4,6,0,2
D14,Robbery-Other,2022,7,16,0,9
D14,Robbery-Other,2022,2,6,0,4
D14,Sexual Violation,2022,11,14,0,3
D14,Sexual Violation,2022,9,10,0,1
D14,Sexual Violation,2022,1,5,0,4
D14,Sexual Violation,2022,5,19,0,14
D14,Sexual Violation,2022,7,13,0,6
D14,Sexual Violation,2022,3,21,0,18
D14,Sexual Violation,2022,10,20,0,10
D14,Sexual Violation,2022,1,1,1,0
D14,Sexual Violation,2022,3,8,0,5
D14,Sexual Violation,2022,9,26,0,17
D14,Sexual Violation,2022,7,19,0,12
D14,Sexual Violation,2022,8,14,0,6
D14,Sexual Violation,2022,10,38,0,28
D14,Sexual Violation,2022,8,18,0,10
D14,Other,2022,5,5,1,0
D14,Other,2022,7,7,1,0
D14,Other,2022,3,4,0,1
D14,Other,2022,28,30,0,2
D14,Other,2022,19,19,1,0
D14,Other,2022,10,12,0,2
D14,Other,2022,9,9,1,0
D14,Other,2022,1,1,1,0
D14,Other,2022,7,8,0,1
D23,Other,2022,2,2,1,0
D23,Other,2022,15,20,0,5
D23,Other,2022,11,15,0,4
D23,Other,2022,79,97,0,18
D23,Other,2022,9,13,0,4
D23,Other Criminal Violations - Offensive Weapons,2022,4,6,0,2
D23,Other Criminal Violations - Offensive Weapons,2022,2,2,1,0
D23,Other Criminal Violations - Offensive Weapons,2022,12,16,0,4
D23,Other Criminal Violations - Offensive Weapons,2022,3,3,1,0
D23,Other Criminal Violations - Offensive Weapons,2022,1,1,1,0
D23,Other Criminal Violations - Offensive Weapons,2022,16,19,0,3
D23,Other Criminal Violations - Offensive Weapons,2022,2,4,0,2
D31,Assault,2022,63,76,0,13
D23,Other,2022,0,1,0,1
D23,Other,2022,2,4,0,2
D31,Other,2022,1,1,1,0
D31,Assault,2022,149,227,0,78
D22,Other,2022,26,28,0,2
D22,Other,2022,0,1,0,1
D31,Other,2022,3,3,1,0
D31,Assault,2022,68,96,0,28
D22,Other,2022,16,19,0,3
D22,Other,2022,2,7,0,5
D31,Other,2022,8,8,1,0
D31,Assault,2022,66,95,0,29
D23,Other,2022,3,4,0,1
D22,Other,2022,1,1,1,0
D22,Other,2022,17,28,0,11
D31,Other,2022,5,6,0,1
D31,Break & Enter-House,2022,4,6,0,2
D31,Assault,2022,15,22,0,7
D31,Assault,2022,179,259,0,80
D31,Assault,2022,16,34,0,18
D31,Assault,2022,147,226,0,79
D31,Attempt Murder,2022,1,1,1,0
D31,Other,2022,31,46,0,15
D31,Other,2022,11,14,0,3
D31,Other,2022,20,37,0,17
D31,Other,2022,17,17,1,0
D31,Other,2022,18,25,0,7
D31,Other,2022,2,5,0,3
D31,Other,2022,29,46,0,17
D31,Other,2022,12,12,1,0
D31,Other,2022,33,42,0,9
D31,Robbery-Financial,2022,0,1,0,1
D31,Robbery-Other,2022,5,14,0,9
D31,Robbery-Other,2022,2,4,0,2
D31,Robbery-Other,2022,12,27,0,15
D31,Robbery-Other,2022,15,24,0,9
D31,Robbery-Other,2022,9,30,0,21
D31,Robbery-Other,2022,1,1,1,0
D31,Robbery-Other,2022,18,29,0,11
D31,Robbery-Other,2022,4,5,0,1
D31,Robbery-Other,2022,19,38,0,19
D31,Sexual Violation,2022,18,36,0,18
D31,Sexual Violation,2022,10,14,0,4
D31,Sexual Violation,2022,19,36,0,17
D31,Sexual Violation,2022,5,9,0,4
D31,Sexual Violation,2022,15,21,0,6
D31,Sexual Violation,2022,2,4,0,2
D31,Sexual Violation,2022,15,34,0,19
D31,Sexual Violation,2022,6,8,0,2
D31,Sexual Violation,2022,18,35,0,17
D31,Other,2022,4,5,0,1
D31,Other,2022,15,16,0,1
D31,Other,2022,18,20,0,2
D31,Other,2022,21,24,0,3
D31,Other,2022,11,13,0,2
D31,Other,2022,3,4,0,1
D31,Other,2022,18,23,0,5
D31,Other,2022,5,5,1,0
D31,Other,2022,30,34,0,4
D31,Other,2022,129,159,0,30
D31,Other,2022,23,35,0,12
D31,Other,2022,83,104,0,21
D31,Other,2022,30,43,0,13
D23,Fraud,2022,1,1,1,0
D23,Other,2022,1,1,1,0
D22,Other,2022,10,13,0,3
D22,Other,2022,10,13,0,3
D31,Break & Enter-House,2022,3,5,0,2
D23,Fraud,2022,4,39,0,35
D22,Other,2022,5,8,0,3
D22,Other,2022,4,4,1,0
D23,Fraud,2022,12,43,0,31
D31,Break & Enter-House,2022,3,5,0,2
D31,Other,2022,2,2,1,0
D22,Other,2022,9,11,0,2
D22,Other,2022,16,17,0,1
D31,Break & Enter-House,2022,5,10,0,5
D23,Fraud,2022,33,239,0,206
D22,Other,2022,3,5,0,2
D31,Other,2022,17,18,0,1
D22,Other,2022,0,1,0,1
D31,Break & Enter-House,2022,0,4,0,4
D23,Fraud,2022,7,54,0,47
D22,Other,2022,3,6,0,3
D31,Other,2022,0,1,0,1
D22,Other,2022,10,10,1,0
D31,Break & Enter-House,2022,6,11,0,5
D23,Other,2022,1,4,0,3
D22,Other,2022,2,5,0,3
D31,Other,2022,4,5,0,1
D22,Other,2022,3,3,1,0
D31,Break & Enter-Other,2022,3,3,1,0
D23,Other,2022,7,36,0,29
D22,Other,2022,30,47,0,17
D22,Other,2022,14,20,0,6
D22,Other,2022,1,1,1,0
D22,Other,2022,6,11,0,5
D22,Robbery-Financial,2022,0,1,0,1
D22,Robbery-Financial,2022,1,1,1,0
D22,Robbery-Financial,2022,0,2,0,2
D22,Robbery-Financial,2022,0,1,0,1
D22,Robbery-Other,2022,3,6,0,3
D22,Robbery-Other,2022,2,6,0,4
D22,Robbery-Other,2022,2,8,0,6
D22,Robbery-Other,2022,15,32,0,17
D22,Robbery-Other,2022,2,3,0,1
D22,Robbery-Other,2022,4,7,0,3
D22,Robbery-Other,2022,11,19,0,8
D22,Robbery-Other,2022,2,6,0,4
D22,Robbery-Other,2022,1,4,0,3
D22,Robbery-Other,2022,8,11,0,3
D22,Robbery-Other,2022,4,12,0,8
D22,Robbery-Other,2022,9,15,0,6
D22,Robbery-Other,2022,1,2,0,1
D22,Robbery-Other,2022,4,6,0,2
D22,Sexual Violation,2022,6,11,0,5
D22,Sexual Violation,2022,3,5,0,2
D22,Sexual Violation,2022,2,4,0,2
D22,Sexual Violation,2022,7,16,0,9
D22,Sexual Violation,2022,4,5,0,1
D22,Sexual Violation,2022,4,9,0,5
D22,Sexual Violation,2022,6,12,0,6
D22,Sexual Violation,2022,4,6,0,2
D22,Sexual Violation,2022,7,8,0,1
D22,Sexual Violation,2022,2,4,0,2
D22,Sexual Violation,2022,1,14,0,13
D22,Sexual Violation,2022,7,15,0,8
D22,Sexual Violation,2022,2,5,0,3
D22,Sexual Violation,2022,5,21,0,16
D22,Other,2022,11,12,0,1
D22,Other,2022,9,11,0,2
D22,Other,2022,7,7,1,0
D22,Other,2022,17,17,1,0
D22,Other,2022,6,6,1,0
D22,Other,2022,24,27,0,3
D31,Auto Theft,2022,2,72,0,70
D23,Other,2022,6,26,0,20
D31,Break & Enter-Other,2022,1,4,0,3
D22,Other,2022,18,22,0,4
D31,Auto Theft,2022,5,76,0,71
D31,Auto Theft,2022,5,162,0,157
D31,Auto Theft,2022,12,173,0,161
D31,Auto Theft,2022,3,105,0,102
D31,Auto Theft,2022,0,21,0,21
D31,Auto Theft,2022,3,110,0,107
D31,Auto Theft,2022,1,48,0,47
D31,Auto Theft,2022,9,154,0,145
D31,Break & Enter-Apartment,2022,12,23,0,11
D31,Break & Enter-Apartment,2022,2,4,0,2
D31,Break & Enter-Apartment,2022,5,9,0,4
D31,Break & Enter-Apartment,2022,1,5,0,4
D31,Break & Enter-Apartment,2022,5,9,0,4
D31,Break & Enter-Apartment,2022,0,3,0,3
D31,Break & Enter-Apartment,2022,2,7,0,5
D31,Break & Enter-Apartment,2022,4,6,0,2
D31,Break & Enter-Apartment,2022,8,17,0,9
D31,Break & Enter-Commercial,2022,3,5,0,2
D31,Break & Enter-Commercial,2022,3,10,0,7
D31,Break & Enter-Commercial,2022,6,14,0,8
D31,Break & Enter-Commercial,2022,10,41,0,31
D31,Break & Enter-Commercial,2022,0,19,0,19
D31,Break & Enter-Commercial,2022,4,28,0,24
D31,Break & Enter-Commercial,2022,1,3,0,2
D31,Break & Enter-Commercial,2022,9,33,0,24
D31,Break & Enter-House,2022,1,2,0,1
D31,Break & Enter-House,2022,5,8,0,3
D31,Break & Enter-Other,2022,1,5,0,4
D22,Other,2022,12,16,0,4
D31,Break & Enter-Other,2022,0,4,0,4
D31,Break & Enter-Other,2022,1,2,0,1
D22,Other,2022,9,11,0,2
D31,Break & Enter-Other,2022,2,5,0,3
D22,Other,2022,99,119,0,20
D31,Break & Enter-Other,2022,3,7,0,4
D22,Other,2022,24,30,0,6
D23,Other,2022,17,90,0,73
D31,Fraud,2022,5,64,0,59
D22,Other,2022,40,50,0,10
D23,Other,2022,21,94,0,73
D31,Fraud,2022,4,45,0,41
D22,Other,2022,8,8,1,0
D23,Other,2022,1,6,0,5
D22,Other,2022,23,37,0,14
D23,Other,2022,8,42,0,34
D22,Other,2022,6,11,0,5
D23,Other,2022,13,32,0,19
D22,Other,2022,44,52,0,8
D23,Other,2022,58,244,0,186
D31,Fraud,2022,11,98,0,87
D22,Other,2022,15,25,0,10
D23,Other,2022,9,68,0,59
D31,Fraud,2022,1,62,0,61
D22,Other,2022,91,120,0,29
D23,Theft Over $5000,2022,0,2,0,2
D31,Fraud,2022,1,40,0,39
D22,Other,2022,5,6,0,1
D23,Theft Over $5000,2022,0,1,0,1
D31,Fraud,2022,0,6,0,6
D22,Other,2022,41,49,0,8
D23,Theft Over $5000,2022,1,6,0,5
D31,Fraud,2022,10,88,0,78
D22,Other,2022,10,13,0,3
D23,Theft Over $5000,2022,1,18,0,17
D31,Fraud,2022,1,12,0,11
D22,Other,2022,35,46,0,11
D23,Theft Over $5000,2022,0,1,0,1
D31,Fraud,2022,13,150,0,137
D22,Other Criminal Violations - Offensive Weapons,2022,3,3,1,0
D23,Theft Over $5000,2022,1,9,0,8
D31,Other,2022,37,116,0,79
D22,Other Criminal Violations - Offensive Weapons,2022,2,2,1,0
D23,Theft Over $5000,2022,0,2,0,2
D31,Other,2022,18,67,0,49
D22,Other Criminal Violations - Offensive Weapons,2022,5,7,0,2
D23,Theft Over $5000,2022,4,62,0,58
D31,Other,2022,36,132,0,96
D22,Other Criminal Violations - Offensive Weapons,2022,12,18,0,6
D23,Theft Over $5000,2022,1,5,0,4
D31,Other,2022,26,88,0,62
D22,Other Criminal Violations - Offensive Weapons,2022,3,4,0,1
D23,Theft Under $5000,2022,1,14,0,13
D31,Other,2022,16,56,0,40
D22,Other Criminal Violations - Offensive Weapons,2022,4,4,1,0
D23,Theft Under $5000,2022,16,130,0,114
D31,Other,2022,3,19,0,16
D22,Other Criminal Violations - Offensive Weapons,2022,7,9,0,2
D31,Other,2022,62,188,0,126
D23,Theft Under $5000,2022,1,1,1,0
D31,Other,2022,4,31,0,27
D22,Other Criminal Violations - Offensive Weapons,2022,5,5,1,0
D31,Other,2022,50,183,0,133
D22,Other Criminal Violations - Offensive Weapons,2022,2,3,0,1
D31,Theft Over $5000,2022,3,8,0,5
D22,Other Criminal Violations - Offensive Weapons,2022,54,69,0,15
D31,Theft Over $5000,2022,2,11,0,9
D23,Theft Under $5000,2022,4,43,0,39
D22,Other Criminal Violations - Offensive Weapons,2022,2,9,0,7
D31,Theft Over $5000,2022,2,11,0,9
D23,Theft Under $5000,2022,8,178,0,170
D22,Other Criminal Violations - Offensive Weapons,2022,6,8,0,2
D31,Theft Over $5000,2022,3,23,0,20
D23,Theft Under $5000,2022,10,414,0,404
D22,Other,2022,0,1,0,1
D31,Theft Over $5000,2022,1,9,0,8
D23,Theft Under $5000,2022,1,6,0,5
D22,Other,2022,0,1,0,1
D31,Theft Over $5000,2022,0,3,0,3
D23,Theft Under $5000,2022,0,1,0,1
D22,Other,2022,0,1,0,1
D31,Theft Over $5000,2022,2,20,0,18
D23,Theft Under $5000,2022,7,98,0,91
D22,Other,2022,1,1,1,0
D31,Theft Over $5000,2022,2,6,0,4
D23,Theft Under $5000,2022,2,69,0,67
D22,Other,2022,1,1,1,0
D31,Theft Over $5000,2022,5,31,0,26
D23,Theft Under $5000,2022,61,938,0,877
D22,Other,2022,1,2,0,1
D31,Theft Under $5000,2022,38,265,0,227
D23,Theft Under $5000,2022,16,225,0,209
D22,Other,2022,1,2,0,1
D31,Theft Under $5000,2022,12,150,0,138
D23,Assault,2022,1,1,1,0
D23,Other,2022,4,6,0,2
D31,Theft Under $5000,2022,47,240,0,193
D23,Assault,2022,33,55,0,22
D23,Other,2022,1,1,1,0
D23,Assault,2022,16,25,0,9
D23,Other,2022,1,1,1,0
D23,Assault,2022,73,115,0,42
D31,Theft Under $5000,2022,18,253,0,235
D23,Other,2022,7,7,1,0
D23,Assault,2022,150,236,0,86
D31,Theft Under $5000,2022,10,136,0,126
D23,Other,2022,2,2,1,0
D23,Assault,2022,3,5,0,2
D31,Theft Under $5000,2022,2,30,0,28
D23,Assault,2022,0,1,0,1
D31,Theft Under $5000,2022,90,499,0,409
D23,Assault,2022,38,56,0,18
D31,Theft Under $5000,2022,7,47,0,40
D23,Assault,2022,0,1,0,1
D31,Theft Under $5000,2022,32,375,0,343
D23,Assault,2022,28,45,0,17
D31,Assault,2022,135,184,0,49
D23,Assault,2022,184,251,0,67
D23,Assault,2022,46,92,0,46
D23,Other,2022,2,5,0,3
D23,Attempt Murder,2022,1,3,0,2
D23,Other,2022,15,20,0,5
D23,Attempt Murder,2022,0,1,0,1
D23,Other,2022,1,3,0,2
D23,Auto Theft,2022,3,17,0,14
D23,Auto Theft,2022,0,61,0,61
D23,Auto Theft,2022,2,29,0,27
D23,Auto Theft,2022,0,1,0,1
D23,Auto Theft,2022,11,118,0,107
D23,Auto Theft,2022,7,120,0,113
D23,Auto Theft,2022,0,14,0,14
D23,Auto Theft,2022,4,55,0,51
D23,Auto Theft,2022,1,55,0,54
D23,Auto Theft,2022,47,773,0,726
D23,Auto Theft,2022,3,104,0,101
D23,Break & Enter-Apartment,2022,0,3,0,3
D23,Break & Enter-Apartment,2022,1,3,0,2
D23,Break & Enter-Apartment,2022,2,6,0,4
D23,Break & Enter-Apartment,2022,1,4,0,3
D23,Break & Enter-Apartment,2022,6,14,0,8
D23,Break & Enter-Apartment,2022,1,6,0,5
D23,Break & Enter-Apartment,2022,0,1,0,1
D23,Break & Enter-Apartment,2022,1,9,0,8
D23,Break & Enter-Apartment,2022,0,6,0,6
D23,Break & Enter-Commercial,2022,0,1,0,1
D23,Break & Enter-Commercial,2022,0,2,0,2
D23,Break & Enter-Commercial,2022,2,4,0,2
D23,Break & Enter-Commercial,2022,3,3,1,0
D23,Break & Enter-Commercial,2022,3,12,0,9
D23,Break & Enter-Commercial,2022,17,103,0,86
D23,Break & Enter-Commercial,2022,3,8,0,5
D23,Break & Enter-House,2022,0,4,0,4
D23,Break & Enter-House,2022,1,4,0,3
D23,Break & Enter-House,2022,0,5,0,5
D23,Break & Enter-House,2022,1,8,0,7
D23,Break & Enter-House,2022,4,6,0,2
D23,Break & Enter-House,2022,0,2,0,2
D23,Break & Enter-House,2022,2,18,0,16
D23,Break & Enter-House,2022,1,9,0,8
D23,Break & Enter-Other,2022,0,1,0,1
D23,Break & Enter-Other,2022,0,3,0,3
D23,Break & Enter-Other,2022,2,7,0,5
D23,Break & Enter-Other,2022,2,2,1,0
D23,Break & Enter-Other,2022,0,6,0,6
D23,Break & Enter-Other,2022,1,4,0,3
D23,Fraud,2022,0,5,0,5
D23,Fraud,2022,3,44,0,41
D23,Fraud,2022,2,20,0,18
D23,Fraud,2022,8,66,0,58
D23,Fraud,2022,26,136,0,110
D23,Other,2022,9,15,0,6
D23,Other,2022,8,9,0,1
D23,Other,2022,8,21,0,13
D23,Other,2022,26,42,0,16
D23,Other,2022,11,15,0,4
D23,Other,2022,4,8,0,4
D23,Other,2022,33,55,0,22
D23,Other,2022,9,18,0,9
D23,Robbery-Financial,2022,3,3,1,0
D23,Robbery-Financial,2022,1,1,1,0
D23,Robbery-Financial,2022,0,2,0,2
D23,Robbery-Other,2022,2,11,0,9
D23,Robbery-Other,2022,6,7,0,1
D23,Robbery-Other,2022,0,1,0,1
D23,Robbery-Other,2022,7,9,0,2
D23,Robbery-Other,2022,26,45,0,19
D23,Robbery-Other,2022,1,1,1,0
D23,Robbery-Other,2022,5,11,0,6
D23,Robbery-Other,2022,3,15,0,12
D23,Robbery-Other,2022,24,51,0,27
D23,Robbery-Other,2022,4,13,0,9
D23,Sexual Violation,2022,0,2,0,2
D23,Sexual Violation,2022,4,7,0,3
D23,Sexual Violation,2022,2,5,0,3
D23,Sexual Violation,2022,10,17,0,7
D23,Sexual Violation,2022,28,44,0,16
D23,Sexual Violation,2022,2,2,1,0
D23,Sexual Violation,2022,7,8,0,1
D23,Sexual Violation,2022,7,8,0,1
D23,Sexual Violation,2022,12,26,0,14
D23,Sexual Violation,2022,9,11,0,2
D23,Other,2022,3,3,1,0
D23,Other,2022,5,6,0,1
D23,Other,2022,2,2,1,0
D23,Other,2022,3,3,1,0
D23,Other,2022,6,6,1,0
D23,Other,2022,21,21,1,0
D23,Other,2022,3,4,0,1
D23,Other,2022,2,4,0,2
D23,Other,2022,2,2,1,0
D23,Other,2022,14,15,0,1
D23,Other,2022,47,56,0,9
D23,Other,2022,10,10,1,0
D23,Other,2022,2,2,1,0
D23,Other,2022,20,24,0,4
D23,Other,2022,10,10,1,0
D23,Other,2022,18,21,0,3
D23,Other,2022,26,31,0,5
D23,Other,2022,103,115,0,12
D32,Other,2022,22,101,0,79
D32,Break & Enter-House,2022,0,14,0,14
D32,Break & Enter-Other,2022,0,1,0,1
D32,Other,2022,15,67,0,52
D32,Break & Enter-Other,2022,1,3,0,2
D32,Other,2022,23,83,0,60
D32,Theft Over $5000,2022,0,9,0,9
D31,Other,2022,110,120,0,10
D32,Assault,2022,36,61,0,25
D32,Other,2022,27,36,0,9
D32,Auto Theft,2022,8,147,0,139
D32,Break & Enter-Other,2022,0,3,0,3
D31,Other,2022,1,1,1,0
D33,Auto Theft,2022,1,29,0,28
D32,Break & Enter-Apartment,2022,1,2,0,1
D32,Other,2022,8,12,0,4
D32,Assault,2022,28,60,0,32
D32,Theft Over $5000,2022,3,6,0,3
D32,Break & Enter-Other,2022,1,1,1,0
D31,Other,2022,6,9,0,3
D33,Auto Theft,2022,0,16,0,16
D32,Assault,2022,7,28,0,21
D32,Break & Enter-Apartment,2022,6,9,0,3
D32,Other,2022,13,16,0,3
D32,Theft Over $5000,2022,0,6,0,6
D32,Break & Enter-Other,2022,0,2,0,2
D31,Other,2022,142,169,0,27
D33,Auto Theft,2022,0,7,0,7
D32,Assault,2022,1,2,0,1
D32,Break & Enter-Apartment,2022,0,2,0,2
D32,Other,2022,19,23,0,4
D32,Theft Over $5000,2022,1,2,0,1
D32,Break & Enter-Other,2022,0,2,0,2
D31,Other,2022,6,9,0,3
D33,Auto Theft,2022,0,40,0,40
D32,Robbery-Other,2022,4,6,0,2
D32,Assault,2022,4,7,0,3
D32,Break & Enter-Apartment,2022,0,2,0,2
D32,Other,2022,6,6,1,0
D32,Theft Over $5000,2022,3,10,0,7
D32,Break & Enter-Other,2022,0,1,0,1
D31,Other,2022,83,99,0,16
D33,Auto Theft,2022,0,26,0,26
D32,Assault,2022,36,68,0,32
D32,Robbery-Other,2022,8,23,0,15
D32,Break & Enter-Apartment,2022,9,16,0,7
D32,Other,2022,22,27,0,5
D32,Theft Over $5000,2022,0,4,0,4
D32,Break & Enter-Other,2022,1,7,0,6
D31,Other Criminal Violations - Offensive Weapons,2022,15,25,0,10
D33,Auto Theft,2022,0,50,0,50
D32,Assault,2022,135,211,0,76
D32,Robbery-Other,2022,3,6,0,3
D32,Break & Enter-Apartment,2022,1,4,0,3
D32,Other,2022,5,7,0,2
D32,Theft Over $5000,2022,2,13,0,11
D32,Break & Enter-Other,2022,0,2,0,2
D31,Other Criminal Violations - Offensive Weapons,2022,5,12,0,7
D31,Other Criminal Violations - Offensive Weapons,2022,33,50,0,17
D31,Other Criminal Violations - Offensive Weapons,2022,7,11,0,4
D31,Other Criminal Violations - Offensive Weapons,2022,7,11,0,4
D31,Other Criminal Violations - Offensive Weapons,2022,1,2,0,1
D31,Other Criminal Violations - Offensive Weapons,2022,40,57,0,17
D31,Other Criminal Violations - Offensive Weapons,2022,4,8,0,4
D31,Other Criminal Violations - Offensive Weapons,2022,22,37,0,15
D31,Other,2022,1,1,1,0
D31,Other,2022,0,1,0,1
D31,Other,2022,1,3,0,2
D31,Other,2022,0,1,0,1
D32,Other,2022,6,6,1,0
D32,Other,2022,2,2,1,0
D32,Other,2022,2,2,1,0
D32,Other,2022,1,1,1,0
D32,Other,2022,3,3,1,0
D32,Other,2022,5,6,0,1
D32,Other,2022,1,1,1,0
D32,Other,2022,2,2,1,0
D32,Other,2022,1,1,1,0
D32,Other,2022,2,2,1,0
D32,Other,2022,3,3,1,0
D32,Other,2022,5,6,0,1
D32,Auto Theft,2022,1,20,0,19
D32,Auto Theft,2022,1,78,0,77
D32,Auto Theft,2022,1,122,0,121
D32,Auto Theft,2022,4,30,0,26
D32,Auto Theft,2022,24,164,0,140
D32,Auto Theft,2022,3,49,0,46
D32,Auto Theft,2022,2,44,0,42
D32,Auto Theft,2022,3,29,0,26
D32,Auto Theft,2022,3,66,0,63
D32,Auto Theft,2022,4,81,0,77
D32,Auto Theft,2022,0,1,0,1
D32,Auto Theft,2022,0,10,0,10
D32,Auto Theft,2022,1,59,0,58
D32,Auto Theft,2022,1,172,0,171
D32,Auto Theft,2022,0,34,0,34
D32,Auto Theft,2022,2,85,0,83
D32,Auto Theft,2022,2,44,0,42
D32,Auto Theft,2022,5,45,0,40
D32,Auto Theft,2022,12,80,0,68
D32,Other,2022,3,3,1,0
D32,Break & Enter-Apartment,2022,2,5,0,3
D32,Robbery-Other,2022,5,10,0,5
D32,Theft Over $5000,2022,1,3,0,2
D33,Auto Theft,2022,0,2,0,2
D32,Break & Enter-Other,2022,0,2,0,2
D32,Other,2022,15,23,0,8
D32,Break & Enter-Apartment,2022,2,5,0,3
D32,Robbery-Other,2022,2,3,0,1
D32,Theft Over $5000,2022,2,12,0,10
D32,Assault,2022,13,22,0,9
D33,Auto Theft,2022,2,21,0,19
D32,Break & Enter-Other,2022,1,2,0,1
D32,Theft Over $5000,2022,0,3,0,3
D32,Robbery-Other,2022,1,6,0,5
D33,Auto Theft,2022,0,2,0,2
D32,Assault,2022,51,75,0,24
D32,Other,2022,48,68,0,20
D32,Break & Enter-Other,2022,0,4,0,4
D32,Theft Over $5000,2022,1,10,0,9
D32,Robbery-Other,2022,1,4,0,3
D33,Break & Enter-Apartment,2022,0,4,0,4
D32,Assault,2022,68,110,0,42
D32,Other,2022,3,4,0,1
D32,Break & Enter-Apartment,2022,1,1,1,0
D32,Break & Enter-Other,2022,0,1,0,1
D32,Theft Over $5000,2022,2,13,0,11
D32,Robbery-Other,2022,12,21,0,9
D33,Break & Enter-Apartment,2022,2,10,0,8
D32,Assault,2022,43,77,0,34
D32,Other,2022,17,22,0,5
D32,Break & Enter-Apartment,2022,0,4,0,4
D32,Break & Enter-Other,2022,1,2,0,1
D32,Theft Over $5000,2022,0,4,0,4
D32,Sexual Violation,2022,6,10,0,4
D33,Break & Enter-Apartment,2022,0,2,0,2
D32,Assault,2022,28,53,0,25
D32,Other,2022,122,130,0,8
D32,Break & Enter-Apartment,2022,6,11,0,5
D32,Fraud,2022,4,56,0,52
D32,Theft Over $5000,2022,3,11,0,8
D32,Sexual Violation,2022,3,7,0,4
D33,Break & Enter-Apartment,2022,0,9,0,9
D32,Assault,2022,54,92,0,38
D32,Other,2022,25,30,0,5
D32,Break & Enter-Apartment,2022,1,3,0,2
D32,Fraud,2022,2,52,0,50
D32,Theft Over $5000,2022,1,9,0,8
D32,Sexual Violation,2022,15,18,0,3
D32,Other,2022,86,97,0,11
D33,Break & Enter-Apartment,2022,4,6,0,2
D32,Attempt Murder,2022,1,1,1,0
D33,Break & Enter-Apartment,2022,4,21,0,17
D32,Other,2022,25,31,0,6
D32,Break & Enter-Apartment,2022,9,20,0,11
D32,Fraud,2022,3,52,0,49
D32,Theft Over $5000,2022,2,14,0,12
D32,Sexual Violation,2022,1,3,0,2
D33,Break & Enter-Apartment,2022,0,2,0,2
D32,Fraud,2022,1,12,0,11
D32,Break & Enter-Apartment,2022,5,6,0,1
D32,Theft Over $5000,2022,6,29,0,23
D32,Sexual Violation,2022,3,7,0,4
D33,Break & Enter-Apartment,2022,2,4,0,2
D32,Fraud,2022,10,96,0,86
D32,Break & Enter-Apartment,2022,1,2,0,1
D32,Theft Over $5000,2022,6,36,0,30
D32,Sexual Violation,2022,3,5,0,2
D33,Break & Enter-Apartment,2022,0,6,0,6
D32,Fraud,2022,0,21,0,21
D32,Break & Enter-Apartment,2022,0,4,0,4
D32,Theft Under $5000,2022,9,129,0,120
D32,Sexual Violation,2022,6,9,0,3
D33,Break & Enter-Apartment,2022,3,8,0,5
D32,Fraud,2022,4,63,0,59
D32,Break & Enter-Apartment,2022,0,1,0,1
D32,Theft Under $5000,2022,10,150,0,140
D32,Sexual Violation,2022,6,20,0,14
D33,Break & Enter-Commercial,2022,0,12,0,12
D32,Fraud,2022,0,39,0,39
D32,Break & Enter-Commercial,2022,0,4,0,4
D32,Theft Under $5000,2022,1,2,0,1
D32,Sexual Violation,2022,3,4,0,1
D33,Break & Enter-Commercial,2022,0,6,0,6
D32,Fraud,2022,3,74,0,71
D32,Break & Enter-Commercial,2022,0,5,0,5
D32,Theft Under $5000,2022,9,138,0,129
D32,Sexual Violation,2022,3,4,0,1
D33,Break & Enter-Commercial,2022,0,1,0,1
D32,Fraud,2022,2,55,0,53
D32,Break & Enter-Commercial,2022,1,23,0,22
D32,Theft Under $5000,2022,2,57,0,55
D32,Sexual Violation,2022,0,1,0,1
D32,Sexual Violation,2022,12,17,0,5
D32,Sexual Violation,2022,12,23,0,11
D32,Sexual Violation,2022,1,2,0,1
D32,Sexual Violation,2022,7,13,0,6
D32,Sexual Violation,2022,11,15,0,4
D32,Sexual Violation,2022,1,8,0,7
D32,Sexual Violation,2022,1,3,0,2
D32,Sexual Violation,2022,3,10,0,7
D32,Other,2022,7,7,1,0
D32,Other,2022,9,9,1,0
D32,Other,2022,3,4,0,1
D32,Other,2022,1,1,1,0
D32,Other,2022,10,10,1,0
D32,Other,2022,1,1,1,0
D32,Other,2022,2,2,1,0
D32,Other,2022,2,2,1,0
D32,Other,2022,7,8,0,1
D32,Other,2022,1,2,0,1
D32,Other,2022,1,1,1,0
D32,Other,2022,8,9,0,1
D32,Other,2022,11,11,1,0
D32,Other,2022,6,6,1,0
D32,Other,2022,1,4,0,3
D32,Other,2022,4,4,1,0
D32,Other,2022,4,4,1,0
D32,Other,2022,12,12,1,0
D32,Other,2022,15,16,0,1
D32,Other,2022,5,10,0,5
D32,Other,2022,16,24,0,8
D32,Other,2022,15,16,0,1
D32,Other,2022,1,3,0,2
D32,Other Criminal Violations - Offensive Weapons,2022,4,6,0,2
D32,Attempt Murder,2022,3,3,1,0
D33,Break & Enter-Commercial,2022,0,7,0,7
D32,Other Criminal Violations - Offensive Weapons,2022,0,2,0,2
D32,Attempt Murder,2022,1,1,1,0
D32,Break & Enter-Commercial,2022,0,5,0,5
D32,Theft Under $5000,2022,91,517,0,426
D33,Break & Enter-Commercial,2022,0,1,0,1
D32,Other Criminal Violations - Offensive Weapons,2022,6,9,0,3
D32,Fraud,2022,0,8,0,8
D32,Other,2022,5,7,0,2
D32,Break & Enter-Commercial,2022,2,14,0,12
D32,Theft Under $5000,2022,4,87,0,83
D33,Break & Enter-Commercial,2022,3,7,0,4
D32,Fraud,2022,5,57,0,52
D32,Other Criminal Violations - Offensive Weapons,2022,1,3,0,2
D32,Fraud,2022,5,103,0,98
D32,Break & Enter-Commercial,2022,0,4,0,4
D32,Theft Under $5000,2022,4,122,0,118
D33,Break & Enter-Commercial,2022,2,17,0,15
D32,Other,2022,4,9,0,5
D32,Fraud,2022,1,27,0,26
D32,Break & Enter-Commercial,2022,0,5,0,5
D33,Break & Enter-Commercial,2022,0,2,0,2
D32,Theft Under $5000,2022,24,266,0,242
D32,Other,2022,5,8,0,3
D32,Other Criminal Violations - Offensive Weapons,2022,6,6,1,0
D32,Fraud,2022,1,67,0,66
D32,Break & Enter-Commercial,2022,1,2,0,1
D33,Break & Enter-Commercial,2022,0,1,0,1
D32,Theft Under $5000,2022,41,253,0,212
D32,Other,2022,0,2,0,2
D32,Other Criminal Violations - Offensive Weapons,2022,1,1,1,0
D32,Fraud,2022,5,108,0,103
D32,Break & Enter-Commercial,2022,1,9,0,8
D33,Break & Enter-Commercial,2022,1,6,0,5
D32,Theft Under $5000,2022,5,162,0,157
D32,Other,2022,12,22,0,10
D32,Other Criminal Violations - Offensive Weapons,2022,1,3,0,2
D32,Fraud,2022,4,108,0,104
D32,Break & Enter-Commercial,2022,3,16,0,13
D33,Break & Enter-Commercial,2022,1,8,0,7
D32,Theft Under $5000,2022,0,1,0,1
D32,Other,2022,8,13,0,5
D32,Other Criminal Violations - Offensive Weapons,2022,1,2,0,1
D32,Fraud,2022,7,77,0,70
D32,Break & Enter-Commercial,2022,1,8,0,7
D33,Break & Enter-Commercial,2022,0,2,0,2
D32,Theft Under $5000,2022,0,13,0,13
D32,Other,2022,8,15,0,7
D32,Other Criminal Violations - Offensive Weapons,2022,1,1,1,0
D32,Fraud,2022,7,88,0,81
D32,Break & Enter-Commercial,2022,1,12,0,11
D33,Break & Enter-House,2022,1,29,0,28
D32,Theft Under $5000,2022,5,204,0,199
D32,Other,2022,8,16,0,8
D32,Other,2022,7,32,0,25
D32,Break & Enter-Commercial,2022,0,1,0,1
D33,Break & Enter-House,2022,0,13,0,13
D32,Theft Under $5000,2022,26,265,0,239
D32,Other,2022,3,13,0,10
D32,Other,2022,20,94,0,74
D32,Break & Enter-Commercial,2022,1,2,0,1
D33,Break & Enter-House,2022,2,7,0,5
D32,Theft Under $5000,2022,4,126,0,122
D32,Other,2022,1,6,0,5
D32,Other Criminal Violations - Offensive Weapons,2022,9,10,0,1
D32,Other,2022,7,78,0,71
D32,Break & Enter-Commercial,2022,3,6,0,3
D33,Break & Enter-House,2022,0,6,0,6
D32,Theft Under $5000,2022,17,203,0,186
D32,Other,2022,1,1,1,0
D32,Other Criminal Violations - Offensive Weapons,2022,19,24,0,5
D32,Other,2022,3,19,0,16
D32,Break & Enter-Commercial,2022,2,15,0,13
D33,Break & Enter-House,2022,0,13,0,13
D32,Theft Under $5000,2022,16,183,0,167
D32,Other,2022,18,29,0,11
D32,Other Criminal Violations - Offensive Weapons,2022,1,2,0,1
D32,Other,2022,22,83,0,61
D32,Break & Enter-Commercial,2022,8,55,0,47
D33,Break & Enter-House,2022,1,3,0,2
D32,Theft Under $5000,2022,111,1145,0,1034
D32,Other,2022,11,27,0,16
D32,Other Criminal Violations - Offensive Weapons,2022,3,5,0,2
D32,Other,2022,5,27,0,22
D32,Break & Enter-Commercial,2022,4,30,0,26
D33,Break & Enter-House,2022,0,3,0,3
D32,Theft Under $5000,2022,82,491,0,409
D32,Other,2022,5,7,0,2
D32,Other Criminal Violations - Offensive Weapons,2022,8,10,0,2
D32,Other,2022,3,47,0,44
D32,Break & Enter-House,2022,0,1,0,1
D33,Break & Enter-House,2022,0,12,0,12
D32,Theft Under $5000,2022,106,857,0,751
D32,Other,2022,5,11,0,6
D32,Other Criminal Violations - Offensive Weapons,2022,9,12,0,3
D32,Other,2022,9,32,0,23
D32,Break & Enter-House,2022,2,7,0,5
D32,Assault,2022,24,36,0,12
D32,Other,2022,31,38,0,7
D32,Other Criminal Violations - Offensive Weapons,2022,6,7,0,1
D32,Other,2022,16,75,0,59
D32,Break & Enter-House,2022,0,25,0,25
D32,Other,2022,3,52,0,49
D32,Assault,2022,27,48,0,21
D33,Break & Enter-House,2022,0,1,0,1
D32,Break & Enter-House,2022,0,15,0,15
D32,Other,2022,3,5,0,2
D32,Assault,2022,0,1,0,1
D33,Break & Enter-House,2022,0,13,0,13
D32,Break & Enter-House,2022,2,7,0,5
D32,Other,2022,12,67,0,55
D32,Assault,2022,23,33,0,10
D33,Break & Enter-House,2022,2,3,0,1
D32,Break & Enter-House,2022,2,2,1,0
D32,Other,2022,39,137,0,98
D32,Assault,2022,6,10,0,4
D33,Break & Enter-House,2022,4,15,0,11
D32,Break & Enter-House,2022,3,29,0,26
D32,Other,2022,6,21,0,15
D32,Assault,2022,58,105,0,47
D32,Other Criminal Violations - Offensive Weapons,2022,15,19,0,4
D33,Break & Enter-House,2022,0,1,0,1
D32,Other,2022,5,11,0,6
D32,Break & Enter-House,2022,0,3,0,3
D32,Other,2022,22,99,0,77
D32,Assault,2022,28,55,0,27
D32,Other,2022,1,1,1,0
D33,Break & Enter-Other,2022,0,2,0,2
D32,Other,2022,4,6,0,2
D32,Break & Enter-House,2022,1,16,0,15
D32,Other,2022,13,56,0,43
D32,Assault,2022,31,48,0,17
D32,Other,2022,1,1,1,0
D33,Break & Enter-Other,2022,0,1,0,1
D32,Other,2022,6,14,0,8
D32,Break & Enter-House,2022,1,12,0,11
D32,Other,2022,2,2,1,0
D33,Break & Enter-Other,2022,0,1,0,1
D32,Robbery-Financial,2022,1,1,1,0
D32,Break & Enter-House,2022,3,24,0,21
D33,Break & Enter-Other,2022,0,2,0,2
D32,Robbery-Financial,2022,1,1,1,0
D32,Break & Enter-House,2022,5,11,0,6
D32,Robbery-Financial,2022,1,1,1,0
D33,Other,2022,12,15,0,3
D33,Break & Enter-Other,2022,0,1,0,1
D32,Break & Enter-House,2022,0,22,0,22
D32,Robbery-Financial,2022,1,1,1,0
D33,Other,2022,4,4,1,0
D33,Break & Enter-Other,2022,0,5,0,5
D32,Break & Enter-House,2022,1,7,0,6
D32,Robbery-Financial,2022,2,2,1,0
D33,Other,2022,10,20,0,10
D32,Robbery-Other,2022,2,4,0,2
D33,Other,2022,4,4,1,0
D32,Robbery-Other,2022,5,13,0,8
D33,Other,2022,5,6,0,1
D32,Robbery-Other,2022,0,9,0,9
D33,Other,2022,1,1,1,0
D32,Robbery-Other,2022,1,1,1,0
D33,Other,2022,1,1,1,0
D32,Robbery-Other,2022,5,15,0,10
D33,Other,2022,2,2,1,0
D32,Robbery-Other,2022,2,17,0,15
D33,Auto Theft,2022,3,56,0,53
D32,Robbery-Other,2022,3,10,0,7
D33,Auto Theft,2022,6,60,0,54
D32,Robbery-Other,2022,0,3,0,3
D33,Auto Theft,2022,0,15,0,15
D32,Robbery-Other,2022,7,10,0,3
D33,Auto Theft,2022,0,7,0,7
D32,Robbery-Other,2022,4,5,0,1
D33,Auto Theft,2022,3,72,0,69
D33,Auto Theft,2022,0,37,0,37
D41,Robbery-Other,2022,2,5,0,3
D41,Robbery-Other,2022,4,14,0,10
D41,Robbery-Other,2022,11,16,0,5
D41,Robbery-Other,2022,0,2,0,2
D41,Robbery-Other,2022,11,22,0,11
D41,Robbery-Other,2022,6,8,0,2
D41,Robbery-Other,2022,1,3,0,2
D41,Break & Enter-Commercial,2022,10,13,0,3
D41,Robbery-Other,2022,14,21,0,7
D41,Robbery-Other,2022,4,8,0,4
D41,Robbery-Other,2022,18,30,0,12
D41,Sexual Violation,2022,3,4,0,1
D41,Sexual Violation,2022,6,8,0,2
D41,Sexual Violation,2022,16,26,0,10
D41,Sexual Violation,2022,8,22,0,14
D41,Sexual Violation,2022,1,4,0,3
D41,Sexual Violation,2022,11,29,0,18
D41,Sexual Violation,2022,6,9,0,3
D41,Sexual Violation,2022,11,14,0,3
D41,Sexual Violation,2022,17,25,0,8
D41,Sexual Violation,2022,2,2,1,0
D41,Sexual Violation,2022,13,33,0,20
D41,Sexual Violation,2022,11,23,0,12
D41,Other,2022,2,2,1,0
D41,Other,2022,6,7,0,1
D41,Other,2022,12,13,0,1
D41,Other,2022,17,22,0,5
D41,Other,2022,5,6,0,1
D41,Other,2022,33,37,0,4
D41,Other,2022,2,2,1,0
D41,Other,2022,8,8,1,0
D41,Other,2022,10,10,1,0
D41,Other,2022,2,2,1,0
D41,Other,2022,12,13,0,1
D41,Other,2022,15,19,0,4
D41,Other,2022,3,4,0,1
D41,Other,2022,11,12,0,1
D41,Other,2022,68,81,0,13
D41,Other,2022,268,310,0,42
D41,Other,2022,12,16,0,4
D41,Other,2022,216,300,0,84
D41,Other,2022,22,27,0,5
D41,Other,2022,2,2,1,0
D41,Other,2022,56,66,0,10
D41,Other,2022,72,80,0,8
D41,Other,2022,6,7,0,1
D41,Other,2022,70,87,0,17
D41,Other,2022,74,91,0,17
D41,Other Criminal Violations - Offensive Weapons,2022,1,2,0,1
D41,Other Criminal Violations - Offensive Weapons,2022,6,6,1,0
D41,Other Criminal Violations - Offensive Weapons,2022,10,13,0,3
D41,Theft Over $5000,2022,1,15,0,14
D33,Robbery-Other,2022,9,10,0,1
D41,Other Criminal Violations - Offensive Weapons,2022,26,27,0,1
D33,Theft Under $5000,2022,5,127,0,122
D33,Other Criminal Violations - Offensive Weapons,2022,4,4,1,0
D33,Break & Enter-Other,2022,0,3,0,3
D41,Theft Over $5000,2022,0,2,0,2
D41,Other Criminal Violations - Offensive Weapons,2022,7,8,0,1
D41,Break & Enter-Commercial,2022,2,4,0,2
D33,Theft Under $5000,2022,0,2,0,2
D33,Other Criminal Violations - Offensive Weapons,2022,1,2,0,1
D41,Theft Over $5000,2022,1,8,0,7
D33,Fraud,2022,8,122,0,114
D33,Robbery-Other,2022,2,2,1,0
D41,Other Criminal Violations - Offensive Weapons,2022,10,13,0,3
D41,Break & Enter-Commercial,2022,7,11,0,4
D33,Theft Under $5000,2022,11,185,0,174
D33,Other Criminal Violations - Offensive Weapons,2022,16,20,0,4
D41,Theft Over $5000,2022,0,1,0,1
D33,Robbery-Other,2022,0,1,0,1
D33,Fraud,2022,12,129,0,117
D41,Other Criminal Violations - Offensive Weapons,2022,2,3,0,1
D41,Break & Enter-Commercial,2022,0,1,0,1
D33,Theft Under $5000,2022,2,100,0,98
D33,Other Criminal Violations - Offensive Weapons,2022,6,9,0,3
D41,Theft Over $5000,2022,1,2,0,1
D33,Sexual Violation,2022,8,14,0,6
D33,Fraud,2022,0,28,0,28
D41,Other Criminal Violations - Offensive Weapons,2022,6,6,1,0
D41,Other Criminal Violations - Offensive Weapons,2022,6,7,0,1
D41,Other Criminal Violations - Offensive Weapons,2022,1,2,0,1
D41,Other Criminal Violations - Offensive Weapons,2022,12,12,1,0
D41,Other Criminal Violations - Offensive Weapons,2022,17,21,0,4
D41,Other,2022,1,1,1,0
D41,Other,2022,1,2,0,1
D41,Other,2022,1,1,1,0
D42,Other,2022,4,4,1,0
D42,Other,2022,2,2,1,0
D42,Other,2022,2,2,1,0
D42,Other,2022,0,2,0,2
D42,Other,2022,0,1,0,1
D42,Auto Theft,2022,0,49,0,49
D42,Auto Theft,2022,3,82,0,79
D42,Auto Theft,2022,1,45,0,44
D42,Auto Theft,2022,1,29,0,28
D42,Auto Theft,2022,1,45,0,44
D42,Auto Theft,2022,2,55,0,53
D42,Auto Theft,2022,2,101,0,99
D42,Auto Theft,2022,2,127,0,125
D42,Auto Theft,2022,3,41,0,38
D42,Auto Theft,2022,0,80,0,80
D42,Auto Theft,2022,3,35,0,32
D42,Break & Enter-Apartment,2022,0,2,0,2
D42,Break & Enter-Apartment,2022,0,4,0,4
D42,Break & Enter-Apartment,2022,1,4,0,3
D42,Break & Enter-Apartment,2022,1,5,0,4
D42,Break & Enter-Apartment,2022,0,1,0,1
D42,Break & Enter-Apartment,2022,2,5,0,3
D42,Break & Enter-Apartment,2022,0,1,0,1
D42,Break & Enter-Apartment,2022,1,5,0,4
D42,Break & Enter-Apartment,2022,0,8,0,8
D42,Break & Enter-Apartment,2022,0,1,0,1
D42,Break & Enter-Commercial,2022,2,5,0,3
D42,Break & Enter-Commercial,2022,7,35,0,28
D42,Break & Enter-Commercial,2022,0,4,0,4
D42,Break & Enter-Commercial,2022,1,2,0,1
D42,Break & Enter-Commercial,2022,2,7,0,5
D42,Break & Enter-Commercial,2022,4,5,0,1
D42,Break & Enter-Commercial,2022,11,46,0,35
D42,Break & Enter-Commercial,2022,3,16,0,13
D42,Break & Enter-Commercial,2022,3,11,0,8
D42,Break & Enter-Commercial,2022,1,10,0,9
D42,Break & Enter-Commercial,2022,0,6,0,6
D42,Break & Enter-House,2022,1,17,0,16
D33,Theft Under $5000,2022,0,1,0,1
D41,Break & Enter-Commercial,2022,7,14,0,7
D33,Fraud,2022,1,6,0,5
D33,Other Criminal Violations - Offensive Weapons,2022,0,1,0,1
D41,Theft Over $5000,2022,0,5,0,5
D41,Theft Over $5000,2022,2,7,0,5
D41,Theft Over $5000,2022,5,22,0,17
D33,Sexual Violation,2022,3,10,0,7
D33,Theft Under $5000,2022,1,9,0,8
D41,Theft Under $5000,2022,6,30,0,24
D41,Break & Enter-Commercial,2022,19,53,0,34
D33,Other Criminal Violations - Offensive Weapons,2022,4,4,1,0
D33,Sexual Violation,2022,4,8,0,4
D33,Theft Under $5000,2022,4,60,0,56
D33,Fraud,2022,5,95,0,90
D41,Theft Under $5000,2022,13,87,0,74
D41,Break & Enter-House,2022,0,1,0,1
D33,Other Criminal Violations - Offensive Weapons,2022,4,4,1,0
D33,Sexual Violation,2022,1,1,1,0
D33,Theft Under $5000,2022,3,96,0,93
D33,Fraud,2022,2,55,0,53
D41,Theft Under $5000,2022,120,352,0,232
D41,Break & Enter-House,2022,0,1,0,1
D33,Other Criminal Violations - Offensive Weapons,2022,2,3,0,1
D33,Sexual Violation,2022,15,33,0,18
D33,Theft Under $5000,2022,3,117,0,114
D33,Fraud,2022,0,1,0,1
D41,Theft Under $5000,2022,268,536,0,268
D41,Break & Enter-House,2022,7,12,0,5
D33,Other Criminal Violations - Offensive Weapons,2022,2,2,1,0
D33,Sexual Violation,2022,9,16,0,7
D33,Theft Under $5000,2022,3,134,0,131
D33,Fraud,2022,1,90,0,89
D41,Theft Under $5000,2022,2,41,0,39
D41,Break & Enter-House,2022,10,20,0,10
D33,Other Criminal Violations - Offensive Weapons,2022,3,4,0,1
D33,Sexual Violation,2022,9,21,0,12
D33,Assault,2022,54,91,0,37
D33,Fraud,2022,0,64,0,64
D41,Theft Under $5000,2022,90,377,0,287
D41,Break & Enter-House,2022,1,4,0,3
D33,Other Criminal Violations - Offensive Weapons,2022,1,1,1,0
D33,Sexual Violation,2022,5,13,0,8
D33,Sexual Violation,2022,0,1,0,1
D33,Sexual Violation,2022,0,1,0,1
D33,Sexual Violation,2022,6,11,0,5
D33,Sexual Violation,2022,3,8,0,5
D33,Sexual Violation,2022,4,4,1,0
D33,Sexual Violation,2022,5,13,0,8
D33,Sexual Violation,2022,1,1,1,0
D33,Other,2022,23,25,0,2
D33,Other,2022,13,13,1,0
D33,Other,2022,3,3,1,0
D33,Other,2022,3,3,1,0
D33,Other,2022,1,1,1,0
D33,Other,2022,12,13,0,1
D33,Other,2022,9,10,0,1
D33,Other,2022,6,6,1,0
D33,Other,2022,8,8,1,0
D33,Other,2022,3,3,1,0
D33,Other,2022,3,3,1,0
D33,Other,2022,1,1,1,0
D33,Other,2022,7,7,1,0
D33,Other,2022,3,4,0,1
D33,Other,2022,4,5,0,1
D33,Other,2022,2,3,0,1
D33,Other,2022,6,7,0,1
D33,Other,2022,9,9,1,0
D33,Other,2022,63,70,0,7
D33,Other,2022,14,20,0,6
D33,Other,2022,7,9,0,2
D33,Other,2022,14,17,0,3
D33,Other,2022,34,50,0,16
D33,Other,2022,27,32,0,5
D33,Other,2022,10,12,0,2
D33,Other,2022,0,1,0,1
D33,Other,2022,13,16,0,3
D33,Other,2022,4,8,0,4
D33,Other,2022,10,10,1,0
D33,Other,2022,1,1,1,0
D33,Other,2022,12,17,0,5
D33,Other Criminal Violations - Offensive Weapons,2022,4,8,0,4
D33,Assault,2022,67,105,0,38
D41,Theft Under $5000,2022,20,85,0,65
D41,Break & Enter-House,2022,1,8,0,7
D33,Other,2022,0,3,0,3
D33,Assault,2022,14,37,0,23
D41,Theft Under $5000,2022,57,135,0,78
D33,Other,2022,0,1,0,1
D33,Assault,2022,8,12,0,4
D41,Theft Under $5000,2022,87,408,0,321
D33,Assault,2022,0,1,0,1
D33,Other,2022,0,1,0,1
D41,Break & Enter-House,2022,1,4,0,3
D33,Fraud,2022,0,4,0,4
D41,Theft Under $5000,2022,26,38,0,12
D33,Assault,2022,57,105,0,48
D41,Other,2022,1,1,1,0
D41,Break & Enter-House,2022,10,14,0,4
D33,Fraud,2022,1,44,0,43
D41,Theft Under $5000,2022,69,373,0,304
D33,Assault,2022,60,91,0,31
D41,Other,2022,0,1,0,1
D41,Break & Enter-House,2022,0,5,0,5
D33,Fraud,2022,3,44,0,41
D41,Theft Under $5000,2022,207,793,0,586
D33,Assault,2022,0,3,0,3
D41,Other,2022,9,17,0,8
D41,Break & Enter-House,2022,4,11,0,7
D33,Fraud,2022,2,31,0,29
D41,Assault,2022,15,21,0,6
D33,Assault,2022,62,87,0,25
D41,Other,2022,2,2,1,0
D41,Break & Enter-Other,2022,1,2,0,1
D33,Fraud,2022,4,41,0,37
D41,Assault,2022,28,36,0,8
D33,Assault,2022,14,35,0,21
D41,Other,2022,2,2,1,0
D41,Break & Enter-Other,2022,0,7,0,7
D33,Other,2022,10,93,0,83
D41,Assault,2022,92,137,0,45
D33,Assault,2022,4,4,1,0
D41,Other,2022,1,1,1,0
D41,Break & Enter-Other,2022,2,5,0,3
D33,Other,2022,11,63,0,52
D41,Assault,2022,160,222,0,62
D33,Assault,2022,1,3,0,2
D41,Other,2022,3,3,1,0
D41,Break & Enter-Other,2022,1,3,0,2
D33,Other,2022,3,25,0,22
D41,Assault,2022,38,45,0,7
D33,Assault,2022,35,55,0,20
D41,Other,2022,1,1,1,0
D41,Break & Enter-Other,2022,0,1,0,1
D33,Other,2022,0,7,0,7
D41,Assault,2022,109,166,0,57
D41,Other,2022,6,6,1,0
D41,Break & Enter-Other,2022,3,7,0,4
D33,Other,2022,13,87,0,74
D41,Assault,2022,23,38,0,15
D33,Other,2022,11,59,0,48
D41,Break & Enter-Other,2022,0,2,0,2
D33,Assault,2022,17,31,0,14
D41,Other,2022,7,8,0,1
D41,Assault,2022,55,73,0,18
D33,Other,2022,2,8,0,6
D41,Break & Enter-Other,2022,1,7,0,6
D33,Assault,2022,21,32,0,11
D41,Auto Theft,2022,0,5,0,5
D41,Assault,2022,125,202,0,77
D33,Other,2022,13,88,0,75
D41,Fraud,2022,0,9,0,9
D33,Assault,2022,0,1,0,1
D41,Auto Theft,2022,2,17,0,15
D41,Assault,2022,6,8,0,2
D33,Other,2022,6,47,0,41
D41,Fraud,2022,2,24,0,22
D33,Assault,2022,32,43,0,11
D41,Auto Theft,2022,6,47,0,41
D41,Assault,2022,126,167,0,41
D33,Other,2022,0,3,0,3
D41,Fraud,2022,12,85,0,73
D33,Assault,2022,1,4,0,3
D41,Auto Theft,2022,17,71,0,54
D41,Assault,2022,111,183,0,72
D33,Other,2022,6,39,0,33
D41,Fraud,2022,16,97,0,81
D33,Other,2022,12,25,0,13
D41,Auto Theft,2022,5,19,0,14
D41,Attempt Murder,2022,1,1,1,0
D33,Other,2022,5,42,0,37
D41,Fraud,2022,2,17,0,15
D33,Other,2022,10,17,0,7
D41,Auto Theft,2022,16,69,0,53
D41,Attempt Murder,2022,1,1,1,0
D33,Other,2022,5,42,0,37
D41,Fraud,2022,13,122,0,109
D33,Other,2022,1,2,0,1
D41,Auto Theft,2022,3,9,0,6
D41,Attempt Murder,2022,0,1,0,1
D33,Other,2022,0,1,0,1
D41,Fraud,2022,8,42,0,34
D33,Other,2022,2,5,0,3
D41,Auto Theft,2022,1,12,0,11
D41,Other,2022,1,3,0,2
D41,Fraud,2022,0,37,0,37
D33,Other,2022,22,37,0,15
D41,Auto Theft,2022,11,53,0,42
D41,Other,2022,7,11,0,4
D41,Auto Theft,2022,1,5,0,4
D33,Other,2022,0,1,0,1
D33,Other,2022,9,15,0,6
D41,Fraud,2022,6,55,0,49
D41,Other,2022,12,23,0,11
D41,Auto Theft,2022,4,22,0,18
D33,Other,2022,5,44,0,39
D33,Other,2022,2,10,0,8
D41,Fraud,2022,0,2,0,2
D41,Other,2022,37,56,0,19
D41,Auto Theft,2022,36,132,0,96
D33,Other,2022,1,2,0,1
D33,Other,2022,7,9,0,2
D41,Fraud,2022,5,33,0,28
D41,Other,2022,7,8,0,1
D41,Break & Enter-Apartment,2022,5,10,0,5
D33,Theft Over $5000,2022,0,12,0,12
D33,Other,2022,8,12,0,4
D41,Fraud,2022,17,173,0,156
D41,Other,2022,20,31,0,11
D41,Break & Enter-Apartment,2022,8,19,0,11
D33,Theft Over $5000,2022,0,6,0,6
D33,Other,2022,6,12,0,6
D41,Other,2022,6,19,0,13
D41,Other,2022,7,10,0,3
D41,Break & Enter-Apartment,2022,0,1,0,1
D33,Theft Over $5000,2022,0,4,0,4
D33,Other,2022,0,2,0,2
D41,Other,2022,12,48,0,36
D41,Other,2022,11,15,0,4
D41,Break & Enter-Apartment,2022,0,1,0,1
D33,Theft Over $5000,2022,0,1,0,1
D33,Other,2022,5,9,0,4
D41,Other,2022,34,87,0,53
D41,Other,2022,23,44,0,21
D41,Break & Enter-Apartment,2022,1,2,0,1
D33,Theft Over $5000,2022,1,11,0,10
D33,Robbery-Other,2022,6,18,0,12
D41,Other,2022,60,176,0,116
D41,Other,2022,2,3,0,1
D41,Break & Enter-Apartment,2022,0,3,0,3
D33,Theft Over $5000,2022,0,2,0,2
D33,Robbery-Other,2022,2,6,0,4
D41,Other,2022,9,37,0,28
D41,Other,2022,28,39,0,11
D41,Other,2022,36,52,0,16
D41,Robbery-Financial,2022,1,3,0,2
D41,Robbery-Financial,2022,2,2,1,0
D41,Robbery-Other,2022,0,2,0,2
D41,Break & Enter-Apartment,2022,7,12,0,5
D33,Robbery-Other,2022,1,2,0,1
D33,Theft Over $5000,2022,0,10,0,10
D41,Other,2022,38,100,0,62
D41,Break & Enter-Apartment,2022,6,14,0,8
D33,Robbery-Other,2022,0,1,0,1
D33,Theft Over $5000,2022,0,5,0,5
D41,Other,2022,15,46,0,31
D41,Break & Enter-Apartment,2022,3,5,0,2
D33,Robbery-Other,2022,8,24,0,16
D33,Theft Over $5000,2022,0,2,0,2
D41,Other,2022,20,70,0,50
D41,Break & Enter-Commercial,2022,3,6,0,3
D33,Robbery-Other,2022,4,8,0,4
D41,Other,2022,47,144,0,97
D41,Break & Enter-Commercial,2022,3,9,0,6
D33,Robbery-Other,2022,4,10,0,6
D33,Theft Over $5000,2022,0,1,0,1
D41,Other,2022,2,2,1,0
D41,Break & Enter-Commercial,2022,7,31,0,24
D33,Robbery-Other,2022,5,31,0,26
D33,Theft Over $5000,2022,0,4,0,4
D41,Other,2022,43,117,0,74
D41,Break & Enter-Commercial,2022,1,2,0,1
D33,Robbery-Other,2022,0,2,0,2
D33,Theft Over $5000,2022,0,8,0,8
D41,Other,2022,50,154,0,104
D41,Break & Enter-Commercial,2022,22,59,0,37
D33,Robbery-Other,2022,2,6,0,4
D33,Theft Over $5000,2022,0,1,0,1
D41,Theft Over $5000,2022,0,4,0,4
D33,Theft Under $5000,2022,34,346,0,312
D41,Theft Over $5000,2022,1,6,0,5
D33,Theft Under $5000,2022,78,474,0,396
D33,Theft Under $5000,2022,5,77,0,72
D33,Theft Under $5000,2022,0,5,0,5
D33,Theft Under $5000,2022,23,340,0,317
D43,Attempt Murder,2022,1,1,1,0
D43,Other,2022,2,5,0,3
D43,Other,2022,6,13,0,7
D43,Other,2022,2,8,0,6
D43,Other,2022,19,28,0,9
D43,Other,2022,5,15,0,10
D43,Other,2022,3,10,0,7
D43,Other,2022,19,42,0,23
D43,Other,2022,6,13,0,7
D43,Other,2022,5,10,0,5
D42,Break & Enter-House,2022,0,10,0,10
D43,Other,2022,22,78,0,56
D43,Other,2022,25,30,0,5
D43,Break & Enter-Commercial,2022,2,8,0,6
D42,Break & Enter-House,2022,2,16,0,14
D43,Other,2022,66,176,0,110
D43,Other,2022,0,2,0,2
D43,Other,2022,10,23,0,13
D42,Break & Enter-House,2022,0,9,0,9
D43,Break & Enter-Commercial,2022,3,5,0,2
D43,Other,2022,5,21,0,16
D43,Other,2022,64,84,0,20
D43,Other,2022,11,13,0,2
D42,Break & Enter-House,2022,0,7,0,7
D43,Break & Enter-Commercial,2022,0,1,0,1
D43,Other,2022,32,128,0,96
D43,Other,2022,2,4,0,2
D43,Other,2022,7,7,1,0
D42,Break & Enter-House,2022,0,2,0,2
D43,Break & Enter-Commercial,2022,2,2,1,0
D43,Theft Over $5000,2022,0,1,0,1
D43,Other,2022,24,35,0,11
D43,Other,2022,41,46,0,5
D42,Break & Enter-House,2022,1,10,0,9
D43,Break & Enter-Commercial,2022,7,18,0,11
D43,Theft Over $5000,2022,0,9,0,9
D43,Robbery-Other,2022,1,1,1,0
D43,Other,2022,5,8,0,3
D42,Break & Enter-House,2022,1,7,0,6
D43,Break & Enter-Commercial,2022,3,5,0,2
D43,Theft Over $5000,2022,0,5,0,5
D43,Robbery-Other,2022,28,45,0,17
D43,Other,2022,5,5,1,0
D42,Break & Enter-House,2022,0,1,0,1
D43,Break & Enter-Commercial,2022,5,24,0,19
D43,Theft Over $5000,2022,0,3,0,3
D43,Robbery-Other,2022,4,10,0,6
D43,Other,2022,31,35,0,4
D42,Break & Enter-House,2022,1,16,0,15
D43,Break & Enter-House,2022,3,10,0,7
D43,Theft Over $5000,2022,2,8,0,6
D42,Theft Over $5000,2022,0,14,0,14
D43,Robbery-Other,2022,9,15,0,6
D43,Robbery-Other,2022,7,13,0,6
D43,Robbery-Other,2022,5,6,0,1
D43,Robbery-Other,2022,1,1,1,0
D43,Robbery-Other,2022,6,17,0,11
D43,Robbery-Other,2022,4,10,0,6
D43,Robbery-Other,2022,31,52,0,21
D43,Robbery-Other,2022,12,22,0,10
D43,Sexual Violation,2022,3,7,0,4
D43,Sexual Violation,2022,3,8,0,5
D43,Sexual Violation,2022,2,10,0,8
D43,Sexual Violation,2022,2,13,0,11
D43,Sexual Violation,2022,6,11,0,5
D43,Sexual Violation,2022,12,28,0,16
D43,Sexual Violation,2022,3,5,0,2
D43,Sexual Violation,2022,5,10,0,5
D43,Sexual Violation,2022,8,18,0,10
D43,Sexual Violation,2022,1,2,0,1
D43,Sexual Violation,2022,9,17,0,8
D43,Sexual Violation,2022,27,53,0,26
D43,Sexual Violation,2022,0,2,0,2
D43,Sexual Violation,2022,12,31,0,19
D43,Other,2022,3,3,1,0
D43,Other,2022,7,7,1,0
D43,Other,2022,1,1,1,0
D43,Other,2022,2,3,0,1
D43,Other,2022,8,8,1,0
D43,Other,2022,28,32,0,4
D43,Other,2022,5,5,1,0
D43,Other,2022,10,11,0,1
D43,Other,2022,6,6,1,0
D43,Other,2022,8,8,1,0
D43,Other,2022,21,27,0,6
D43,Other,2022,38,48,0,10
D42,Theft Over $5000,2022,0,1,0,1
D43,Break & Enter-House,2022,3,5,0,2
D43,Theft Over $5000,2022,1,7,0,6
D42,Break & Enter-House,2022,4,16,0,12
D43,Other,2022,59,67,0,8
D42,Theft Over $5000,2022,0,4,0,4
D43,Break & Enter-House,2022,0,2,0,2
D43,Theft Over $5000,2022,0,2,0,2
D42,Break & Enter-House,2022,1,3,0,2
D43,Other,2022,7,10,0,3
D42,Theft Over $5000,2022,0,5,0,5
D43,Other,2022,15,19,0,4
D43,Break & Enter-House,2022,2,7,0,5
D43,Other,2022,0,1,0,1
D43,Theft Over $5000,2022,0,2,0,2
D43,Break & Enter-House,2022,2,6,0,4
D43,Other,2022,29,36,0,7
D42,Break & Enter-Other,2022,1,4,0,3
D42,Theft Over $5000,2022,0,1,0,1
D43,Other,2022,1,1,1,0
D42,Break & Enter-Other,2022,0,2,0,2
D43,Theft Over $5000,2022,0,3,0,3
D43,Break & Enter-House,2022,1,5,0,4
D42,Theft Under $5000,2022,43,265,0,222
D43,Other,2022,59,69,0,10
D42,Break & Enter-Other,2022,0,2,0,2
D43,Theft Over $5000,2022,3,8,0,5
D43,Break & Enter-House,2022,3,7,0,4
D42,Theft Under $5000,2022,23,255,0,232
D43,Other,2022,271,321,0,50
D42,Break & Enter-Other,2022,0,2,0,2
D43,Theft Over $5000,2022,3,13,0,10
D43,Break & Enter-House,2022,3,7,0,4
D42,Theft Under $5000,2022,0,10,0,10
D43,Other,2022,6,6,1,0
D42,Break & Enter-Other,2022,0,1,0,1
D43,Theft Over $5000,2022,0,3,0,3
D43,Break & Enter-House,2022,3,7,0,4
D42,Theft Under $5000,2022,6,78,0,72
D43,Other,2022,67,76,0,9
D42,Break & Enter-Other,2022,0,1,0,1
D43,Theft Over $5000,2022,1,13,0,12
D43,Break & Enter-House,2022,0,4,0,4
D42,Theft Under $5000,2022,54,269,0,215
D43,Other Criminal Violations - Offensive Weapons,2022,0,1,0,1
D42,Break & Enter-Other,2022,2,3,0,1
D43,Theft Under $5000,2022,5,31,0,26
D43,Break & Enter-House,2022,0,6,0,6
D42,Theft Under $5000,2022,36,244,0,208
D43,Other Criminal Violations - Offensive Weapons,2022,13,14,0,1
D42,Fraud,2022,10,76,0,66
D43,Theft Under $5000,2022,148,582,0,434
D43,Break & Enter-Other,2022,0,1,0,1
D42,Theft Under $5000,2022,16,161,0,145
D42,Fraud,2022,12,111,0,99
D43,Other Criminal Violations - Offensive Weapons,2022,0,1,0,1
D42,Fraud,2022,0,1,0,1
D43,Theft Under $5000,2022,9,100,0,91
D43,Break & Enter-Other,2022,0,1,0,1
D42,Theft Under $5000,2022,29,236,0,207
D43,Other Criminal Violations - Offensive Weapons,2022,5,7,0,2
D42,Fraud,2022,6,54,0,48
D43,Break & Enter-Other,2022,0,1,0,1
D43,Theft Under $5000,2022,26,187,0,161
D42,Theft Under $5000,2022,49,265,0,216
D43,Other Criminal Violations - Offensive Weapons,2022,5,6,0,1
D42,Fraud,2022,8,81,0,73
D43,Break & Enter-Other,2022,1,1,1,0
D43,Theft Under $5000,2022,44,185,0,141
D42,Theft Under $5000,2022,1,10,0,9
D43,Other Criminal Violations - Offensive Weapons,2022,1,4,0,3
D42,Fraud,2022,4,71,0,67
D43,Break & Enter-Other,2022,1,4,0,3
D43,Theft Under $5000,2022,65,417,0,352
D42,Theft Under $5000,2022,0,1,0,1
D43,Other Criminal Violations - Offensive Weapons,2022,2,2,1,0
D42,Fraud,2022,5,46,0,41
D43,Break & Enter-Other,2022,1,2,0,1
D43,Theft Under $5000,2022,6,70,0,64
D42,Theft Under $5000,2022,5,73,0,68
D43,Other Criminal Violations - Offensive Weapons,2022,2,2,1,0
D42,Fraud,2022,7,63,0,56
D43,Break & Enter-Other,2022,2,2,1,0
D43,Theft Under $5000,2022,8,85,0,77
D42,Theft Under $5000,2022,56,474,0,418
D43,Other Criminal Violations - Offensive Weapons,2022,5,5,1,0
D42,Fraud,2022,3,63,0,60
D43,Break & Enter-Other,2022,3,6,0,3
D43,Theft Under $5000,2022,34,189,0,155
D42,Theft Under $5000,2022,14,144,0,130
D43,Other Criminal Violations - Offensive Weapons,2022,6,6,1,0
D42,Fraud,2022,2,4,0,2
D43,Break & Enter-Other,2022,1,2,0,1
D43,Theft Under $5000,2022,2,7,0,5
D42,Assault,2022,50,72,0,22
D42,Fraud,2022,7,48,0,41
D43,Fraud,2022,5,25,0,20
D43,Theft Under $5000,2022,34,149,0,115
D42,Assault,2022,107,166,0,59
D43,Theft Under $5000,2022,83,512,0,429
D43,Other Criminal Violations - Offensive Weapons,2022,16,17,0,1
D42,Fraud,2022,12,103,0,91
D43,Fraud,2022,10,109,0,99
D42,Assault,2022,0,1,0,1
D43,Theft Under $5000,2022,5,30,0,25
D43,Other Criminal Violations - Offensive Weapons,2022,9,10,0,1
D42,Fraud,2022,15,54,0,39
D43,Fraud,2022,2,32,0,30
D42,Assault,2022,43,69,0,26
D43,Theft Under $5000,2022,45,276,0,231
D43,Other,2022,1,1,1,0
D42,Other,2022,10,45,0,35
D43,Fraud,2022,16,50,0,34
D42,Assault,2022,49,77,0,28
D43,Assault,2022,10,18,0,8
D43,Other,2022,1,2,0,1
D42,Other,2022,20,81,0,61
D43,Fraud,2022,5,44,0,39
D42,Assault,2022,76,117,0,41
D43,Assault,2022,61,115,0,54
D43,Other,2022,0,1,0,1
D42,Other,2022,15,46,0,31
D43,Fraud,2022,15,117,0,102
D42,Assault,2022,50,79,0,29
D43,Assault,2022,20,34,0,14
D43,Other,2022,1,3,0,2
D42,Other,2022,11,55,0,44
D43,Fraud,2022,1,41,0,40
D42,Assault,2022,39,58,0,19
D43,Assault,2022,58,80,0,22
D51,Other,2022,4,4,1,0
D42,Other,2022,21,82,0,61
D43,Fraud,2022,6,51,0,45
D42,Assault,2022,57,93,0,36
D43,Assault,2022,78,115,0,37
D51,Other,2022,28,35,0,7
D42,Other,2022,22,64,0,42
D43,Fraud,2022,1,53,0,52
D43,Assault,2022,118,177,0,59
D51,Other,2022,85,92,0,7
D42,Assault,2022,3,5,0,2
D42,Other,2022,16,69,0,53
D43,Assault,2022,18,35,0,17
D51,Other,2022,79,86,0,7
D42,Assault,2022,29,42,0,13
D42,Other,2022,19,66,0,47
D42,Assault,2022,57,107,0,50
D51,Other,2022,4,4,1,0
D43,Fraud,2022,0,5,0,5
D43,Assault,2022,38,54,0,16
D42,Other,2022,4,10,0,6
D42,Assault,2022,0,1,0,1
D51,Other,2022,7,7,1,0
D43,Fraud,2022,9,58,0,49
D43,Assault,2022,1,1,1,0
D42,Other,2022,6,47,0,41
D42,Assault,2022,25,39,0,14
D51,Other,2022,9,12,0,3
D43,Fraud,2022,13,124,0,111
D43,Assault,2022,76,112,0,36
D42,Other,2022,23,95,0,72
D42,Attempt Murder,2022,1,1,1,0
D51,Other,2022,13,16,0,3
D43,Fraud,2022,3,20,0,17
D43,Assault,2022,5,9,0,4
D42,Other,2022,11,25,0,14
D42,Attempt Murder,2022,2,2,1,0
D51,Auto Theft,2022,0,18,0,18
D43,Fraud,2022,17,95,0,78
D43,Assault,2022,90,139,0,49
D42,Theft Over $5000,2022,1,3,0,2
D42,Attempt Murder,2022,1,1,1,0
D51,Auto Theft,2022,5,17,0,12
D43,Other,2022,4,18,0,14
D43,Assault,2022,229,334,0,105
D42,Theft Over $5000,2022,1,10,0,9
D42,Other,2022,14,17,0,3
D51,Auto Theft,2022,7,42,0,35
D43,Other,2022,19,54,0,35
D43,Assault,2022,10,17,0,7
D42,Theft Over $5000,2022,0,11,0,11
D42,Other,2022,24,37,0,13
D51,Auto Theft,2022,3,59,0,56
D43,Other,2022,8,23,0,15
D43,Assault,2022,102,157,0,55
D42,Theft Over $5000,2022,0,5,0,5
D42,Other,2022,17,22,0,5
D51,Auto Theft,2022,0,3,0,3
D43,Other,2022,21,54,0,33
D43,Attempt Murder,2022,1,1,1,0
D42,Theft Over $5000,2022,2,8,0,6
D42,Other,2022,14,19,0,5
D42,Other,2022,10,27,0,17
D42,Other,2022,16,22,0,6
D42,Other,2022,8,14,0,6
D42,Other,2022,11,22,0,11
D42,Other,2022,1,2,0,1
D42,Other,2022,4,5,0,1
D42,Other,2022,12,25,0,13
D42,Other,2022,4,5,0,1
D42,Robbery-Financial,2022,1,1,1,0
D42,Robbery-Other,2022,7,10,0,3
D51,Auto Theft,2022,2,14,0,12
D43,Other,2022,25,83,0,58
D42,Theft Over $5000,2022,1,4,0,3
D43,Attempt Murder,2022,1,1,1,0
D51,Auto Theft,2022,0,11,0,11
D43,Other,2022,32,112,0,80
D42,Theft Over $5000,2022,1,12,0,11
D43,Attempt Murder,2022,5,5,1,0
D51,Auto Theft,2022,2,8,0,6
D43,Other,2022,7,37,0,30
D43,Other,2022,6,40,0,34
D43,Other,2022,15,56,0,41
D42,Other Criminal Violations - Offensive Weapons,2022,1,1,1,0
D42,Other Criminal Violations - Offensive Weapons,2022,4,5,0,1
D42,Other Criminal Violations - Offensive Weapons,2022,3,7,0,4
D42,Other Criminal Violations - Offensive Weapons,2022,4,4,1,0
D42,Other Criminal Violations - Offensive Weapons,2022,2,2,1,0
D42,Other Criminal Violations - Offensive Weapons,2022,6,6,1,0
D42,Other Criminal Violations - Offensive Weapons,2022,1,1,1,0
D42,Other Criminal Violations - Offensive Weapons,2022,8,9,0,1
D42,Other Criminal Violations - Offensive Weapons,2022,1,1,1,0
D42,Other,2022,1,1,1,0
D42,Other,2022,0,1,0,1
D43,Other,2022,2,2,1,0
D43,Other,2022,2,3,0,1
D43,Other,2022,4,4,1,0
D43,Other,2022,7,8,0,1
D43,Other,2022,2,4,0,2
D43,Other,2022,1,1,1,0
D43,Other,2022,1,2,0,1
D43,Other,2022,7,11,0,4
D43,Other,2022,1,1,1,0
D43,Other,2022,2,2,1,0
D43,Auto Theft,2022,0,16,0,16
D43,Auto Theft,2022,8,66,0,58
D43,Auto Theft,2022,2,25,0,23
D43,Auto Theft,2022,6,24,0,18
D43,Auto Theft,2022,10,35,0,25
D43,Auto Theft,2022,13,75,0,62
D43,Auto Theft,2022,2,10,0,8
D43,Auto Theft,2022,8,42,0,34
D43,Auto Theft,2022,6,52,0,46
D43,Auto Theft,2022,0,1,0,1
D43,Auto Theft,2022,6,25,0,19
D43,Auto Theft,2022,15,61,0,46
D43,Auto Theft,2022,6,33,0,27
D43,Auto Theft,2022,25,109,0,84
D43,Break & Enter-Apartment,2022,0,1,0,1
D43,Break & Enter-Apartment,2022,1,6,0,5
D43,Break & Enter-Apartment,2022,0,1,0,1
D43,Break & Enter-Apartment,2022,1,2,0,1
D43,Break & Enter-Apartment,2022,4,7,0,3
D43,Break & Enter-Apartment,2022,9,13,0,4
D43,Break & Enter-Apartment,2022,1,2,0,1
D43,Break & Enter-Apartment,2022,7,9,0,2
D43,Break & Enter-Apartment,2022,9,14,0,5
D43,Break & Enter-Apartment,2022,2,3,0,1
D43,Break & Enter-Commercial,2022,3,6,0,3
D43,Break & Enter-Commercial,2022,3,8,0,5
D43,Break & Enter-Commercial,2022,3,9,0,6
D43,Break & Enter-Commercial,2022,0,7,0,7
D43,Break & Enter-Commercial,2022,4,11,0,7
D42,Robbery-Other,2022,12,31,0,19
D42,Robbery-Other,2022,0,7,0,7
D42,Robbery-Other,2022,4,9,0,5
D42,Robbery-Other,2022,6,14,0,8
D42,Robbery-Other,2022,7,11,0,4
D42,Robbery-Other,2022,9,28,0,19
D42,Robbery-Other,2022,10,26,0,16
D42,Robbery-Other,2022,2,6,0,4
D42,Robbery-Other,2022,16,26,0,10
D42,Robbery-Other,2022,10,12,0,2
D42,Sexual Violation,2022,3,15,0,12
D42,Sexual Violation,2022,12,23,0,11
D42,Sexual Violation,2022,7,9,0,2
D42,Sexual Violation,2022,4,8,0,4
D42,Sexual Violation,2022,10,15,0,5
D42,Sexual Violation,2022,10,15,0,5
D42,Sexual Violation,2022,5,10,0,5
D42,Sexual Violation,2022,6,9,0,3
D42,Sexual Violation,2022,0,2,0,2
D42,Sexual Violation,2022,3,5,0,2
D42,Sexual Violation,2022,3,10,0,7
D42,Sexual Violation,2022,1,4,0,3
D42,Other,2022,13,15,0,2
D42,Other,2022,18,18,1,0
D42,Other,2022,0,1,0,1
D42,Other,2022,5,6,0,1
D42,Other,2022,2,2,1,0
D42,Other,2022,20,20,1,0
D42,Other,2022,19,20,0,1
D42,Other,2022,12,13,0,1
D42,Other,2022,24,27,0,3
D42,Other,2022,4,5,0,1
D42,Other,2022,2,2,1,0
D42,Other,2022,3,3,1,0
D42,Other,2022,15,15,1,0
D42,Other,2022,21,27,0,6
D42,Other,2022,54,68,0,14
D42,Other,2022,1,1,1,0
D42,Other,2022,19,27,0,8
D42,Other,2022,14,21,0,7
D42,Other,2022,41,46,0,5
D42,Other,2022,22,23,0,1
D42,Other,2022,10,13,0,3
D42,Other,2022,26,35,0,9
D42,Other,2022,5,5,1,0
D42,Other,2022,7,9,0,2
D42,Other,2022,37,42,0,5
D42,Other,2022,27,31,0,4
D42,Other Criminal Violations - Offensive Weapons,2022,4,4,1,0
D42,Other Criminal Violations - Offensive Weapons,2022,10,10,1,0
D52,Other,2022,39,55,0,16
D52,Fraud,2022,19,143,0,124
D52,Robbery-Financial,2022,2,2,1,0
D52,Fraud,2022,26,292,0,266
D52,Robbery-Financial,2022,1,1,1,0
D52,Other,2022,22,97,0,75
D52,Robbery-Financial,2022,4,4,1,0
D52,Other,2022,1,1,1,0
D52,Other,2022,1,6,0,5
D51,Robbery-Other,2022,10,17,0,7
D52,Robbery-Financial,2022,2,2,1,0
D52,Other,2022,7,7,1,0
D52,Other,2022,3,3,1,0
D52,Other,2022,3,3,1,0
D52,Other,2022,1,2,0,1
D52,Other,2022,2,4,0,2
D52,Other,2022,8,8,1,0
D52,Auto Theft,2022,0,1,0,1
D52,Auto Theft,2022,3,14,0,11
D52,Auto Theft,2022,2,4,0,2
D52,Auto Theft,2022,2,16,0,14
D52,Auto Theft,2022,0,18,0,18
D52,Auto Theft,2022,0,1,0,1
D52,Auto Theft,2022,0,8,0,8
D52,Auto Theft,2022,1,5,0,4
D52,Auto Theft,2022,1,44,0,43
D52,Auto Theft,2022,8,31,0,23
D52,Break & Enter-Apartment,2022,7,21,0,14
D52,Break & Enter-Apartment,2022,5,11,0,6
D52,Break & Enter-Apartment,2022,4,20,0,16
D52,Break & Enter-Apartment,2022,0,2,0,2
D52,Break & Enter-Apartment,2022,0,11,0,11
D52,Break & Enter-Apartment,2022,2,4,0,2
D52,Break & Enter-Apartment,2022,4,13,0,9
D52,Break & Enter-Apartment,2022,13,28,0,15
D52,Break & Enter-Commercial,2022,3,16,0,13
D52,Break & Enter-Commercial,2022,3,18,0,15
D52,Break & Enter-Commercial,2022,6,25,0,19
D52,Break & Enter-Commercial,2022,0,3,0,3
D52,Break & Enter-Commercial,2022,5,14,0,9
D52,Break & Enter-Commercial,2022,0,3,0,3
D52,Break & Enter-Commercial,2022,13,68,0,55
D52,Break & Enter-Commercial,2022,37,89,0,52
D52,Break & Enter-House,2022,3,10,0,7
D52,Break & Enter-House,2022,0,1,0,1
D52,Break & Enter-Other,2022,2,7,0,5
D52,Break & Enter-Other,2022,1,4,0,3
D52,Break & Enter-Other,2022,3,8,0,5
D52,Break & Enter-Other,2022,0,8,0,8
D52,Break & Enter-Other,2022,2,6,0,4
D52,Break & Enter-Other,2022,0,2,0,2
D52,Break & Enter-Other,2022,2,7,0,5
D52,Fraud,2022,15,156,0,141
D52,Fraud,2022,1,8,0,7
D52,Fraud,2022,0,17,0,17
D52,Fraud,2022,7,104,0,97
D52,Fraud,2022,3,102,0,99
D52,Fraud,2022,0,2,0,2
D52,Fraud,2022,2,97,0,95
D52,Fraud,2022,1,42,0,41
D51,Other,2022,36,80,0,44
D52,Robbery-Other,2022,6,14,0,8
D52,Other,2022,9,29,0,20
D51,Other,2022,3,8,0,5
D51,Other,2022,42,182,0,140
D51,Robbery-Other,2022,15,35,0,20
D52,Robbery-Other,2022,6,10,0,4
D52,Other,2022,30,110,0,80
D53,Break & Enter-Commercial,2022,0,5,0,5
D51,Theft Over $5000,2022,2,9,0,7
D51,Robbery-Other,2022,27,50,0,23
D52,Robbery-Other,2022,8,15,0,7
D52,Other,2022,37,159,0,122
D51,Theft Over $5000,2022,3,19,0,16
D53,Break & Enter-Commercial,2022,0,1,0,1
D51,Robbery-Other,2022,36,54,0,18
D52,Robbery-Other,2022,9,20,0,11
D52,Other,2022,0,11,0,11
D51,Theft Over $5000,2022,4,19,0,15
D53,Break & Enter-Commercial,2022,1,3,0,2
D51,Robbery-Other,2022,0,1,0,1
D52,Robbery-Other,2022,0,1,0,1
D52,Other,2022,30,322,0,292
D51,Theft Over $5000,2022,4,17,0,13
D53,Break & Enter-Commercial,2022,0,3,0,3
D51,Robbery-Other,2022,9,15,0,6
D52,Robbery-Other,2022,5,9,0,4
D52,Other,2022,6,104,0,98
D51,Theft Over $5000,2022,0,2,0,2
D53,Break & Enter-Commercial,2022,2,13,0,11
D51,Robbery-Other,2022,5,8,0,3
D52,Robbery-Other,2022,1,3,0,2
D52,Other,2022,35,155,0,120
D51,Theft Over $5000,2022,1,5,0,4
D53,Break & Enter-Commercial,2022,2,11,0,9
D51,Robbery-Other,2022,0,3,0,3
D52,Robbery-Other,2022,9,35,0,26
D52,Other,2022,78,378,0,300
D51,Theft Over $5000,2022,3,5,0,2
D53,Break & Enter-Commercial,2022,2,12,0,10
D51,Robbery-Other,2022,15,19,0,4
D52,Robbery-Other,2022,19,41,0,22
D52,Theft Over $5000,2022,2,9,0,7
D51,Theft Over $5000,2022,2,6,0,4
D53,Break & Enter-Commercial,2022,4,20,0,16
D53,Break & Enter-Commercial,2022,1,7,0,6
D53,Break & Enter-Commercial,2022,7,30,0,23
D53,Break & Enter-Commercial,2022,0,11,0,11
D53,Break & Enter-Commercial,2022,3,12,0,9
D53,Break & Enter-House,2022,3,10,0,7
D53,Break & Enter-House,2022,0,7,0,7
D53,Break & Enter-House,2022,2,10,0,8
D53,Break & Enter-House,2022,0,2,0,2
D53,Break & Enter-House,2022,1,2,0,1
D53,Break & Enter-House,2022,0,4,0,4
D53,Break & Enter-House,2022,1,20,0,19
D53,Break & Enter-House,2022,4,17,0,13
D53,Break & Enter-House,2022,1,9,0,8
D53,Break & Enter-House,2022,0,1,0,1
D53,Break & Enter-House,2022,3,19,0,16
D53,Break & Enter-House,2022,0,2,0,2
D53,Break & Enter-House,2022,1,9,0,8
D53,Break & Enter-House,2022,0,4,0,4
D53,Break & Enter-Other,2022,2,4,0,2
D53,Break & Enter-Other,2022,0,1,0,1
D53,Break & Enter-Other,2022,1,2,0,1
D53,Break & Enter-Other,2022,0,2,0,2
D53,Break & Enter-Other,2022,2,7,0,5
D53,Break & Enter-Other,2022,0,5,0,5
D53,Break & Enter-Other,2022,1,3,0,2
D53,Break & Enter-Other,2022,2,7,0,5
D53,Break & Enter-Other,2022,3,5,0,2
D53,Break & Enter-Other,2022,2,8,0,6
D53,Break & Enter-Other,2022,1,3,0,2
D53,Break & Enter-Other,2022,0,1,0,1
D53,Fraud,2022,13,151,0,138
D53,Fraud,2022,0,4,0,4
D53,Fraud,2022,1,6,0,5
D53,Fraud,2022,1,19,0,18
D53,Fraud,2022,1,20,0,19
D53,Fraud,2022,0,3,0,3
D53,Fraud,2022,0,18,0,18
D53,Fraud,2022,0,19,0,19
D53,Fraud,2022,1,31,0,30
D53,Fraud,2022,2,49,0,47
D53,Fraud,2022,4,53,0,49
D53,Fraud,2022,0,3,0,3
D52,Other Criminal Violations - Offensive Weapons,2022,1,2,0,1
D51,Auto Theft,2022,1,33,0,32
D51,Sexual Violation,2022,7,24,0,17
D52,Sexual Violation,2022,0,1,0,1
D52,Theft Over $5000,2022,3,8,0,5
D51,Theft Over $5000,2022,1,12,0,11
D52,Sexual Violation,2022,13,25,0,12
D52,Theft Over $5000,2022,1,12,0,11
D51,Sexual Violation,2022,19,41,0,22
D51,Theft Under $5000,2022,0,1,0,1
D52,Sexual Violation,2022,0,1,0,1
D52,Theft Over $5000,2022,0,2,0,2
D51,Sexual Violation,2022,26,50,0,24
D51,Theft Under $5000,2022,38,543,0,505
D52,Sexual Violation,2022,1,6,0,5
D52,Theft Over $5000,2022,1,11,0,10
D51,Sexual Violation,2022,27,53,0,26
D51,Theft Under $5000,2022,278,1292,0,1014
D52,Sexual Violation,2022,9,12,0,3
D52,Theft Over $5000,2022,0,7,0,7
D51,Sexual Violation,2022,1,3,0,2
D51,Theft Under $5000,2022,123,848,0,725
D52,Sexual Violation,2022,14,41,0,27
D52,Theft Over $5000,2022,0,11,0,11
D51,Sexual Violation,2022,11,24,0,13
D51,Theft Under $5000,2022,0,1,0,1
D52,Theft Over $5000,2022,13,51,0,38
D51,Sexual Violation,2022,8,19,0,11
D51,Theft Under $5000,2022,0,1,0,1
D51,Break & Enter-Apartment,2022,7,20,0,13
D52,Sexual Violation,2022,1,1,1,0
D51,Sexual Violation,2022,0,4,0,4
D52,Sexual Violation,2022,12,32,0,20
D51,Sexual Violation,2022,10,16,0,6
D52,Sexual Violation,2022,3,10,0,7
D52,Sexual Violation,2022,10,26,0,16
D51,Sexual Violation,2022,0,1,0,1
D52,Other Criminal Violations - Offensive Weapons,2022,9,10,0,1
D52,Sexual Violation,2022,24,55,0,31
D52,Theft Under $5000,2022,0,1,0,1
D51,Other,2022,22,24,0,2
D51,Theft Under $5000,2022,83,621,0,538
D52,Other Criminal Violations - Offensive Weapons,2022,22,27,0,5
D52,Other,2022,5,6,0,1
D51,Break & Enter-Apartment,2022,16,44,0,28
D52,Theft Under $5000,2022,21,292,0,271
D51,Other,2022,8,10,0,2
D51,Theft Under $5000,2022,12,53,0,41
D52,Other,2022,8,18,0,10
D52,Other,2022,3,3,1,0
D51,Break & Enter-Apartment,2022,12,35,0,23
D52,Theft Under $5000,2022,2,12,0,10
D51,Other,2022,19,20,0,1
D51,Theft Under $5000,2022,54,382,0,328
D52,Other,2022,0,1,0,1
D52,Other,2022,6,7,0,1
D51,Break & Enter-Apartment,2022,22,63,0,41
D52,Theft Under $5000,2022,5,62,0,57
D51,Other,2022,26,30,0,4
D51,Theft Under $5000,2022,20,137,0,117
D52,Other,2022,1,2,0,1
D52,Other,2022,24,25,0,1
D51,Break & Enter-Apartment,2022,0,1,0,1
D52,Theft Under $5000,2022,12,202,0,190
D51,Other,2022,1,1,1,0
D51,Theft Under $5000,2022,0,1,0,1
D52,Other,2022,0,1,0,1
D52,Other,2022,8,9,0,1
D51,Break & Enter-Apartment,2022,12,28,0,16
D52,Theft Under $5000,2022,53,527,0,474
D51,Other,2022,8,9,0,1
D51,Theft Under $5000,2022,5,312,0,307
D52,Other,2022,1,1,1,0
D53,Other,2022,4,4,1,0
D53,Other,2022,0,1,0,1
D53,Other,2022,1,1,1,0
D53,Other,2022,1,1,1,0
D53,Other,2022,1,1,1,0
D53,Other,2022,4,4,1,0
D53,Other,2022,10,10,1,0
D53,Other,2022,2,2,1,0
D53,Auto Theft,2022,2,43,0,41
D53,Auto Theft,2022,1,44,0,43
D53,Auto Theft,2022,0,23,0,23
D53,Auto Theft,2022,1,24,0,23
D53,Auto Theft,2022,1,16,0,15
D53,Auto Theft,2022,0,41,0,41
D53,Auto Theft,2022,2,95,0,93
D53,Auto Theft,2022,2,79,0,77
D53,Auto Theft,2022,2,64,0,62
D53,Auto Theft,2022,0,5,0,5
D53,Auto Theft,2022,0,11,0,11
D53,Auto Theft,2022,10,109,0,99
D53,Auto Theft,2022,2,15,0,13
D53,Auto Theft,2022,5,35,0,30
D53,Auto Theft,2022,2,36,0,34
D53,Auto Theft,2022,0,32,0,32
D53,Break & Enter-Apartment,2022,13,25,0,12
D53,Break & Enter-Apartment,2022,0,1,0,1
D53,Break & Enter-Apartment,2022,1,3,0,2
D53,Break & Enter-Apartment,2022,0,5,0,5
D53,Break & Enter-Apartment,2022,1,3,0,2
D53,Break & Enter-Apartment,2022,0,1,0,1
D53,Break & Enter-Apartment,2022,3,5,0,2
D53,Break & Enter-Apartment,2022,1,6,0,5
D53,Break & Enter-Apartment,2022,1,5,0,4
D53,Break & Enter-Apartment,2022,0,1,0,1
D53,Break & Enter-Apartment,2022,7,27,0,20
D53,Break & Enter-Apartment,2022,5,26,0,21
D53,Break & Enter-Apartment,2022,5,17,0,12
D53,Break & Enter-Apartment,2022,5,15,0,10
D53,Break & Enter-Apartment,2022,3,10,0,7
D53,Break & Enter-Apartment,2022,2,9,0,7
D53,Break & Enter-Commercial,2022,32,63,0,31
D53,Break & Enter-Commercial,2022,0,2,0,2
D52,Theft Under $5000,2022,0,21,0,21
D51,Other,2022,8,9,0,1
D51,Theft Under $5000,2022,111,697,0,586
D52,Other,2022,10,13,0,3
D51,Break & Enter-Apartment,2022,3,6,0,3
D52,Theft Under $5000,2022,21,373,0,352
D51,Other,2022,7,7,1,0
D51,Assault,2022,76,124,0,48
D52,Other,2022,4,4,1,0
D51,Break & Enter-Apartment,2022,13,32,0,19
D52,Theft Under $5000,2022,2,199,0,197
D51,Other,2022,26,32,0,6
D51,Assault,2022,199,334,0,135
D52,Other,2022,12,16,0,4
D51,Break & Enter-Commercial,2022,0,1,0,1
D52,Theft Under $5000,2022,24,363,0,339
D51,Other,2022,42,58,0,16
D51,Assault,2022,292,428,0,136
D52,Other,2022,20,25,0,5
D51,Break & Enter-Commercial,2022,13,31,0,18
D52,Theft Under $5000,2022,0,1,0,1
D51,Other,2022,126,152,0,26
D51,Assault,2022,0,1,0,1
D52,Other,2022,49,1077,0,1028
D51,Break & Enter-Commercial,2022,11,25,0,14
D52,Theft Under $5000,2022,467,1939,0,1472
D51,Assault,2022,314,482,0,168
D52,Other,2022,3,3,1,0
D51,Break & Enter-Commercial,2022,20,72,0,52
D52,Assault,2022,51,110,0,59
D51,Break & Enter-Commercial,2022,26,53,0,27
D51,Other,2022,230,255,0,25
D51,Assault,2022,6,16,0,10
D52,Other,2022,26,31,0,5
D52,Assault,2022,8,14,0,6
D51,Break & Enter-Commercial,2022,1,4,0,3
D51,Other,2022,1,1,1,0
D51,Assault,2022,115,195,0,80
D52,Other,2022,28,35,0,7
D52,Assault,2022,33,65,0,32
D51,Break & Enter-Commercial,2022,5,13,0,8
D51,Other,2022,581,624,0,43
D51,Assault,2022,72,114,0,42
D52,Other,2022,81,99,0,18
D52,Assault,2022,98,131,0,33
D51,Break & Enter-Commercial,2022,0,6,0,6
D51,Other,2022,3,4,0,1
D51,Assault,2022,14,47,0,33
D52,Other,2022,5,7,0,2
D52,Assault,2022,89,143,0,54
D51,Break & Enter-Commercial,2022,16,60,0,44
D51,Other,2022,106,126,0,20
D51,Assault,2022,116,164,0,48
D52,Other,2022,43,48,0,5
D52,Assault,2022,2,4,0,2
D51,Break & Enter-House,2022,7,11,0,4
D51,Other,2022,62,72,0,10
D51,Attempt Murder,2022,1,1,1,0
D52,Other,2022,11,15,0,4
D52,Assault,2022,143,204,0,61
D51,Break & Enter-House,2022,0,1,0,1
D51,Other,2022,3,5,0,2
D51,Attempt Murder,2022,2,2,1,0
D52,Other,2022,39,51,0,12
D52,Assault,2022,20,35,0,15
D51,Break & Enter-House,2022,2,2,1,0
D51,Other,2022,66,84,0,18
D51,Other,2022,13,22,0,9
D52,Other,2022,361,391,0,30
D52,Assault,2022,147,228,0,81
D51,Break & Enter-House,2022,4,7,0,3
D51,Other,2022,24,46,0,22
D52,Other Criminal Violations - Offensive Weapons,2022,10,10,1,0
D52,Assault,2022,264,416,0,152
D51,Break & Enter-House,2022,1,3,0,2
D51,Other Criminal Violations - Offensive Weapons,2022,3,4,0,1
D51,Other,2022,34,53,0,19
D52,Other Criminal Violations - Offensive Weapons,2022,2,2,1,0
D52,Other,2022,14,24,0,10
D51,Break & Enter-House,2022,1,2,0,1
D51,Other Criminal Violations - Offensive Weapons,2022,24,29,0,5
D51,Other,2022,33,61,0,28
D52,Other Criminal Violations - Offensive Weapons,2022,6,9,0,3
D52,Other,2022,2,2,1,0
D51,Break & Enter-House,2022,0,1,0,1
D51,Other Criminal Violations - Offensive Weapons,2022,49,59,0,10
D51,Other,2022,2,3,0,1
D52,Other Criminal Violations - Offensive Weapons,2022,6,6,1,0
D52,Other,2022,0,2,0,2
D51,Break & Enter-Other,2022,0,6,0,6
D51,Other Criminal Violations - Offensive Weapons,2022,61,74,0,13
D51,Other,2022,12,24,0,12
D52,Other Criminal Violations - Offensive Weapons,2022,6,10,0,4
D52,Other,2022,10,10,1,0
D51,Break & Enter-Other,2022,2,4,0,2
D51,Other Criminal Violations - Offensive Weapons,2022,13,17,0,4
D51,Other,2022,14,25,0,11
D52,Other Criminal Violations - Offensive Weapons,2022,12,13,0,1
D52,Other,2022,17,27,0,10
D51,Break & Enter-Other,2022,2,7,0,5
D51,Other Criminal Violations - Offensive Weapons,2022,16,18,0,2
D51,Other,2022,3,4,0,1
D52,Other,2022,26,36,0,10
D51,Break & Enter-Other,2022,5,11,0,6
D51,Other Criminal Violations - Offensive Weapons,2022,5,5,1,0
D51,Other,2022,12,31,0,19
D52,Other,2022,6,12,0,6
D51,Break & Enter-Other,2022,1,2,0,1
D51,Other Criminal Violations - Offensive Weapons,2022,9,13,0,4
D51,Robbery-Financial,2022,0,1,0,1
D51,Robbery-Financial,2022,1,1,1,0
D51,Robbery-Financial,2022,1,1,1,0
D51,Robbery-Other,2022,1,1,1,0
D52,Other,2022,16,34,0,18
D51,Other,2022,1,2,0,1
D51,Other,2022,1,1,1,0
D51,Break & Enter-Other,2022,0,4,0,4
D51,Other,2022,1,4,0,3
D51,Break & Enter-Other,2022,1,4,0,3
D52,Other,2022,1,3,0,2
D51,Fraud,2022,6,74,0,68
D51,Fraud,2022,22,202,0,180
D51,Fraud,2022,25,192,0,167
D51,Fraud,2022,0,1,0,1
D51,Fraud,2022,23,164,0,141
D51,Fraud,2022,0,13,0,13
D51,Fraud,2022,4,71,0,67
D51,Fraud,2022,6,39,0,33
D51,Fraud,2022,0,1,0,1
D51,Fraud,2022,2,14,0,12
D51,Fraud,2022,7,117,0,110
D51,Other,2022,30,128,0,98
D51,Other,2022,87,242,0,155
D51,Other,2022,121,326,0,205
D51,Other,2022,0,1,0,1
D51,Other,2022,156,383,0,227
D51,Other,2022,2,10,0,8
D51,Other,2022,48,180,0,132
D55,Theft Under $5000,2022,0,17,0,17
D55,Theft Under $5000,2022,26,114,0,88
D55,Theft Under $5000,2022,19,154,0,135
D55,Theft Under $5000,2022,0,1,0,1
D55,Theft Under $5000,2022,32,170,0,138
D55,Theft Under $5000,2022,44,229,0,185
D55,Theft Under $5000,2022,209,875,0,666
D55,Theft Under $5000,2022,24,186,0,162
D55,Theft Under $5000,2022,97,415,0,318
D55,Theft Under $5000,2022,4,59,0,55
D55,Theft Under $5000,2022,38,224,0,186
D55,Theft Under $5000,2022,0,26,0,26
D55,Assault,2022,2,2,1,0
D55,Assault,2022,27,52,0,25
D55,Auto Theft,2022,1,15,0,14
D55,Assault,2022,37,54,0,17
D55,Assault,2022,68,105,0,37
D55,Assault,2022,43,64,0,21
D55,Assault,2022,125,196,0,71
D55,Assault,2022,82,119,0,37
D55,Assault,2022,71,102,0,31
D55,Assault,2022,10,14,0,4
D55,Assault,2022,40,65,0,25
D55,Assault,2022,107,133,0,26
D55,Assault,2022,2,2,1,0
D55,Assault,2022,39,60,0,21
D55,Assault,2022,46,78,0,32
D55,Assault,2022,139,221,0,82
D55,Assault,2022,76,106,0,30
D55,Assault,2022,77,111,0,34
D55,Assault,2022,44,64,0,20
D55,Assault,2022,72,98,0,26
D55,Assault,2022,25,37,0,12
D55,Attempt Murder,2022,1,1,1,0
D55,Attempt Murder,2022,3,3,1,0
D55,Attempt Murder,2022,1,1,1,0
D55,Attempt Murder,2022,1,1,1,0
D55,Attempt Murder,2022,2,2,1,0
D55,Attempt Murder,2022,1,1,1,0
D55,Other,2022,8,12,0,4
D55,Other,2022,12,20,0,8
D55,Other,2022,14,19,0,5
D55,Other,2022,6,10,0,4
D55,Other,2022,18,39,0,21
D55,Other,2022,17,26,0,9
D55,Other,2022,10,19,0,9
D55,Other,2022,2,2,1,0
D55,Other,2022,4,10,0,6
D55,Other,2022,19,26,0,7
D55,Other,2022,6,11,0,5
D55,Other,2022,9,16,0,7
D53,Other,2022,107,115,0,8
D53,Other,2022,6,10,0,4
D55,Break & Enter-Commercial,2022,3,6,0,3
D55,Fraud,2022,11,70,0,59
D53,Other,2022,1,2,0,1
D53,Other,2022,9,12,0,3
D55,Auto Theft,2022,2,22,0,20
D55,Break & Enter-Commercial,2022,1,7,0,6
D53,Other,2022,4,5,0,1
D53,Other,2022,3,8,0,5
D55,Auto Theft,2022,3,53,0,50
D55,Break & Enter-Commercial,2022,2,2,1,0
D53,Other,2022,5,5,1,0
D53,Robbery-Financial,2022,1,1,1,0
D55,Auto Theft,2022,1,44,0,43
D53,Robbery-Financial,2022,1,1,1,0
D55,Break & Enter-House,2022,4,7,0,3
D53,Other,2022,2,2,1,0
D53,Robbery-Financial,2022,1,1,1,0
D55,Fraud,2022,3,15,0,12
D55,Auto Theft,2022,2,22,0,20
D55,Fraud,2022,4,40,0,36
D55,Break & Enter-House,2022,0,9,0,9
D53,Other,2022,1,1,1,0
D55,Auto Theft,2022,3,24,0,21
D53,Robbery-Other,2022,5,14,0,9
D53,Fraud,2022,3,96,0,93
D55,Fraud,2022,4,20,0,16
D55,Break & Enter-House,2022,1,15,0,14
D53,Other,2022,12,13,0,1
D55,Auto Theft,2022,0,5,0,5
D53,Robbery-Other,2022,0,1,0,1
D53,Fraud,2022,5,82,0,77
D55,Other,2022,0,1,0,1
D53,Theft Under $5000,2022,0,6,0,6
D55,Break & Enter-House,2022,1,12,0,11
D53,Other,2022,0,2,0,2
D55,Auto Theft,2022,0,32,0,32
D53,Robbery-Other,2022,1,3,0,2
D53,Fraud,2022,5,104,0,99
D55,Other,2022,9,71,0,62
D53,Theft Under $5000,2022,2,11,0,9
D55,Break & Enter-House,2022,2,14,0,12
D53,Other,2022,1,1,1,0
D55,Auto Theft,2022,3,40,0,37
D53,Robbery-Other,2022,0,1,0,1
D53,Fraud,2022,5,56,0,51
D55,Other,2022,8,43,0,35
D53,Theft Under $5000,2022,2,12,0,10
D55,Break & Enter-House,2022,1,5,0,4
D53,Other,2022,10,14,0,4
D55,Auto Theft,2022,0,1,0,1
D53,Robbery-Other,2022,4,4,1,0
D53,Fraud,2022,0,2,0,2
D55,Other,2022,0,1,0,1
D53,Theft Under $5000,2022,11,103,0,92
D55,Break & Enter-House,2022,1,5,0,4
D53,Other,2022,7,8,0,1
D55,Auto Theft,2022,0,22,0,22
D53,Robbery-Other,2022,1,4,0,3
D53,Fraud,2022,7,56,0,49
D55,Other,2022,27,66,0,39
D53,Theft Under $5000,2022,1,101,0,100
D53,Fraud,2022,3,50,0,47
D55,Break & Enter-House,2022,1,5,0,4
D53,Other,2022,16,21,0,5
D55,Auto Theft,2022,1,18,0,17
D53,Robbery-Other,2022,3,3,1,0
D53,Other,2022,50,230,0,180
D55,Break & Enter-House,2022,4,9,0,5
D55,Auto Theft,2022,7,69,0,62
D53,Other,2022,0,1,0,1
D55,Other,2022,14,65,0,51
D53,Theft Under $5000,2022,13,207,0,194
D55,Other,2022,44,176,0,132
D53,Robbery-Other,2022,1,3,0,2
D55,Break & Enter-House,2022,3,8,0,5
D55,Auto Theft,2022,1,15,0,14
D53,Other,2022,40,41,0,1
D53,Theft Under $5000,2022,0,15,0,15
D53,Other,2022,1,4,0,3
D55,Other,2022,16,52,0,36
D53,Robbery-Other,2022,7,9,0,2
D55,Break & Enter-House,2022,6,19,0,13
D55,Auto Theft,2022,4,55,0,51
D53,Other,2022,102,112,0,10
D53,Theft Under $5000,2022,0,1,0,1
D53,Other,2022,1,4,0,3
D55,Other,2022,16,87,0,71
D53,Robbery-Other,2022,8,12,0,4
D55,Break & Enter-House,2022,3,5,0,2
D55,Auto Theft,2022,1,14,0,13
D53,Other,2022,53,59,0,6
D53,Theft Under $5000,2022,8,96,0,88
D53,Other,2022,2,10,0,8
D55,Other,2022,3,8,0,5
D53,Robbery-Other,2022,4,10,0,6
D55,Break & Enter-House,2022,3,19,0,16
D55,Auto Theft,2022,3,19,0,16
D53,Other,2022,49,52,0,3
D53,Theft Under $5000,2022,57,464,0,407
D53,Other,2022,0,1,0,1
D55,Other,2022,6,54,0,48
D53,Robbery-Other,2022,8,12,0,4
D55,Break & Enter-House,2022,4,6,0,2
D55,Auto Theft,2022,0,23,0,23
D53,Other,2022,49,59,0,10
D53,Theft Under $5000,2022,36,605,0,569
D53,Other,2022,1,13,0,12
D55,Other,2022,24,90,0,66
D55,Other,2022,2,4,0,2
D55,Other,2022,8,39,0,31
D55,Other,2022,14,61,0,47
D55,Other,2022,41,165,0,124
D55,Other,2022,20,118,0,98
D55,Other,2022,16,115,0,99
D55,Other,2022,7,44,0,37
D55,Other,2022,22,85,0,63
D55,Other,2022,5,33,0,28
D55,Theft Over $5000,2022,0,1,0,1
D55,Theft Over $5000,2022,0,3,0,3
D55,Theft Over $5000,2022,1,3,0,2
D55,Theft Over $5000,2022,0,3,0,3
D55,Theft Over $5000,2022,2,13,0,11
D55,Theft Over $5000,2022,1,1,1,0
D55,Theft Over $5000,2022,1,7,0,6
D55,Theft Over $5000,2022,1,3,0,2
D55,Theft Over $5000,2022,0,3,0,3
D55,Theft Over $5000,2022,1,9,0,8
D55,Theft Over $5000,2022,0,1,0,1
D55,Theft Over $5000,2022,0,4,0,4
D55,Theft Over $5000,2022,1,15,0,14
D55,Theft Over $5000,2022,0,4,0,4
D55,Theft Over $5000,2022,1,8,0,7
D55,Theft Over $5000,2022,0,2,0,2
D55,Theft Over $5000,2022,2,5,0,3
D55,Theft Over $5000,2022,0,1,0,1
D55,Theft Under $5000,2022,41,248,0,207
D55,Theft Under $5000,2022,18,105,0,87
D55,Theft Under $5000,2022,41,173,0,132
D55,Theft Under $5000,2022,5,111,0,106
D55,Theft Under $5000,2022,75,389,0,314
D55,Theft Under $5000,2022,13,109,0,96
D55,Theft Under $5000,2022,12,181,0,169
D55,Break & Enter-Apartment,2022,0,1,0,1
D53,Other,2022,19,19,1,0
D53,Robbery-Other,2022,0,1,0,1
D53,Other,2022,0,5,0,5
D53,Theft Under $5000,2022,63,348,0,285
D55,Break & Enter-Apartment,2022,1,4,0,3
D53,Other Criminal Violations - Offensive Weapons,2022,16,21,0,5
D53,Robbery-Other,2022,2,3,0,1
D53,Other,2022,7,20,0,13
D53,Theft Under $5000,2022,0,2,0,2
D55,Break & Enter-Apartment,2022,6,10,0,4
D53,Other Criminal Violations - Offensive Weapons,2022,1,1,1,0
D53,Other Criminal Violations - Offensive Weapons,2022,1,1,1,0
D53,Other Criminal Violations - Offensive Weapons,2022,2,4,0,2
D53,Other Criminal Violations - Offensive Weapons,2022,2,2,1,0
D53,Other Criminal Violations - Offensive Weapons,2022,4,4,1,0
D53,Other Criminal Violations - Offensive Weapons,2022,6,9,0,3
D53,Other Criminal Violations - Offensive Weapons,2022,3,5,0,2
D53,Other Criminal Violations - Offensive Weapons,2022,19,23,0,4
D53,Other Criminal Violations - Offensive Weapons,2022,9,9,1,0
D53,Other Criminal Violations - Offensive Weapons,2022,8,12,0,4
D53,Other Criminal Violations - Offensive Weapons,2022,1,1,1,0
D53,Other Criminal Violations - Offensive Weapons,2022,5,5,1,0
D53,Other Criminal Violations - Offensive Weapons,2022,4,6,0,2
D55,Other,2022,5,5,1,0
D55,Other,2022,4,4,1,0
D55,Other,2022,1,1,1,0
D55,Other,2022,4,4,1,0
D55,Other,2022,2,2,1,0
D55,Other,2022,6,6,1,0
D55,Other,2022,3,4,0,1
D55,Other,2022,4,4,1,0
D55,Other,2022,6,8,0,2
D55,Other,2022,1,2,0,1
D55,Other,2022,1,1,1,0
D55,Other,2022,6,8,0,2
D55,Other,2022,1,1,1,0
D55,Other,2022,7,8,0,1
D55,Other,2022,2,2,1,0
D55,Other,2022,1,1,1,0
D55,Auto Theft,2022,1,9,0,8
D55,Break & Enter-Apartment,2022,2,7,0,5
D55,Break & Enter-Apartment,2022,13,22,0,9
D55,Break & Enter-Apartment,2022,7,19,0,12
D55,Break & Enter-Apartment,2022,4,18,0,14
D55,Break & Enter-Apartment,2022,0,6,0,6
D55,Break & Enter-Apartment,2022,1,8,0,7
D55,Break & Enter-Apartment,2022,17,25,0,8
D55,Break & Enter-Apartment,2022,0,1,0,1
D55,Break & Enter-Apartment,2022,6,11,0,5
D55,Break & Enter-Apartment,2022,16,32,0,16
D55,Break & Enter-Apartment,2022,7,15,0,8
D55,Break & Enter-Apartment,2022,3,9,0,6
D55,Break & Enter-Apartment,2022,13,19,0,6
D55,Break & Enter-Apartment,2022,2,7,0,5
D55,Break & Enter-Apartment,2022,0,1,0,1
D55,Break & Enter-Commercial,2022,4,12,0,8
D55,Break & Enter-Commercial,2022,3,4,0,1
D55,Break & Enter-Commercial,2022,10,28,0,18
D55,Break & Enter-Commercial,2022,2,5,0,3
D55,Break & Enter-Commercial,2022,4,26,0,22
D55,Break & Enter-Commercial,2022,0,2,0,2
D55,Break & Enter-Commercial,2022,4,9,0,5
D55,Break & Enter-Commercial,2022,2,13,0,11
D55,Break & Enter-Commercial,2022,4,16,0,12
D55,Break & Enter-Commercial,2022,2,11,0,9
D55,Break & Enter-Commercial,2022,2,10,0,8
D55,Break & Enter-Commercial,2022,15,44,0,29
D55,Break & Enter-Commercial,2022,0,3,0,3
D55,Break & Enter-Commercial,2022,5,13,0,8
D53,Robbery-Other,2022,0,8,0,8
D53,Sexual Violation,2022,12,32,0,20
D53,Sexual Violation,2022,2,3,0,1
D53,Sexual Violation,2022,1,3,0,2
D53,Sexual Violation,2022,4,6,0,2
D53,Sexual Violation,2022,0,3,0,3
D53,Sexual Violation,2022,4,8,0,4
D53,Sexual Violation,2022,3,6,0,3
D53,Sexual Violation,2022,5,13,0,8
D53,Sexual Violation,2022,0,1,0,1
D53,Sexual Violation,2022,14,23,0,9
D53,Sexual Violation,2022,7,16,0,9
D53,Sexual Violation,2022,7,15,0,8
D53,Sexual Violation,2022,8,10,0,2
D53,Sexual Violation,2022,7,13,0,6
D53,Sexual Violation,2022,5,10,0,5
D53,Other,2022,9,12,0,3
D53,Other,2022,2,2,1,0
D53,Other,2022,7,9,0,2
D53,Other,2022,1,2,0,1
D53,Other,2022,3,3,1,0
D53,Other,2022,7,7,1,0
D53,Other,2022,12,13,0,1
D53,Other,2022,3,5,0,2
D53,Other,2022,1,4,0,3
D53,Other,2022,5,8,0,3
D53,Other,2022,7,8,0,1
D53,Other,2022,4,5,0,1
D53,Other,2022,9,10,0,1
D53,Other,2022,1,1,1,0
D55,Break & Enter-House,2022,0,2,0,2
D55,Break & Enter-Other,2022,0,2,0,2
D55,Break & Enter-Other,2022,0,1,0,1
D55,Break & Enter-Other,2022,0,4,0,4
D55,Break & Enter-Other,2022,0,3,0,3
D55,Break & Enter-Other,2022,3,7,0,4
D55,Break & Enter-Other,2022,1,2,0,1
D55,Break & Enter-Other,2022,0,5,0,5
D55,Break & Enter-Other,2022,1,4,0,3
D55,Break & Enter-Other,2022,0,1,0,1
D55,Break & Enter-Other,2022,0,1,0,1
D55,Break & Enter-Other,2022,1,3,0,2
D55,Break & Enter-Other,2022,0,3,0,3
D55,Break & Enter-Other,2022,0,2,0,2
D55,Break & Enter-Other,2022,1,3,0,2
D55,Break & Enter-Other,2022,1,2,0,1
D55,Break & Enter-Other,2022,3,5,0,2
D55,Break & Enter-Other,2022,1,1,1,0
D55,Fraud,2022,0,1,0,1
D55,Fraud,2022,2,35,0,33
D55,Fraud,2022,7,34,0,27
D55,Fraud,2022,6,33,0,27
D55,Fraud,2022,1,33,0,32
D55,Fraud,2022,8,68,0,60
D55,Fraud,2022,5,58,0,53
D55,Fraud,2022,6,58,0,52
D55,Fraud,2022,2,4,0,2
D55,Fraud,2022,2,43,0,41
D55,Fraud,2022,8,53,0,45
D55,Fraud,2022,1,23,0,22
D55,Fraud,2022,3,26,0,23
D55,Fraud,2022,13,111,0,98
D55,Fraud,2022,4,38,0,34
D53,Theft Under $5000,2022,76,541,0,465
D53,Theft Under $5000,2022,23,295,0,272
D53,Assault,2022,128,227,0,99
D53,Assault,2022,2,2,1,0
D53,Assault,2022,3,6,0,3
D53,Assault,2022,6,11,0,5
D53,Assault,2022,10,13,0,3
D53,Assault,2022,1,5,0,4
D53,Assault,2022,14,20,0,6
D53,Assault,2022,3,7,0,4
D53,Assault,2022,14,26,0,12
D53,Assault,2022,17,29,0,12
D53,Assault,2022,36,47,0,11
D53,Assault,2022,3,6,0,3
D53,Assault,2022,2,2,1,0
D53,Assault,2022,71,110,0,39
D53,Assault,2022,116,204,0,88
D53,Assault,2022,76,116,0,40
D53,Assault,2022,58,97,0,39
D53,Assault,2022,64,106,0,42
D53,Assault,2022,29,40,0,11
D53,Attempt Murder,2022,1,1,1,0
D53,Attempt Murder,2022,2,2,1,0
D53,Attempt Murder,2022,1,1,1,0
D53,Attempt Murder,2022,1,1,1,0
D53,Other,2022,19,33,0,14
D53,Other,2022,0,1,0,1
D53,Other,2022,2,3,0,1
D53,Other,2022,4,6,0,2
D53,Other,2022,3,3,1,0
D53,Other,2022,3,5,0,2
D53,Other,2022,5,8,0,3
D53,Other,2022,4,8,0,4
D53,Other,2022,0,3,0,3
D53,Other,2022,11,17,0,6
D53,Other,2022,8,19,0,11
D53,Other,2022,21,29,0,8
D53,Other,2022,3,16,0,13
D53,Other,2022,9,51,0,42
D53,Other,2022,9,45,0,36
D53,Other,2022,5,44,0,39
D53,Other,2022,0,5,0,5
D53,Other,2022,1,1,1,0
D53,Other,2022,18,61,0,43
D53,Other,2022,25,164,0,139
D53,Other,2022,25,71,0,46
D53,Other,2022,22,77,0,55
D53,Other,2022,0,3,0,3
D53,Other,2022,15,67,0,52
D53,Other,2022,6,33,0,27
D53,Theft Over $5000,2022,4,29,0,25
D53,Theft Over $5000,2022,0,1,0,1
D53,Theft Over $5000,2022,0,3,0,3
D53,Theft Over $5000,2022,0,2,0,2
D53,Theft Over $5000,2022,0,1,0,1
D53,Theft Over $5000,2022,0,4,0,4
D53,Theft Over $5000,2022,0,3,0,3
D53,Theft Over $5000,2022,1,5,0,4
D53,Theft Over $5000,2022,0,3,0,3
D53,Theft Over $5000,2022,0,6,0,6
D53,Theft Over $5000,2022,0,2,0,2
D53,Theft Over $5000,2022,0,4,0,4
D53,Theft Over $5000,2022,1,13,0,12
D53,Theft Over $5000,2022,1,3,0,2
D53,Theft Over $5000,2022,2,10,0,8
D53,Theft Over $5000,2022,1,6,0,5
D53,Theft Over $5000,2022,0,1,0,1
D53,Theft Under $5000,2022,87,678,0,591
D53,Theft Under $5000,2022,0,2,0,2
D53,Theft Under $5000,2022,2,23,0,21
D53,Theft Under $5000,2022,1,26,0,25
D53,Theft Under $5000,2022,1,28,0,27
D55,Other,2022,40,54,0,14
D55,Other,2022,8,19,0,11
D55,Other,2022,12,22,0,10
D55,Other,2022,8,13,0,5
D55,Other,2022,7,20,0,13
D55,Other,2022,6,10,0,4
D55,Robbery-Financial,2022,1,2,0,1
D55,Robbery-Financial,2022,1,2,0,1
D55,Robbery-Financial,2022,1,1,1,0
D55,Robbery-Financial,2022,1,1,1,0
D55,Robbery-Other,2022,3,10,0,7
D55,Robbery-Other,2022,0,2,0,2
D55,Robbery-Other,2022,9,19,0,10
D55,Robbery-Other,2022,1,5,0,4
D55,Robbery-Other,2022,10,20,0,10
D55,Robbery-Other,2022,7,11,0,4
D55,Robbery-Other,2022,14,30,0,16
D55,Robbery-Other,2022,1,9,0,8
D55,Robbery-Other,2022,2,7,0,5
D55,Robbery-Other,2022,1,2,0,1
D55,Robbery-Other,2022,1,6,0,5
D55,Robbery-Other,2022,5,6,0,1
D55,Robbery-Other,2022,19,33,0,14
D55,Robbery-Other,2022,5,6,0,1
D55,Robbery-Other,2022,6,17,0,11
D55,Robbery-Other,2022,5,5,1,0
D55,Robbery-Other,2022,4,5,0,1
D55,Robbery-Other,2022,1,4,0,3
D55,Sexual Violation,2022,6,9,0,3
D55,Sexual Violation,2022,3,7,0,4
D55,Sexual Violation,2022,5,14,0,9
D55,Sexual Violation,2022,5,11,0,6
D55,Sexual Violation,2022,7,15,0,8
D55,Sexual Violation,2022,9,13,0,4
D55,Sexual Violation,2022,4,17,0,13
D55,Sexual Violation,2022,3,4,0,1
D55,Sexual Violation,2022,4,9,0,5
D55,Sexual Violation,2022,8,14,0,6
D55,Sexual Violation,2022,3,5,0,2
D55,Sexual Violation,2022,4,6,0,2
D55,Sexual Violation,2022,12,26,0,14
D55,Sexual Violation,2022,10,17,0,7
D55,Sexual Violation,2022,7,17,0,10
D55,Sexual Violation,2022,2,5,0,3
D55,Sexual Violation,2022,7,13,0,6
D55,Sexual Violation,2022,5,12,0,7
D55,Other,2022,1,1,1,0
D55,Other,2022,2,2,1,0
D55,Other,2022,9,9,1,0
D55,Other,2022,1,1,1,0
D55,Other,2022,1,1,1,0
D55,Other,2022,8,8,1,0
D55,Other,2022,12,12,1,0
D55,Other,2022,6,7,0,1
D55,Other,2022,4,5,0,1
D55,Other,2022,10,10,1,0
D55,Other,2022,13,14,0,1
D55,Other,2022,15,15,1,0
D55,Other,2022,3,3,1,0
D55,Other,2022,27,28,0,1
D55,Other,2022,5,5,1,0
D55,Other,2022,7,7,1,0
D55,Other,2022,41,45,0,4
D55,Other,2022,3,3,1,0
D55,Other,2022,11,13,0,2
D55,Other,2022,2,3,0,1
D55,Other,2022,36,38,0,2
D55,Other,2022,26,30,0,4
D55,Other,2022,1,1,1,0
D55,Other,2022,47,53,0,6
D55,Other,2022,29,35,0,6
D55,Other,2022,75,96,0,21
D55,Other,2022,47,52,0,5
D55,Other,2022,2,2,1,0
D55,Other,2022,5,5,1,0
D55,Other,2022,20,23,0,3
D55,Other,2022,49,59,0,10
D55,Other,2022,1,1,1,0
D55,Other,2022,17,22,0,5
D55,Other,2022,21,27,0,6
D55,Other,2022,117,139,0,22
D55,Other,2022,46,53,0,7
D55,Other,2022,42,46,0,4
D55,Other,2022,36,43,0,7
D55,Other,2022,154,164,0,10
D55,Other,2022,14,17,0,3
D55,Other Criminal Violations - Offensive Weapons,2022,6,7,0,1
D55,Other Criminal Violations - Offensive Weapons,2022,3,3,1,0
D55,Other Criminal Violations - Offensive Weapons,2022,6,6,1,0
D55,Other Criminal Violations - Offensive Weapons,2022,3,3,1,0
D55,Other Criminal Violations - Offensive Weapons,2022,5,8,0,3
D55,Other Criminal Violations - Offensive Weapons,2022,3,4,0,1
D55,Other Criminal Violations - Offensive Weapons,2022,12,12,1,0
D55,Other Criminal Violations - Offensive Weapons,2022,0,1,0,1
D55,Other Criminal Violations - Offensive Weapons,2022,9,13,0,4
D55,Other Criminal Violations - Offensive Weapons,2022,4,6,0,2
D55,Other Criminal Violations - Offensive Weapons,2022,5,8,0,3
D55,Other Criminal Violations - Offensive Weapons,2022,14,17,0,3
D55,Other Criminal Violations - Offensive Weapons,2022,6,6,1,0
D55,Other Criminal Violations - Offensive Weapons,2022,3,3,1,0
D55,Other Criminal Violations - Offensive Weapons,2022,1,1,1,0
D55,Other Criminal Violations - Offensive Weapons,2022,6,8,0,2
D55,Other Criminal Violations - Offensive Weapons,2022,2,2,1,0
D55,Other,2022,0,1,0,1
D55,Other,2022,0,1,0,1
D55,Other,2022,1,1,1,0
D55,Other,2022,1,1,1,0
NSA,Other,2022,28,34,0,6
NSA,Auto Theft,2022,1,42,0,41
NSA,Break & Enter-Apartment,2022,2,11,0,9
NSA,Break & Enter-Commercial,2022,5,10,0,5
NSA,Break & Enter-House,2022,0,3,0,3
NSA,Break & Enter-Other,2022,2,4,0,2
NSA,Fraud,2022,1,1,1,0
NSA,Fraud,2022,0,1,0,1
NSA,Fraud,2022,1,1,1,0
NSA,Fraud,2022,29,148,0,119
NSA,Other,2022,1,1,1,0
NSA,Other,2022,47,124,0,77
NSA,Theft Over $5000,2022,4,15,0,11
NSA,Theft Under $5000,2022,1,1,1,0
NSA,Theft Under $5000,2022,19,109,0,90
NSA,Theft Under $5000,2022,0,1,0,1
NSA,Assault,2022,0,1,0,1
NSA,Assault,2022,99,199,0,100
NSA,Assault,2022,0,1,0,1
NSA,Assault,2022,0,1,0,1
NSA,Assault,2022,0,1,0,1
NSA,Other,2022,23,50,0,27
NSA,Robbery-Financial,2022,4,4,1,0
NSA,Robbery-Other,2022,0,1,0,1
NSA,Robbery-Other,2022,2,2,1,0
NSA,Robbery-Other,2022,75,89,0,14
NSA,Sexual Violation,2022,1,1,1,0
NSA,Sexual Violation,2022,0,1,0,1
NSA,Sexual Violation,2022,0,1,0,1
NSA,Sexual Violation,2022,24,124,0,100
NSA,Other,2022,106,117,0,11
NSA,Other,2022,0,1,0,1
NSA,Other,2022,1,1,1,0
NSA,Other,2022,141,161,0,20
NSA,Other Criminal Violations - Offensive Weapons,2022,44,48,0,4
NSA,Other,2022,6,13,0,7
